Stetind nammasaš 	čohkka 	manná njuolga bajás gitta 1.400 mehtara allodahkii .
Stetind nammasaš 	čohkka 	manná njuolga bajás gitta 1.400 mehtara allodahkii .
Sámi giellaráđis lea leamaš iskkadeami váldoovddasvástádus , ja stivrenjoavkkus leat Sámi giellaráđi bargolávdegotti áirasat Barbro Lill Hætta , Nils Øyvind Helander ja Nora Brandsfjeld , ja kánturhoavda , Anne Dagmar Biti Mikalsen , 	čohkkan 	.ERR
Maŋŋel válgga 2009 mii leat 15 nissona ja njeallje dain 	čohkkahit 	stivrras , gávnnaha Sara Larsson .DUŠŠ
	Aššu –
Go leimmet borran gallásčovjjiid , lávlon sáhpanlávlagiid ja oalle ládje maid váiban čiŋadan hámiin 	čohkkat 	, lei áigi fas šaddat dábálaš sáhpančivgan áhku guossis .ERR
Dobbelis 	čohkkaba 	skuvlaáŋgiris russat geat leaba bargame skuvlabargguid .ERR
Vai ain vearrát , leat go politiijat gávdnan min já váldan min 	čohkkanlottiid 	?DUŠŠ
Ii galgan oktage sahtet dadjat ahte ii mahtte 	čohkkanlottiid 	dahkkat .DUŠŠ
Go lottit leddje gárvasit ráhkaduvvon , de lei suddegáddai dahje giđđaláddui geahččalit movt loddi 	čohkka 	čácis .ERR
Diibmomearri lei biddjon ja galgen boahtit su beavdái , son áiggui 	čohkkat 	aktobeavddis .ERR
Nieida gii 	čohkkai 	kássas , moddjái ja jearai máid mun áiggun go nu olu njálggahájaid ges oastán .DUŠŠ
Máret Guhttor lea 	čohkkan 	Sámedikkis dan rájes go dat vuođđuduvui .ERR
Soai Geliinnain 	čohkkaiga 	sallalaga giettis ja lávlluiga sálmmaid .DUŠŠ
Lei váttis gávdnat 	čohkkansaji 	nu ahte šadden feaskkáris čuožžut , muhto ii lean ge vuosttaš geardde go Juvvá-banne šaddá čuožžut .DUŠŠ
Son 	čohkkai 	ja fuoikkui .DUŠŠ
Guhkkeleappos sogiid čađa sabmá Látnjajotoaivi , mii lea Marastat duoddariid alimus 	čohkka 	.
Máret Mienna Bongo 	čohkkada 	iđđesgáfiin ja šuohkahallá .DUŠŠ
Gáren Ánná 	čohkkada 	guhká jaska ovdal go jienada : – Ii munnje lean oktage ožžon sáni go ledjen ealo luhtte , nu ahte in beassan oaidnit filmma ovdal muhtun áiggi maŋŋel .DUŠŠ
Guovddašbellodaga nuoraidsearvi Finnmárkkus lea hui vuostá dan go dal daddjo ahte Davvi-Norgga girdimiidda galgá biddjot 	čohkkansajiide 	divagat , ii ge šat leahkit mátkosteddjit ektui .DUŠŠ
De bierdna 	čohkkadii 	, dasa go seaibi riekta galbmui gitta jikŋii .DUŠŠ
De galgá jáddadit measta buot čuovggaid lanjas ja 	čohkkanit 	máŋggas dohko .DUŠŠ
Sámi mediaváikkuheaddjit ja dutkit 	čohkkanedje 	Roavvenjárgii čakčamánu loahpas suokkardit sápmelaš media ja álgoálbmogiid mediapolitihka .DUŠŠ
Sámi mediaváikkuheaddjit ja dutkit 	čohkkanedje 	Roavvenjárgii čakčamánu loahpas suokkardit sápmelaš media ja álgoálbmogiid mediapolitihka .DUŠŠ
Ja de jearrá johtti : “ Iigo son oaččo das 	čohkkat 	dassážii go arvi vássá ?ERR
Dá leat goitge buot namahusat : Gorži , gorsa , ája , jávri , várri , fielbmá , gáisá , jeaggi , maras , luoppal , johka ja 	čohkka 	.
Muhto dassážii go beasan du salas 	čohkkat 	ja du gieđas doallat , ráhkkásan .ERR
Vaikko in du salas beasa 	čohkkat 	, vaikko it doala mu gieđa , vaikko it loga munnje dan maid hálidan gullat , mu ráhkis .ERR
	Avvir –
Nubbi dan guoktásis , geat dál leaba goalmmát vahkku 	čohkkame 	háldogiddagasas Jielleváris danin go galgaba leat roavvát veagalváldán guokte nissonolbmo Johkamohkis , lea váidon vel eambbo nissonolbmuid veagalváldán mat galget dáhpáhuvvon ovdal ‹ ‹ Johkamohkki-veagalváldi › › šattai politiijaid áššin .ERR
Bassi 	čohkka 	Mathisen čálii jagi 2004:s lohkkiid reivve Romssa Nordlys aviisii musas kolonialismmas ) , mas son čálii ahte lea vuostá OG-doaluid lágidit Romssas jagi 2014:s .
Dat lea lihka duohta go mii 	čohkkat 	dás ERR
Eamiálbmogiid nammavierut Alaskas eai leat buohkaide áddehahtti , eaige buohkatge nagot dadjat inuihtaid báikenamaid nu go Nunathloogagamiutbingoi Dunes dahje Dakeekathlrimjingia Point ( 	čohkka 	) .
Dakkár festiválalávuid gos olbmot besset 	čohkkat 	ja dolastit .ERR
Don fal muittát man ollu čuoikkat diibmá ledje , ii ballen baljo jaska 	čohkkat 	.ERR
Indiánaid ráfiriekkis lea de boahtán guovddažii , gos ášši bealit galget rieggás 	čohkkat 	ja digaštallat ášši dassážii čoavddus boahtá .ERR
Lea veahá eará 	čohkkat 	ja digaštallat ášši go nuppi bealli čohkká njune ovddas ja goappašagain lea geatnegasvuohta guldalit ja nuppi nuppi vuhtiiváldet .ERR
Jaska 	čohkkat 	?ERR
– In liiko jaska 	čohkkat 	beare guhká , dadjá son .ERR
Duopmu šattai nie go olmmái mieđihii daguidis ja duopmostuollu oaivvilda dákkár duomu eanet heivvolažžan go giddagasas 	čohkkat 	.ERR
Suollagat váruhuvvoba rihkkon 268 paragráfa , mas lea ráŋggáštusmearri 12 jagi giddagassas 	čohkkat 	, lohká son .ERR
Háldi lea 	čohkka 	mas lea dehálaš historjá .
– Das mun láven 	čohkkat 	ja goarrut , lohka Sárá ja čohkkeda goarrunmášiinna gurrii .ERR
– Mun ráhkistan 	čohkkat 	olgun geasset .ERR
– Sávvamis manná bures válggas , muhto dat lea jienasteddjiid duohken ja dál ii sáhte šat maidege dahkat , go 	čohkkat 	ja vuorddašit bohtosiid , dadjá Aili Keskitalo .ERR
TPB álggaheaddjit dubmehalle jagi giddagasas 	čohkkat 	ja lagabui 30 miljovnna ruvnnu máksit filbma- ja CD-skearru lágádusaide .ERR
1997 dubmehalai dievdu 	čohkkat 	giddagasas jagi ja guokte mánu ja vel máksit 75 000 ruvnno buhtadussan nieiddažii .ERR
Duodjestudeanttat Maire Aslaksen ja Inga Elisa Påve 	čohkkaba 	stuolus ja beavdeguoras masa sudno ERR
– Mun vuoiŋŋastan buoremusat go beasan beaivve ovddas 	čohkkat 	, ja áfáiduvvot ERR
Ja jus lea fiinna dálki , de gal heive 	čohkkat 	olgun .ERR
Red lea suhtus , go leat akto šaddan guoddit siva dagu ovddas , man geažil lea 	čohkkan 	giddagasa .ERR
– Mun ceggen vaikke ieš filbmafestivála jus Sámi Filbmafestivála ii dohkket 	čohkkansajiid 	Buletjávrris .DUŠŠ
Muhtumin sáhtán 	čohkkat 	Facebook:s dušše vihtta minuhta , muhto olles diimmu maid muhtun beivviid , muitala Inger Johanne .ERR
MOKTA : Deanu searvegotti organista geavaha mielas astoáiggis maiddái 	čohkkat 	orgel-gáttis .ERR
T-báidi lea sidjiide geat leat oastán čuohppankoartta ja leat vázzán Tuvrrahasaid 	čohkkatuvrraid 	.
	Non-fiction texts –
	čohkka 	– čohkat
s. Dán jagi 	čohkka 	bođii erenoamážit das go doaluid golut ledje čielgasit bajimusas 2003:s olles áigodagas .
Sámi giellaráđis lea leamaš iskkadeami váldoovddasvástádus , ja stivrenjoavkkus leat Sámi giellaráđi bargolávdegotti áirasat Barbro Lill Hætta , Nils Øyvind Helander ja Nora Brandsfjeld , ja kánturhoavda , Anne Dagmar Biti Mikalsen , 	čohkkan 	.ERR
Dáinna lágiin don geasehat skuhtera nu ahte dat stivre iežas ja de ii dárbbaš olmmoš 	čohkkat 	skuhteris mii lea gollosis .ERR
Smávva muorrakássat ledje 	čohkkanbeankan 	ja dasa vel lássin min iežamet niestebumbbat .DUŠŠ
Seamma lanjas ledje min smávva niestebumbbat mat adnojedje 	čohkkanbeaŋkan 	maid .DUŠŠ
Ja dalle balle mánat skuvlaolbmain , eai duostan eambbo nu jaska 	čohkkaje 	buohkat .DUŠŠ
Ja dalle balle mánat skuvla-olbmain , eai duostan eambbo nu jaska 	čohkkaje 	buohkat .DUŠŠ
Lávii nu váivi 	čohkkat 	joavdelassan go báhppa barga daid earaiguin .ERR
Dat hearvas eahketboddu njuorasmahtii su miela , ja son 	čohkkai 	dál maiddai ovtta muitobáikkis .DUŠŠ
Son 	čohkkai 	dál jura seamma vuovderavddas gos son mánnan leai ávus viegadan ja gaskan vajalkeahtesnásttiid ja čiŋahan daiguin su smávva oappaidis ja iežas .DUŠŠ
Ja son muitai maiddai , go son dal das 	čohkkai 	, mo čeavlas dážabártnit boagustedje su go son mánnan darogiela molžžai .DUŠŠ
Oahppi fertii 	čohkkat 	roaŋkut vuolimusas girjeskábes ja Anna lássii uvssa .ERR
Hui unnán sevdnjeslatnja lei , doppe fertiimet 	čohkkat 	diibmoviissaid .ERR
	Min Aigi –
Son lea 	čohkkan 	giddagasas mánu go dubmehalai goddán geatki .ERR
In sáhte ruovttus 	čohkkat 	luomeáiggi .ERR
Mánát 	čohkkajit 	ja spellet dihtorspealuin ja surfejit interneahttas eaige danne šat mana olggos čuoigat ja stoahkat .DUŠŠ
Muhtimat 	čohkkade 	ja jugade gáhta alde ja ledje buohkaid ovddas .ERR
Olbmot 	čohkkaje 	fárpalit alde , muhto historjá muitala ahte unnimus fárpaliid šadde lonuhit .DUŠŠ
Birrasii 40 olbmo ledje álbmotbeaivvis 	čohkkanan 	ásahit ođđa sámi searvvi .ERR
Ja vaikko Romssa Fylkkagielddas juo gávdnojit olbmot geat juoiggadit kántuvrrain , de ii dáidde gal juoigi bargun šaddat 	čohkkat 	juoigankántuvrras , dadjet Romssa Fylkkagielddas .ERR
– Gulahallan lea ollu eambbo go guovttes geat 	čohkkaba 	goabbat PC:in Windows 2000 prográmmain ja čálašeaba e-poasttaid dahje geahčadeaba goabbat ge ruovttusiiddu .ERR
Jus bárdni dupmehallet seksualalaš oktavuhttin ja veagalváldin , de sahtta son 	čohkka 	giddagassii olles 15 jági , muhttu politi-inspektøra Are Meedbye lohká ahte dat ii lea realistalaš , ja sus ii leat makkarge oaivvil man guhkka raŋggaštus sahtta šaddet .ERR
Dán jagi šattaimet guhká 	čohkkat 	ja smiehttat , dadjá Triumf gii sávva ahte dat ii dagat ahte joavkkut eai gille šat dieđihit boahtte áiggis gilvvuide ERR
Dat lea veahá suddu go juste dán kurssa ulbmil han livččii oláhit daid olbmuid geat 	čohkkajit 	mearrideaddji virggiin , ja dat leat Finnmárkku almmolaš orgánain ain eanas dievdoolbmot , lohká Anne-Cathrine Larsen .DUŠŠ
Guhkka 	čohkkai 	Sámi Radio hoavda ja čuokkui rádio ovdal go oaččui das jiena .DUŠŠ
Muhto sii eai dušše 	čohkka 	ja juga gáfe , birra jagi barget sii ruđa čohkket vuoi besset vuolgit golgat .ERR
Hedenesas leat sin máttut ovdal 	čohkkanan 	ja dan dihte áigo sii dohko vuolgit muitala Edel .ERR
Dá 	čohkka 	fágačállin Per Mathis Oskaliim diimmá riikačoahkkimis ERR
Hálddahuslaš stivrenjoavkkus 	čohkkaba 	Sámedikki ovddas Veslemøy Dahl ja Kirsten Anne Guttorm , ja Anne Cathrine Larsen ja Kari Meløy ges fylkkagieldda ovddas .ERR
Jos galgá oanehaččat čoahkkáigeassit ráđđehusa ja Sámedikki báktelága rievdaárvalusas , de sáhttá dušše okte vel duođaštit ahte Sámediggi ja ráđđehus 	čohkkaba 	nu goabbatbealde beavddi go oba sáhttá ge .ERR
Jos galgá oanehaččat čoahkkáigeassit ráđđehusa ja Sámedikki báktelága rievdadanárvalusas , de sáhttá dušše okte vel duođaštit ahte Sámediggi ja ráđđehus 	čohkkaba 	nu goabbatbealde beavddi go oba sáhttá ge .ERR
Dat eai leat vuordán ahte sápmelaččain lea nu stuora fápmu go sii 	čohkkanit 	buot njealji riikas .ERR
Dakkaraš vearredagu dihte sahtta šaddat 	čohkkat 	máŋga jagi , muitala Henriksen .ERR
Son rávká buorebeaivvi ja 	čohkkana 	stuolloravdii .ERR
Olmmái sáhkkohalla maiddái 2000 ruvnnuin , maid maiddái sáhttá njeallji beaivvi giddagasas 	čohkkamiin 	máksit .DUŠŠ
Politihkkáriid árgabeaivi lea dakkár ahte ii sáhte vuordit beassat agibeaivve 	čohkkat 	.ERR
Guovdageainnus ii báljo gávdno ge alla 	čohkka 	, nu mot fylkamánni lea čuoččuhan , dadjá Hætta .
Nuorttaguvlui geačadettiin oaidnit sabmámin Gorvegacca , mii lea guovllu alimus 	čohkka 	.
Dáža , ruoŧŧelaš ja sápmelaš 	čohkkajedje 	šaldi alde DUŠŠ
Mánát aitto 	čohkkadallege 	biillas .DUŠŠ
Lagabui 20 olbmo ledje 	čohkkanan 	digaštallat boahtteáiggi sámediggepolitihka .ERR
	Science texts –
Suolojár njárga Rovvejoh 	čohkka 	olleslavttus - oktasaš mearus- ja vuođđooassi
Dákkár semantihkalaš ovttageardánahttima sáhttá konkretiseret govvosiin 18. gáisá várri 	čohkka 	oaivi njunni aláš skáidi bávti
Dán loatnanamasnai lea adnojuvvon vuođđooasis buhttenappellatiivan dánskkagiela oppalaš tearbma berg mii ii govčča sámegiela 	čohkka 	semantihkalaš sisdoalu .
Vuođđooassin adnojuvvon appellatiivvaid gáisá , 	čohkka 	, oaivi , várri ja bávti buohtastahttin govvosis 22 čájeha , mo sámegiela vuođđooasseappellatiivvaid álgoálgosaš mearkkašupmejuohkáseapmi rievddai ollásit , go dát luonddunamahusat jorgaluvvojedje iešguđet láhkai dárogillii .
Dárogiel luonddunamahusat maiguin vuođđooasseappellatiivvat - gáisá , - 	čohkka 	, - oaivi , - várri ja - bávti leat jorgaluvvon dárogillii Mátta-Várjjaga grádamihttokárttaid bái- kenamain .

Áhčči dušše bázii 	čohkkat 	beavdegurrii .ERR
Guokte vieljaža manaiga oktii mánuteahpin mearragáddái fievrras rieavanii 	čohkkat 	121 ERR
