[word = "rahkadit"]

Boađus: 52
		
Cealkkačájeheapmi
	Administrative texts –
Buoridandihte gelbbolašvuođa , lea Mánáidsuodjalusa Gelbbolašvuođaguovddáš Davvi-Norggas ožžon doarjaga 	rahkadit 	njeallje fáddágihpagažža mánáidsuodjalusa birra sámi oktavuođain .
Dat boahta sihke das ahte lea váttis fidnet olbmuid geain lea gelbbolašvuohta 	rahkadit 	oahpponeavuid , ja das go ii gávdno doarvái ruhta álggahit nu olu prošeavttaid ahte buot fágasurggiid govččašii .
Dasa lassin ahte lei váttis 	rahkadit 	tiibmoplána ja daid olu bihttáide , de lei váttis gávdnat girjjiid .
Orohat galgá geavahan-njuolggadusaid olis maiddái 	rahkadit 	njuolggadusaid orohaga oktasaš resurssaid geavaheami birra , nugo áiddiid // gárddiid ja eará oktasaš rusttegiid .
	Avvir –
Ávžžuhan eará boazodoalli 	rahkadit 	seamma lágan raporta mii sáhttá leat veahkeneavvu gielddaide ja eará ealáhusaide , dadjá Smuk .
Kárášjoga joavku rOlFa lea dán geasi čuojahan miehtá Finnmárkku ja máŋgii jo čájehan ahte máhttet eallima 	rahkadit 	go čuojahit .
Skuvllas besset mánát earret eará oahppat buđehiid čohkket , muorjemáihlli ja measttu 	rahkadit 	, muoraid čuollat , skuvlagođiin bargat , gámasuoidneráhkadeami , ja guolásteami .
Mun manan sandálaid 	rahkadit 	!
Ja soai leaba maid beassan 	rahkadit 	tv-ášši , mii ikte lei Ođđasiin .
Anna Cicilie mielas lei hui somá 	rahkadit 	tv-ášši , Elen Kristina mielas lei fas dohkálaš somá .
Skuvllas besset mánát earret eará oahppat buđehiid čohkket , muorjemáihlli ja measttu 	rahkadit 	, muoraid čuollat , skuvlagođiin bargat , gámasuoidneráhkadeami , ja guolásteami .
Ovdaprošeavtta ulbmil lea buktit plána ja válddahusa lullisámegiela oahppoprošektii mii galgá čađahuvvot golmma jagi badjel , ja bušeahta 	rahkadit 	, joatká Gaski .
Romssa Universitehta dutki , Trond Trosterud , muitala sii háliidit geavahit sámi digitála giellateknologiija veahkehit 	rahkadit 	giellaoahpahusprográmmaid komi- , njenecagillii ja gielddasámegillii .
Dat lea nu aseheapme ahte lea veadjemeahttun 	rahkadit 	dakkár vakuuma máilbmi buoremus laboratoriijain .
Olga lea máistán lohttejuvvon dorski masa son bures liikui vaikko lei imašlaš vuohki 	rahkadit 	guoli .
Ja soai leaba maid beassan 	rahkadit 	tv-ášši , mii ikte lei Ođđasiin .
Anna Cicilie mielas lei hui somá 	rahkadit 	tv-ášši , Elen Kristina mielas lei fas dohkálaš somá .
Muhto lihká ii dieđihan FeFo go mearridedje guhtta mánu maŋŋá 	rahkadit 	foandda maid dušše FeFo galggai hálddašit .
Sofia Jannok máhtii 	rahkadit 	eallima festiválakroas ja oaččui olbmui mielde lávlut ja juoigat .
« Sámediggi šaddá dan maid sápmelaččat ieža 	rahkadit 	das » .
Kirsten Marit Olsen , Guovdageainnus , lea ožžon sámedikkis 80.000 ruvnnu doarjaga , 	rahkadit 	ođđa CD- skearru mas árbevirolaš luođit 2009:s gullojit .
Mun manan sandálaid 	rahkadit 	!
V Boares vuojadanáldása 	rahkadit 	iešguđetlágan doaluidlatnjan .
, lea son guhte fuomášii kaleandara 	rahkadit 	.
Sárgunfilmmaid lea vejolaš ođđa vugiin dihtoris 	rahkadit 	.
Son ii loga sáhttit vuorjat olbmuid geat máhtáše dakkár cd:id 	rahkadit 	.
– Mii gal dieđusge fertiimet 	rahkadit 	sutnje luođi , muitala rOlfFa joavkku váldolávlu , son maid muitala ahte sin joavku lei áidna joavku Gaskaijarockas geat orro festivála leairras .
	Min Aigi –
Danne sii gáibidit , ahte gielddahálddahus bargagoahtá 	rahkadit 	positiivvalaš gova gielddas .
Gii lea gii vuoitá dahje táhpe jus 	rahkadit 	gievrras sámegielat áviissa ?
Historjjá álggii ná : Sámediggi lei juo guhká rahčan 	rahkadit 	« Sámi riddo- ja vuotnaguovlluid doaibmaplána » , mii lea okta daid miljárdda plánain maid Sámediggi lea ráhkadan , muhto maid ii oktage hálit oaidnit .
AUF dáhttu 	rahkadit 	sierra « Guovllu Agenda 21 » , ja « Fylkkagieldda birasplána Finnmárkui » .
Sii maid dáhttot áigeresurssat 	rahkadit 	oahpponeavvuid , ja vel ahte juohkinlohku luohkáid sturrodaga ektui buorrána .
Gilisearvvi jahkečoahkkin vuosttalda garrasit áigumuša 	rahkadit 	Goahteluoppal-guovllu álbmotmeahccin .
ja buohkaid friddja diktit 	rahkadit 	TV !
Son lea álgan guldalit techno-musihka , ja sus lea jurdda 	rahkadit 	musihka mas leat veaha techno-inspiration .
Sii galget 	rahkadit 	seaidneáviisa OD birra , gosa ruđat mannet .
VG lei čállán dan birra , ja Nordahl Carlsen oaččui dalle idea 	rahkadit 	filmma dán girjjás searvvi birra .
Finnmárkkufylkkadiggí áigu dál vuoruhit kultuvrra , ja dainna lágin 	rahkadit 	500 kultuvra bargosaji fylkii .
Eakton lea ahte 	rahkadit 	buriid eavttuid Finnmárkku eanan vuoigatvuođaid hálddašeapmái , nu ahte ovttasbarggut gaskkal albmogiid Finnmárkkus doibmet soabalašvuođas .
Álggos lei Mikkelsen jurddašan 	rahkadit 	dušše dokumeanttašuvnna ovddeš mearrásámiid árbevieruin .
– Jos šaddá duohtan ahte 	rahkadit 	čierastallan luohkká Salaščohkkii de boahtá dat váikkohit boazudollui .
Soai galgaba goappašagat ddáidaga 	rahkadit 	báikkalaš ávdnasiiguin
Dat mearkkaša ahte gielddat ovttasráđii kultuvraskuvllain dahje vuođđuskuvllain 	rahkadit 	dákkár plána , mas lea oktasaš áddejupmi ahte kultuvra lea dehálaš mánáide skuvllas .
Muhto hutkkai go mii leimmet , mii mearrideimmet 	rahkadit 	savzzagallamallasa .
Nuorat v &#x88;ldet iezas dihtoriid ovtta sadjái , omd. ovtta skihppára lusa , bidjet oktii dihtoriid ja spillejit spillaid , juhket ja 	rahkadit 	programmaid .
– Leat viggan 	rahkadit 	márkaniid Sámi Cup olis , vai misge Kárášjogas leat geassemárkanat .
Katja buollá 	rahkadit 	álbma guhkes fikšenfilmma iežas álbmogis .
– Kulturjoavku galgá 	rahkadit 	sámi kulturčájálmasa min arktalaš oappá- ja vielljaálbmogii , muitala kulturprográmma jođiheaddji Dag Broch .
Giđa rádjái 	rahkadit 	15 prográmma ja reastta vel boahtte čavčča , muitala Labba .
Álggos han lei plánejuvvon 	rahkadit 	stuorra ” badelanda ” , muhto dat livčče leamen menddo divrras , gielddas ii livčče ráđđi dasa .
-”Asttoáigis láven cohkkát garasjas hutkat ja 	rahkadit 	odda lávlai , mun okto , vuoi earaidguin .
-”Asttoáigis láven cohkkát garasjas hutkat ja 	rahkadit 	odda lávlai , mun okto , vuoi earaidguin .

[word = "rahkada"]
Rauni Vest Simonsen 	rahkada 	čiŋaid ieš ja liiko vuovdalit daid márkaniin .
atná jápmán nasisttaid ja muohttaga ja 	rahkada 	das gelddolaš guoimmuheame ja ođasmahttá zombie filmmaid .
Lea maiddái okta interaktiiva filbma čájálmasas mas leat bohccot guohtumin filmmas , bohccot bohtet lagabui ja lagabui geahči , gitta geahči doške gieđaid , dahje 	rahkada 	garra jiena , de báhtarit bohccot fas .
Dát njivli 	rahkada 	mirkko PSP mii lea jámolaš , ja soaitá lassánan meara liegganeami dihtii .
	Min Aigi –
Juohkehašhan seaguha iežas vásáhusaid dasa maid čálbmi oaidná ja 	rahkada 	dan bokte iežas mearkkašumi govvii . 

[word = "rahkadan"]
Boađus: 56
			
Cealkkačájeheapmi
	Administrative texts –
Fylkkamánnit Finnmárkkus , Romssas ja Nordlánddas leat ovttas Sámedikkiin 	rahkadan 	diehtojuohkkinčállosa mii lea sáddejuvvon gielddaide ja earáide olles riikkas .
	Avvir –
Muhto joavkkut leat álo ovttas 	rahkadan 	musihka liikká vaikko čuojahit iešguđet joavkkus , dadjá Lars Vaular .
Hirbmat somá go álbmot liikui maid mun lean 	rahkadan 	, dat attii munnje hui buorre dovddu ja dat dušše addá munnje eanet miela designet viidásabbot , muitala lihkolaš vuoiti Márjá-Liissá Partapuoli .
Ii leat maŋemuš háve gal go mii sápmelaččat boahtit oaidnit ja sihkkarit boahtteáiggis maid beassat geavahit daid biktasiid ja čiŋaid maid Sámi ođđa bivnnut hábmejeaddji lea 	rahkadan 	.
Tv-ášši 	rahkadan 	Sudnos leamaš oalle hoahpu ja olu bargu Kárášjogas .
– Mun lean álo liikon Hermann Rorschacha bleahkkareiddet jurddašan vuohkái , mo olbmot láhttegohtet go oidnet bleahkkafiguvrraid , ja dat oidno dan bihttás go mii leat gráfalaččat 	rahkadan 	dákkár bleahkkahámiid mat oidnojit čájálmasas ja jurdda lea gávdnat olbmuid duohtavuođa daiguin bleahkka hámiiguin , čilge Skåden .
Dál lea addojuvvon ruhtadoarjja dáža homofiillaid organisašuvdnii , LLH : ii , 	rahkadan 	dihte sierra neahttasiiddu homofiila sápmelaččaide , ja sin birra .
Biret Laila Eira vuovdala dujiid maid bargoguovddažis ieža leat 	rahkadan 	.
Searvvi lea 	rahkadan 	doaibmaplána man váibmoášši lea joatkit mánáid ja nuoraid giellabarggu ovddosguvlui .
go dii ehpet leat 	rahkadan 	gurrenbáikki , de ehpet beroš luonddus .
Vaikko Finnmárku lea vuosttaš fylkkasuohkan davvin mii lea 	rahkadan 	dakkár Riska- ja raššivuođaanalysa , de lohká fylkkamánni ahte Davvi-Norga lea eanemusat bázahallan analysaid ektui .
Norgga oasusovttastupmi Funcom guhte lea 	rahkadan 	beakkán online dihtorspeala Age of Conan lea almmuheame rájes , Miessemánu rájes , gahččan 55,50 ruvnnos 13,65 ruvdnui ( diibmu 13.25 ikte ) , dat dagaha masá 400 proseantta .
Lea ádjás bargu go 	rahkadan 	dušše ovtta das , inge sáhte mange láhkai geahpedit barggu .
, maid Molotov Cocktail ledje 	rahkadan 	, Kararockas lávvardaga .
Oahppit ja sin vátnemat ledje geat leat 	rahkadan 	revya ja sii leat áddestaddan ja geavahan dáhpáhusaid mat leat geavvan Kárášjogas ja sámi servodagas .
Neahttaservvodagas Facebook:as leat sii 	rahkadan 	joavkku
Sii čuojahedje rocklávlagiid maid ieža leat 	rahkadan 	.
Márkanfievrrideami oktavuođas lea Biergodiehtokantuvra 	rahkadan 	3 márkanfievrridan filmma .
Eurohpá guliid šaddu lea beali unnit go ovdal , ja smávvaguolit dagahit stuorát ja stuorát oasi obbalaš logus , čájeha rappoarta maid Cemagref Public Agricultural and Enviromental research Institute Lyonas , Fránskkas , lea 	rahkadan 	.
leat 	rahkadan 	Deanu Gildii , iešsorbmen eastalan plána .
jođiheaddji ja dál son ja ovddeš Gielddadoavttirin Sigrunn Winterfeldt leaba 	rahkadan 	dán plána , mii galgá bistit gaskal 2009-2013 .
– Mun lean álo liikon Hermann Rorschacha bleahkkareiddet jurddašan vuohkái , mo olbmot láhttegohtet go oidnet bleahkkafiguvrraid , ja dat oidno dan bihttás go mii leat gráfalaččat 	rahkadan 	dákkár bleahkkahámiid mat oidnojit čájálmasas ja jurdda lea gávdnat olbmuid duohtavuođa daiguin bleahkka hámiiguin , čilge Skåden .
Márjá-Liissá hábmen ja 	rahkadan 	dán čuvlla mii sus lea badjelis .
Hirbmat somá go álbmot liikui maid mun lean 	rahkadan 	, dat attii munnje hui buorre dovddu ja dat dušše addá munnje eanet miela designet viidásabbot , muitala lihkolaš vuoiti Márjá-Liissá Partapuoli .
Ii leat maŋemuš háve gal go mii sápmelaččat boahtit oaidnit ja sihkkarit boahtteáiggis maid beassat geavahit daid biktasiid ja čiŋaid maid Sámi ođđa bivnnut hábmejeaddji lea 	rahkadan 	.
Willoch lea ieš 	rahkadan 	rehketstuhka mii čájeha ahte doarjja bearrašii mas leat golbma máná , vearrogessosa ja mánnasdikšundoarjja ektui , dagahii 1995:s 9,3 proseanta gaskamearalašbálkkás .
Soai leaba 	rahkadan 	neahttasiiddu gos beasat lohkat sámi kultuvrra birra ja jus lea miella lasihit de sáhtát válddit oktavuođa sudnuin .
Dál lea addojuvvon ruhtadoarjja dáža homofiillaid organisašuvdnii , LLH : ii , 	rahkadan 	dihte sierra neahttasiiddu homofiila sápmelaččaide , ja sin birra .
Maŋŋelaš dán jagi galgá son maid leat 	rahkadan 	rieja ja čiekčan ovtta biilla mii lei parkerejuvvon gávpogis
	Non-fiction texts –
Universitehta , Rolf Gaasland ja Anniken Greve , Textpraxis dutkanjoavku , leat 	rahkadan 	.
Muđuid ledje hui olu stensiilat maid oahpaheaddjit ledje 	rahkadan 	.
	Min Aigi –
Govaid lea Merja Aletta Ranttila 	rahkadan 	.
VIEJKERIEKKAS:Dáiddár Maj-Doris Rimpi lea geavahan datneárpmu teknihka go lea 	rahkadan 	gova “ Viejkeriekkas ” .
Gunvor lea iešdahtolaccat geavahan ávdnasiid mat eai galggašii heivet čikŋan ja das 	rahkadan 	mosaihka .
Leat skulptuvrrat ja sárgumat maid 10. luohkkálaččat leat 	rahkadan 	.
VIEJKERIEKKIS:Dáiddár Maj-Doris Rimpi lea geavahan datneárpmu teknihka go lea 	rahkadan 	gova “ Viejkeriekkis ” .
VIEJKERIEKKIS:Dáiddár Maj-Doris Rimpi lea geavahan datneárpmu teknihka go lea 	rahkadan 	gova “ Viejkeriekkis ” .
Lea várra nu ahte dat geat leat 	rahkadan 	dán jiekŋateahtera leat oahppan diimmá boastuvuođain .
– Geavai nu ahte olbmot ain eanet bažaladde sámi gálbbai Gáivuonas , máŋŋá go mon ledjen 	rahkadan 	dán hui kritihkkalaččat , logai Solbakk .
Sii leat rahkan smávva rieiddot dujiid nu go vávvai , lávkkai , njuikkonii , guvsiiid ja muhton lei 	rahkadan 	duodje muitospealu .
Sii leat rahkan smávva rieiddot dujiid nu go vávvai , lávkkai , njuikkonii , guvsiiid ja muhton lei 	rahkadan 	duodje muitospealu .
Ovtta beaivve finaimet Palmela satnejodiheaddji dearvvaheamin , ja addimin raddevissui gova maid Merja Aletta Ranttila lei 	rahkadan 	.
KANÁDA ÁLGOÁLBMOT:Alanis Obomsawin lea 	rahkadan 	filmma mii govida movt kanáda álgoalbmoga guolasteaddjit fállehuvvo riddobearraigehčiide .
Filbma maid Alanis Obomsawin lea 	rahkadan 	govida movt kanáda álgoalbmoga guolasteaddjit fállehuvvo riddobearraigehčiide .
HOLVOT:Dáiddár Inga Nordsletta Pedersen lea 	rahkadan 	gova maid lea gohččodan oahppováillagat .
VUITTII : Lullisápmelaš musihkkár Frode Fjellheim vuittii dán jagi Spellemann-gilvvuid rabasluohká iežas 	rahkadan 	CD meassuin
– Mii leat Giellafestiválas 	rahkadan 	kompendiuma , aviissa , mis leat logaldallamat leamaš ja leat giela čatnan teknologiijai , čilge Gaup Eira .
Son lea 	rahkadan 	rock-skearru nuorttalašgillii .
Govva : Rolf “ rOlffa ” Morten lea alccesii 	rahkadan 	musihkastudio garasjas .
-”Na , vuitin varra ” Ungdommens Kulturpris ” danin go mun 	rahkadan 	mushikka ja lávlai mat dán áige nuorat liikojit .
Govva : Rolf “ rOlffa ” Morten lea alccesii 	rahkadan 	musihkastudio garasjas .
-”Na , vuitin varra ” Ungdommens Kulturpris ” danin go mun 	rahkadan 	mushikka ja lávlai mat dán áige nuorat liikojit .
Ofelaš prošeaktajođiheaddji , Marit Broch Johansen , Sámi Allaskuvllas Guovdageainnus muitala ahte ofelaččat leat 	rahkadan 	sierra sámi alfabehta čállosa buohkaide .
Iŋgor Ántte Áilu lei 	rahkadan 	dán luođi .
Olbmot besset maid vásihit sámi fikšen filmma premiera nama lassii « Non profit » maid Pauliina Feodoroff lea 	rahkadan 	.
Anne Katrine lea dánsejeaddji ja koreográfa , ja lea 	rahkadan 	dan čajalmasa Riddu Riđđu festiválii .

[word = "rahkadin"]

Boađus: 1
Cealkkačájeheapmi
	Avvir –
– Mun 	rahkadin 	dán lávlaga go ledjen 16 jahkásaš ja ledjen Johkamohkis dánssas . 