golbmagávccátlohkái+Num+Pl+Attr	oktačuohtigolmma>ingávccátlot>	ˈokː.htɑ#tʃˌuoh.ti#kˌolm.mɑ>in#kˌɑːβɸ.tsɑːt#lˌot>
guhttanuppelogis+N+Coll+Pl+Nom	oktačuohtiguhttanuppelohkás>at	ˈokː.htɑ#tʃˌuoh.ti#kˌuhː.tɑ#nˌup.pe#lˌohː.kɑːs>ɑh
guhttaloginubbi+A+Ord+Sg+Gen	oktačuohtiguhttaloginuppe>	ˈokː.htɑ#tʃˌuoh.ti#kˌuhː.tɑ#lˌo.gi#nˌup.pe>
gávcciviđatlohkái+Num+Sg+Attr	oktačuohtigákci>nviđátlot>	ˈokː.htɑ#tʃˌuoh.ti#kˌɑːkː.htsi>n#vˌi.ðɑːt#lˌot>
gávccilogioktanuppelogát+A+Ord+Sg+Acc	oktačuohtigávccilogioktanuppelogád>a	ˈokː.htɑ#tʃˌuoh.ti#kˌɑːβɸ.tsi#lˌo.gi#ˌokː.htɑ#nˌup.pe#lˌo.gɑːd>ɑ
gávccilogivuosttaš+A+Ord+Sg+Gen+PxDu3	oktačuohtigávccilogivuosttaž>easkka	ˈokː.htɑ#tʃˌuoh.ti#kˌɑːβɸ.tsi#lˌo.gi#vˌuos.tɑž>eæs.kɑ
gávccičihččetlohkái+Num+Ess	oktačuohtigávcci>čihččetlogi>n	ˈokː.htɑ#tʃˌuoh.ti#kˌɑːβɸ.tsi>#tʃˌihː.tʃet#lˌo.gi>n
njealljeovccátlohkái+Num+Pl+Attr	oktačuohtinjelji>inovccátlot>	ˈokː.htɑ#tʃˌuoh.ti#ɲˌeʎ.ʎi>in#ˌoβɸ.tsɑːt#lˌot>
nubbečihččetlohkái+Num+Sg+Attr	oktačuohtinubbe>čihččetlot>	ˈokː.htɑ#tʃˌuoh.ti#nˌubː.pe>#tʃˌihː.tʃet#lˌot>
nubbečihččetlohkái+Num+Sg+Attr	oktačuohtinubbi>nčihččetlot>	ˈokː.htɑ#tʃˌuoh.ti#nˌubː.pi>n#tʃˌihː.tʃet#lˌot>
nubbeviđátlohkái+Num+Sg+Loc	oktačuohtinuppe>viđátlogi>s	ˈokː.htɑ#tʃˌuoh.ti#nˌup.pe>#vˌi.ðɑːt#lˌo.gi>s
oktaguđátlogát+A+Ord+Sg+Gen+PxDu2	oktačuohtioktaguđátlogád>eatte	ˈokː.htɑ#tʃˌuoh.ti#ˌokː.htɑ#kˌu.ðɑːt#lˌo.gɑːd>ĕæt.te
oktanuppelohkái+Num+Ess	oktačuohtiovtta>tnuppelogi>n	ˈokː.htɑ#tʃˌuoh.ti#ˌoβɸ.tɑ>t#nˌup.pe#lˌo.gi>n
oktaovccátlohkái+Num+Sg+Ill	oktačuohtiovtta>ovccátlohká>i	ˈokː.htɑ#tʃˌuoh.ti#ˌoβɸ.tɑ>#ˌoβɸ.tsɑːt#lˌohː.kɑː>i
ovcciovccátlohkái+Num+Sg+Attr	oktačuohtiokci>novccátlot>	ˈokː.htɑ#tʃˌuoh.ti#ˌokː.htsi>n#ˌoβɸ.tsɑːt#lˌot>
ovccičihččetlohkái+Num+Sg+Attr	oktačuohtiokci>nčihččetlot>	ˈokː.htɑ#tʃˌuoh.ti#ˌokː.htsi>n#tʃˌihː.tʃet#lˌot>
ovccinjealjátlohkái+Num+Pl+Acc	oktačuohtiovcci>njealjátlogi>id	ˈokː.htɑ#tʃˌuoh.ti#ˌoβɸ.tsi>#ɲˌeæʎ.ʎɑːt#lˌo.gi>id
ovccičihččetlohkái+Num+Ess	oktačuohtiovcci>tčihččetlogi>n	ˈokː.htɑ#tʃˌuoh.ti#ˌoβɸ.tsi>t#tʃˌihː.tʃet#lˌo.gi>n
vihttalogičieža+Num+Sg+Nom	oktačuohtiviihtta>logičieža>	ˈokː.htɑ#tʃˌuoh.ti#vˌijhː.tɑ>#lˌo.gi#tʃˌie.dʃɑ>
vihttanuppelohkái+Num+Pl+Ill+Attr	oktačuohtiviđa>idnuppelogi>id	ˈokː.htɑ#tʃˌuoh.ti#vˌi.ðɑ>id#nˌup.pe#lˌo.gi>id
vihttaovccátlohkái+Num+Pl+Acc	oktačuohtivihtta>ovccátlogi>id	ˈokː.htɑ#tʃˌuoh.ti#vˌihː.tɑ>#ˌoβɸ.tsɑːt#lˌo.gi>id
vihttaviđatlohkái+Num+Sg+Nom	oktačuohtivihtta>viđatlohká>i	ˈokː.htɑ#tʃˌuoh.ti#vˌihː.tɑ>#vˌi.ðɑt#lˌohː.kɑː>i
vihttačihččetlohkái+Num+Ess	oktačuohtiviđa>tčihččetlogi>n	ˈokː.htɑ#tʃˌuoh.ti#vˌi.ðɑ>t#tʃˌihː.tʃet#lˌo.gi>n
vihttagoalmmátlogis+N+Coll+Ess	oktačuohtivihttagoalmmátlogis>in	ˈokː.htɑ#tʃˌuoh.ti#vˌihː.tɑ#kˌoɑlm.mɑːt#lˌo.gis>in
vihttanuppelogát+A+Ord+Der/vuohta+N+Sg+Loc+PxPl3	oktačuohtivihttanuppelogát>»»»vuođa>st>easet	ˈokː.htɑ#tʃˌuoh.ti#vˌihː.tɑ#nˌup.pe#lˌo.gɑːt>»»»#vˌuo.ðɑ>st>ĕæ.seh
vihttaviđátlogis+N+Coll+Ess	oktačuohtivihttaviđátlogis>in	ˈokː.htɑ#tʃˌuoh.ti#vˌihː.tɑ#vˌi.ðɑːt#lˌo.gis>in
vihttaloginjealljenuppelogát+A+Ord+Attr	oktačuohtivihttaloginjealljenuppelogát>	ˈokː.htɑ#tʃˌuoh.ti#vˌihː.tɑ#lˌo.gi#ɲˌĕæʎː.ʎe#nˌup.pe#lˌo.gɑːt>
čiežalogátlohkái+Num+Ess	oktačuohtičieža>logátlogi>n	ˈokː.htɑ#tʃˌuoh.ti#tʃˌie.dʃɑ>#lˌo.gɑːt#lˌo.gi>n
čiežalogátlohkái+Num+Ess	oktačuohtičieža>tlogátlogi>n	ˈokː.htɑ#tʃˌuoh.ti#tʃˌie.dʃɑ>t#lˌo.gɑːt#lˌo.gi>n
čiežalogátlohkái+Num+Sg+Acc	oktačuohtičieža>logátlohká>i	ˈokː.htɑ#tʃˌuoh.ti#tʃˌie.dʃɑ>#lˌo.gɑːt#lˌohː.kɑː>i
čiežačihččetlohkái+Num+Pl+Attr	oktačuohtičieža>inčihččetlot>	ˈokː.htɑ#tʃˌuoh.ti#tʃˌie.dʃɑ>in#tʃˌihː.tʃet#lˌot>
čiežaovccátlogis+N+Coll+Ess	oktačuohtičiežaovccátlogis>in	ˈokː.htɑ#tʃˌuoh.ti#tʃˌie.dʃɑ#ˌoβɸ.tsɑːt#lˌo.gis>in
čiežalogigávccinuppelogát+A+Ord+Sg+Ill	oktačuohtičiežalogigávccinuppelogád>ii	ˈokː.htɑ#tʃˌuoh.ti#tʃˌie.dʃɑ#lˌo.gi#kˌɑːβɸ.tsi#nˌup.pe#lˌo.gɑːd>ij
čiežalogioktanuppelogát+A+Ord+Sg+Nom	oktačuohtičiežalogioktanuppelogát>	ˈokː.htɑ#tʃˌuoh.ti#tʃˌie.dʃɑ#lˌo.gi#ˌokː.htɑ#nˌup.pe#lˌo.gɑːt>
čiežalogiovccis+N+Coll+Sg+Ill+PxSg1	oktačuohtičiežalogiokcás>asa>n	ˈokː.htɑ#tʃˌuoh.ti#tʃˌie.dʃɑ#lˌo.gi#ˌokː.htsɑːs>ɑ.sɑ>n
čiežalogivihttanuppelogát+A+Ord+Der/vuohta+N+Sg+Gen+PxPl2	oktačuohtičiežalogivihttanuppelogát>»»»vuođa>det	ˈokː.htɑ#tʃˌuoh.ti#tʃˌie.dʃɑ#lˌo.gi#vˌihː.tɑ#nˌup.pe#lˌo.gɑːt>»»»#vˌuo.ðɑ>deh
čiežalogigávcci+Num+Ess	oktačuohtičieža>logigávcci>n	ˈokː.htɑ#tʃˌuoh.ti#tʃˌie.dʃɑ>#lˌo.gi#kˌɑːβɸ.tsi>n
čiežaloginjeallje+Num+Sg+Nom	oktačuohtičieža>loginjeallje>	ˈokː.htɑ#tʃˌuoh.ti#tʃˌie.dʃɑ>#lˌo.gi#ɲˌĕæʎː.ʎe>
čiežalogivihtta+Num+Sg+Com	oktačuohtičieža>inlogiinviđa>in	ˈokː.htɑ#tʃˌuoh.ti#tʃˌie.dʃɑ>in#lˌo.gijn#vˌi.ðɑ>in
čiežalogičieža+Num+Pl+Gen	oktačuohtičieža>logičieža>id	ˈokː.htɑ#tʃˌuoh.ti#tʃˌie.dʃɑ>#lˌo.gi#tʃˌie.dʃɑ>id
čiežalogičieža+Num+Sg+Gen	oktačuohtičieža>logičieža>	ˈokː.htɑ#tʃˌuoh.ti#tʃˌie.dʃɑ>#lˌo.gi#tʃˌie.dʃɑ>
AIDS+N+Sg+Nom	AIDS>	ˈɑjds>
AIDS+N+Ess	AIDSa>n	ˈɑjd.sɑː>n
AIDS+N+Pl+Com+PxSg1	AIDSa>id>anguin	ˈɑjd.sɑː>id>ɑn.gujn
AIDS+N+Sg+Nom+PxPl3	AIDSa>>set	ˈɑjd.sɑː>>seh
AIDS+N+Sg+Loc	AIDSa>s	ˈɑjd.sɑː>s
AIDS+N+Sg+Loc+PxPl2	AIDSa>st>eattet	ˈɑjd.sɑː>st>ĕæt.teh
AIDS+N+Sg+Ill+PxDu1	AIDSa>s>eame	ˈɑjd.sɑː>s>ĕæ.me
AIDS+N+Sg+Ill+PxSg1	AIDSa>s>an	ˈɑjd.sɑː>s>ɑn
AIDS+N+Der/Dimin+N+Sg+Nom	AIDSa»š	ˈɑjd.sɑː»ʃ
AIDS+N+Der/Dimin+N+Der/viđá+Adv	AIDSa»š»viđá	ˈɑjd.sɑː»ʃ»#vˌi.ðɑː
AIDS+N+Der/Dimin+N+Ess	AIDSa»žin	ˈɑjd.sɑː»žin
AIDS+N+Der/Dimin+N+Pl+Nom	AIDSa»žat	ˈɑjd.sɑː»žɑh
AIDS+N+Der/Dimin+N+Sg+Nom+PxDu3	AIDSa»žeaskka	ˈɑjd.sɑː»žeæs.kɑ
AIDS+N+Der/Dimin+N+Sg+Ill+PxDu2	AIDSa»žasa>de	ˈɑjd.sɑː»žɑ.sɑ>de
AIDS+N+Der/Dimin+N+Sg+Ill+PxDu3	AIDSa»žasa>ska	ˈɑjd.sɑː»žɑ.sɑ>skɑ
AIDS+N+Sg+Ill	AIDSi>i	ˈɑjd.si>i
Biehtárvahkku+Sem/Time+N+Sg+Acc+PxPl2	Biehtárvahko>det	pˈieh.tɑːr#vˌɑh.ko>deh
Biehtárvahkku+Sem/Time+N+Sg+Acc+PxSg2	Biehtárvahko>t	pˈieh.tɑːr#vˌɑh.ko>h
Biehtárvahkku+Sem/Time+N+Der/laš+A+Superl+Sg+Gen	Biehtárvahko»lepmos>a	pˈieh.tɑːr#vˌɑh.ko»lep.mos>ɑ
Biehtárvahkku+Sem/Time+N+Der/laš+A+Der/vuohta+N+Der/viđá+Adv	Biehtárvahko»laš»»»vuohta»viđá	pˈieh.tɑːr#vˌɑh.ko»lɑʃ»»»#vˌuoh.tɑ»vi.ðɑː
Biehtárvahkku+Sem/Time+N+Pl+Nom	Biehtárvahku>t	pˈieh.tɑːr#vˌɑh.ku>h
Biehtárvahkku+Sem/Time+N+Sg+Com+PxDu2	Biehtárvahku>in>eatte	pˈieh.tɑːr#vˌɑh.ku>in>ĕæt.te
Biehtárvahkku+Sem/Time+N+Der/heapmi+A+Attr	Biehtárvahku»his>	pˈieh.tɑːr#vˌɑh.ku»his>
Biehtárvahkku+Sem/Time+N+Der/huhtti+V+TV+Ind+Prt+ConNeg	Biehtárvahku»huhttá>n	pˈieh.tɑːr#vˌɑh.ku»huhː.tɑː>n
Biehtárvahkku+Sem/Time+N+Der/huvva+V+IV+Ind+Prt+ConNeg	Biehtárvahku»huvva>n	pˈieh.tɑːr#vˌɑh.ku»huv.vɑ>n
Biehtárvahkku+Sem/Time+N+Sg+Ill+PxSg1	Biehtárvahkko>s>an	pˈieh.tɑːr#vˌɑhː.ko>s>ɑn
Biehtárvahkku+Sem/Time+N+Sg+Nom+PxDu2	Biehtárvahkko>de	pˈieh.tɑːr#vˌɑhː.ko>de
Biehtárvahkku+Sem/Time+N+Sg+Nom+PxPl1	Biehtárvahkko>met	pˈieh.tɑːr#vˌɑhː.ko>meh
Biehtárvahkku+Sem/Time+N+Der/huhtti+V+TV+PrfPrc	Biehtárvahkko»huhttá>n	pˈieh.tɑːr#vˌɑhː.ko»huhː.tɑː>n
Biehtárvahkku+Sem/Time+N+Der/laš+A+Attr+Der/vuohta+N+Ess	Biehtárvahkko»laš>»»»vuohta>n	pˈieh.tɑːr#vˌɑhː.ko»lɑʃ>»»»#vˌuoh.tɑ>n
Biehtárvahkku+Sem/Time+N+Der/viđá+Adv	Biehtárvahkko»viđá	pˈieh.tɑːr#vˌɑhː.ko»vi.ðɑː
Biehtárvahkku+Sem/Time+N+Sg+Loc+PxSg3	Biehtárvahkku>st>is	pˈieh.tɑːr#vˌɑhː.ku>st>is
Biehtárvahkku+Sem/Time+N+Sg+Com+PxPl2	Biehtárvahkku>in>eattet	pˈieh.tɑːr#vˌɑhː.ku>in>ĕæt.teh
Biehtárvahkku+Sem/Time+N+Sg+Com+PxPl3	Biehtárvahkku>in>easet	pˈieh.tɑːr#vˌɑhː.ku>in>ĕæ.seh
Birggetbeaivi+Sem/Time+N+Pl+Com+PxSg3	Birggetbeivvi>id>isguin	pˈirk.ket#pˌejv.vi>id>is.gujn
Birggetbeaivi+Sem/Time+N+Pl+Com	Birggetbeivvi>iguin	pˈirk.ket#pˌejv.vi>i.gujn
Birggetbeaivi+Sem/Time+N+Sg+Com	Birggetbeivvi>in	pˈirk.ket#pˌejv.vi>in
Birggetbeaivi+Sem/Time+N+Sg+Com+PxDu1	Birggetbeivvi>in>eame	pˈirk.ket#pˌejv.vi>in>ĕæ.me
Birggetbeaivi+Sem/Time+N+Sg+Com+PxDu3	Birggetbeivvi>in>easkka	pˈirk.ket#pˌejv.vi>in>eæs.kɑ
Birggetbeaivi+Sem/Time+N+Sg+Com+PxSg2	Birggetbeivvi>in>at	pˈirk.ket#pˌejv.vi>in>ɑh
Birggetbeaivi+Sem/Time+N+Sg+Com+PxSg3	Birggetbeivvi>in>is	pˈirk.ket#pˌejv.vi>in>is
Birggetbeaivi+Sem/Time+N+Der/viđá+Adv	Birggetbeaive»viđá	pˈirk.ket#pˌĕæjː.ve»vi.ðɑː
Birggetbeaivi+Sem/Time+N+Sg+Nom	Birggetbeaivi>	pˈirk.ket#pˌĕæjː.vi>
Birggetbeaivi+Sem/Time+N+Sg+Ill	Birggetbeaivá>i	pˈirk.ket#pˌĕæjː.vɑː>i
Birggetbeaivi+Sem/Time+N+Der/huvva+V+IV+Imprt+Sg2	Birggetbeaivve»huva>	pˈirk.ket#pˌĕæjv.ve»hu.vɑ>
Birggetbeaivi+Sem/Time+N+Der/huvva+V+IV+Der/NomAct+N+Sg+Ill+PxDu1	Birggetbeaivve»huvva>»m>asa>me	pˈirk.ket#pˌĕæjv.ve»huv.vɑ>»m>ɑ.sɑ>me
Birggetbeaivi+Sem/Time+N+Pl+Nom	Birggetbeaivvi>t	pˈirk.ket#pˌeæjv.vi>h
Birggetbeaivi+Sem/Time+N+Sg+Loc	Birggetbeaivvi>s	pˈirk.ket#pˌeæjv.vi>s
Birggetbeaivi+Sem/Time+N+Der/huhtti+V+TV+Ger	Birggetbeaivvi»huhte>din	pˈirk.ket#pˌeæjv.vi»huh.te>din
Birggetvahkku+Sem/Time+N+Sg+Loc+PxDu1	Birggetvahku>st>eame	pˈirk.ket#vˌɑh.ku>st>ĕæ.me
Birggetvahkku+Sem/Time+N+Der/huhtti+V+TV+VGen	Birggetvahku»huhti>	pˈirk.ket#vˌɑh.ku»huh.ti>
Birggetvahkku+Sem/Time+N+Der/huhtti+V+TV+Ind+Prs+Sg1	Birggetvahku»huhtá>n	pˈirk.ket#vˌɑh.ku»huhː.tɑː>n
Birggetvahkku+Sem/Time+N+Sg+Acc	Birggetvahkku>	pˈirk.ket#vˌɑhː.ku>
Birggetvahkku+Sem/Time+N+Sg+Nom	Birggetvahkku>	pˈirk.ket#vˌɑhː.ku>
Birggetvahkku+Sem/Time+N+Sg+Ill	Birggetvahkku>i	pˈirk.ket#vˌɑhː.ku>i
Erkkebeaivi+Sem/Time+N+Pl+Com+PxPl1	Erkkebeivvi>id>eametguin	ˈerr̥.ke#pˌejv.vi>id>ĕæ.met.gujn
Erkkebeaivi+Sem/Time+N+Pl+Com	Erkkebeivvi>iguin	ˈerr̥.ke#pˌejv.vi>i.gujn
Erkkebeaivi+Sem/Time+N+Pl+Gen	Erkkebeivvi>id	ˈerr̥.ke#pˌejv.vi>id
Erkkebeaivi+Sem/Time+N+Pl+Nom+PxDu3	Erkkebeivvi>id>easkka	ˈerr̥.ke#pˌejv.vi>id>eæs.kɑ
Erkkebeaivi+Sem/Time+N+Pl+Nom+PxSg3	Erkkebeivvi>id>is	ˈerr̥.ke#pˌejv.vi>id>is
Erkkebeaivi+Sem/Time+N+Sg+Com	Erkkebeivvi>in	ˈerr̥.ke#pˌejv.vi>in
Erkkebeaivi+Sem/Time+N+Der/viđá+Adv	Erkkebeaive»viđá	ˈerr̥.ke#pˌĕæjː.ve»vi.ðɑː
Erkkebeaivi+Sem/Time+N+Sg+Gen+PxSg3	Erkkebeaivvi>s	ˈerr̥.ke#pˌeæjv.vi>s
Erkkebeaivi+Sem/Time+N+Der/heapmi+A+Attr	Erkkebeaivvi»his>	ˈerr̥.ke#pˌeæjv.vi»his>
Erkkebeaivi+Sem/Time+N+Der/huhtti+V+TV+Ind+Prs+Sg2	Erkkebeaivvi»huhtá>t	ˈerr̥.ke#pˌeæjv.vi»huhː.tɑː>h
Erkkebeaivi+Sem/Time+N+Der/huvva+V+IV+Imprt+Pl1	Erkkebeaivvi»huvvu>t	ˈerr̥.ke#pˌeæjv.vi»huv.vu>h
Erkkebeaivi+Sem/Time+N+Sg+Gen+PxDu2	Erkkebeaivvá>de	ˈerr̥.ke#pˌeæjv.vɑː>de
Erkkevahkku+Sem/Time+N+Sg+Gen+PxDu2	Erkkevahko>de	ˈerr̥.ke#vˌɑh.ko>de
Erkkevahkku+Sem/Time+N+Der/Dimin+N+Der/Dimin+N+Sg+Loc+PxPl2	Erkkevahko»žačča>st>eattet	ˈerr̥.ke#vˌɑh.ko»žɑt.tʃɑ>st>ĕæt.teh
Erkkevahkku+Sem/Time+N+Der/Dimin+N+Sg+Loc	Erkkevahko»žis	ˈerr̥.ke#vˌɑh.ko»žis
Erkkevahkku+Sem/Time+N+Pl+Com+PxDu1	Erkkevahku>id>eameguin	ˈerr̥.ke#vˌɑh.ku>id>ĕæ.me.gujn
Erkkevahkku+Sem/Time+N+Der/huhtti+V+TV+VGen	Erkkevahku»huhti>	ˈerr̥.ke#vˌɑh.ku»huh.ti>
Erkkevahkku+Sem/Time+N+Sg+Ill+PxDu2	Erkkevahkko>s>eatte	ˈerr̥.ke#vˌɑhː.ko>s>ĕæt.te
Erkkevahkku+Sem/Time+N+Der/viđá+Adv	Erkkevahkko»viđá	ˈerr̥.ke#vˌɑhː.ko»vi.ðɑː
Erkkevahkku+Sem/Time+N+Ess+PxDu3	Erkkevahkku>n>easkka	ˈerr̥.ke#vˌɑhː.ku>n>eæs.kɑ
Eskilvahkku+Sem/Time+N+Sg+Acc+PxDu2	Eskilvahko>de	ˈesː.kil#vˌɑh.ko>de
Eskilvahkku+Sem/Time+N+Der/Dimin+N+Pl+Nom	Eskilvahko»žat	ˈesː.kil#vˌɑh.ko»žɑh
Eskilvahkku+Sem/Time+N+Pl+Nom	Eskilvahku>t	ˈesː.kil#vˌɑh.ku>h
Eskilvahkku+Sem/Time+N+Sg+Acc	Eskilvahku>	ˈesː.kil#vˌɑh.ku>
Eskilvahkku+Sem/Time+N+Sg+Gen+PxSg3	Eskilvahku>s	ˈesː.kil#vˌɑh.ku>s
Eskilvahkku+Sem/Time+N+Sg+Loc+PxSg1	Eskilvahku>st>an	ˈesː.kil#vˌɑh.ku>st>ɑn
Eskilvahkku+Sem/Time+N+Der/huhtti+V+TV+VAbess	Eskilvahku»huhte>keahttá	ˈesː.kil#vˌɑh.ku»huh.te>kĕæhː.tɑː
Eskilvahkku+Sem/Time+N+Der/huhtti+V+TV+Cond+Prs+Sg2	Eskilvahku»huhtá>šedje>t	ˈesː.kil#vˌɑh.ku»huhː.tɑː>ʃec.ce>h
Eskilvahkku+Sem/Time+N+Der/heapmi+A+Ess	Eskilvahkko»heapmi>n	ˈesː.kil#vˌɑhː.ko»heæp.mi>n
Eskilvahkku+Sem/Time+N+Der/viđá+Adv	Eskilvahkko»viđá	ˈesː.kil#vˌɑhː.ko»vi.ðɑː
Eskilvahkku+Sem/Time+N+Ess	Eskilvahkku>n	ˈesː.kil#vˌɑhː.ku>n
Eskilvahkku+Sem/Time+N+Ess+PxDu2	Eskilvahkku>n>eatte	ˈesː.kil#vˌɑhː.ku>n>ĕæt.te
Eskilvahkku+Sem/Time+N+Ess+PxPl2	Eskilvahkku>n>eattet	ˈesː.kil#vˌɑhː.ku>n>ĕæt.teh
Eskilvahkku+Sem/Time+N+Pl+Nom	Eskilvahkku>t	ˈesː.kil#vˌɑhː.ku>h
Eskilvahkku+Sem/Time+N+Pl+Acc	Eskilvahkku>id	ˈesː.kil#vˌɑhː.ku>id
Eskilvahkku+Sem/Time+N+Pl+Nom+PxSg3	Eskilvahkku>id>is	ˈesː.kil#vˌɑhː.ku>id>is
Eskilvahkku+Sem/Time+N+Sg+Ill	Eskilvahkku>i	ˈesː.kil#vˌɑhː.ku>i
Gucco+Interj	Gucco	kˈut.tso
Heaikkavahkku+Sem/Time+N+Sg+Acc+PxDu2	Heaikkavahko>de	hˈeæjç.kɑ#vˌɑh.ko>de
Heaikkavahkku+Sem/Time+N+Der/Dimin+N+Sg+Nom	Heaikkavahko»š	hˈeæjç.kɑ#vˌɑh.ko»ʃ
Heaikkavahkku+Sem/Time+N+Der/Dimin+N+Sg+Ill	Heaikkavahko»žii	hˈeæjç.kɑ#vˌɑh.ko»žij
Heaikkavahkku+Sem/Time+N+Der/laš+A+Attr	Heaikkavahko»laš>	hˈeæjç.kɑ#vˌɑh.ko»lɑʃ>
Heaikkavahkku+Sem/Time+N+Pl+Com+PxSg1	Heaikkavahku>id>anguin	hˈeæjç.kɑ#vˌɑh.ku>id>ɑn.gujn
Heaikkavahkku+Sem/Time+N+Pl+Nom	Heaikkavahku>t	hˈeæjç.kɑ#vˌɑh.ku>h
Heaikkavahkku+Sem/Time+N+Sg+Gen	Heaikkavahku>	hˈeæjç.kɑ#vˌɑh.ku>
Heaikkavahkku+Sem/Time+N+Der/heapmi+A+Sg+Loc	Heaikkavahku»heame>s	hˈeæjç.kɑ#vˌɑh.ku»hĕæ.me>s
Heaikkavahkku+Sem/Time+N+Der/huvva+V+IV+Ind+Prt+Sg2	Heaikkavahku»huvve>t	hˈeæjç.kɑ#vˌɑh.ku»huv.ve>h
Heaikkavahkku+Sem/Time+N+Sg+Acc+PxSg2	Heaikkavahkko>t	hˈeæjç.kɑ#vˌɑhː.ko>h
Heaikkavahkku+Sem/Time+N+Der/Dimin+N+Sg+Loc	Heaikkavahkko»žis	hˈeæjç.kɑ#vˌɑhː.ko»žis
Heaikkavahkku+Sem/Time+N+Der/huvva+V+IV+Ind+Prs+Sg3	Heaikkavahkko»huvvá>	hˈeæjç.kɑ#vˌɑhː.ko»huvː.vɑː>
Heaikkavahkku+Sem/Time+N+Der/viđá+Adv	Heaikkavahkko»viđá	hˈeæjç.kɑ#vˌɑhː.ko»vi.ðɑː
Heaikkavahkku+Sem/Time+N+Ess	Heaikkavahkku>n	hˈeæjç.kɑ#vˌɑhː.ku>n
Heaikkavahkku+Sem/Time+N+Sg+Nom	Heaikkavahkku>	hˈeæjç.kɑ#vˌɑhː.ku>
Heaikkavahkku+Sem/Time+N+Sg+Com	Heaikkavahkku>in	hˈeæjç.kɑ#vˌɑhː.ku>in
Heaikkavahkku+Sem/Time+N+Sg+Ill	Heaikkavahkku>i	hˈeæjç.kɑ#vˌɑhː.ku>i
Hosianna+Interj	Hosianna	hˈo.si.ˌɑn.nɑ
Konsešuvdnaeaktuduvvon+A+Attr	Konsešuvdnaeaktuduvvon>	khˈonː.se.ʃuβː.tnɑ#ˌeækː.htu.duv.von>
Konsešuvdnaeaktuduvvon+A+Pl+Nom	Konsešuvdnaeaktuduvvon>	khˈonː.se.ʃuβː.tnɑ#ˌeækː.htu.duv.von>
Konsešuvdnaeaktuduvvon+A+Sg+Nom	Konsešuvdnaeaktuduvvon>	khˈonː.se.ʃuβː.tnɑ#ˌeækː.htu.duv.von>
Luciabeaivi+Sem/Time+N+Pl+Acc	Luciabeivvi>id	lˈu.tsi.ˌɑ#pˌejv.vi>id
Luciabeaivi+Sem/Time+N+Pl+Acc+PxSg1	Luciabeivvi>id>an	lˈu.tsi.ˌɑ#pˌejv.vi>id>ɑn
Luciabeaivi+Sem/Time+N+Pl+Com+PxPl1	Luciabeivvi>id>eametguin	lˈu.tsi.ˌɑ#pˌejv.vi>id>ĕæ.met.gujn
Luciabeaivi+Sem/Time+N+Pl+Com	Luciabeivvi>iguin	lˈu.tsi.ˌɑ#pˌejv.vi>i.gujn
Luciabeaivi+Sem/Time+N+Pl+Gen	Luciabeivvi>id	lˈu.tsi.ˌɑ#pˌejv.vi>id
Luciabeaivi+Sem/Time+N+Pl+Gen+PxSg3	Luciabeivvi>id>is	lˈu.tsi.ˌɑ#pˌejv.vi>id>is
Luciabeaivi+Sem/Time+N+Pl+Ill	Luciabeivvi>ide	lˈu.tsi.ˌɑ#pˌejv.vi>i.de
Luciabeaivi+Sem/Time+N+Sg+Com	Luciabeivvi>in	lˈu.tsi.ˌɑ#pˌejv.vi>in
Luciabeaivi+Sem/Time+N+Sg+Com+PxDu2	Luciabeivvi>in>eatte	lˈu.tsi.ˌɑ#pˌejv.vi>in>ĕæt.te
Luciabeaivi+Sem/Time+N+Sg+Com+PxSg2	Luciabeivvi>in>at	lˈu.tsi.ˌɑ#pˌejv.vi>in>ɑh
Luciabeaivi+Sem/Time+N+Sg+Com+PxSg3	Luciabeivvi>in>is	lˈu.tsi.ˌɑ#pˌejv.vi>in>is
Luciabeaivi+Sem/Time+N+Der/viđá+Adv	Luciabeaive»viđá	lˈu.tsi.ˌɑ#pˌĕæjː.ve»vi.ðɑː
Luciabeaivi+Sem/Time+N+Sg+Nom	Luciabeaivi>	lˈu.tsi.ˌɑ#pˌĕæjː.vi>
Luciabeaivi+Sem/Time+N+Sg+Acc+PxSg1	Luciabeaivá>n	lˈu.tsi.ˌɑ#pˌĕæjː.vɑː>n
Luciabeaivi+Sem/Time+N+Sg+Ill	Luciabeaivá>i	lˈu.tsi.ˌɑ#pˌĕæjː.vɑː>i
Luciabeaivi+Sem/Time+N+Sg+Gen+Allegro	Luciabeaivve>	lˈu.tsi.ˌɑ#pˌĕæjv.ve>
Luciabeaivi+Sem/Time+N+Sg+Acc+PxDu3	Luciabeaivvi>ska	lˈu.tsi.ˌɑ#pˌeæjv.vi>skɑ
Luciabeaivi+Sem/Time+N+Der/huhtti+V+TV+Imprt+Pl2	Luciabeaivvi»huhtte>t	lˈu.tsi.ˌɑ#pˌeæjv.vi»huhː.te>h
Luciabeaivi+Sem/Time+N+Sg+Gen+PxSg2	Luciabeaivvá>t	lˈu.tsi.ˌɑ#pˌeæjv.vɑː>h
Luciabeaivi+Sem/Time+N+Der/Dimin+N+Sg+Ill+PxPl3	Luciabeaivvá»žasa>set	lˈu.tsi.ˌɑ#pˌeæjv.vɑː»žɑ.sɑ>seh
Luciabeaivi+Sem/Time+N+Der/laš+A+Der/vuohta+N+Sg+Ill	Luciabeaivvá»laš»»»vuhti>i	lˈu.tsi.ˌɑ#pˌeæjv.vɑː»lɑʃ»»»#vˌuh.ti>i
Luciabeaivi+Sem/Time+N+Der/laš+A+Der/vuohta+N+Sg+Nom+PxSg3	Luciabeaivvá»laš»»»vuohta>s	lˈu.tsi.ˌɑ#pˌeæjv.vɑː»lɑʃ»»»#vˌuoh.tɑ>s
Lávrrasvahkku+Sem/Time+N+Sg+Acc+PxSg2	Lávrrasvahko>t	lˈɑːβr.rɑs#vˌɑh.ko>h
Lávrrasvahkku+Sem/Time+N+Sg+Gen+PxDu2	Lávrrasvahko>de	lˈɑːβr.rɑs#vˌɑh.ko>de
Lávrrasvahkku+Sem/Time+N+Sg+Gen+PxPl2	Lávrrasvahko>det	lˈɑːβr.rɑs#vˌɑh.ko>deh
Lávrrasvahkku+Sem/Time+N+Sg+Gen+PxSg2	Lávrrasvahko>t	lˈɑːβr.rɑs#vˌɑh.ko>h
Lávrrasvahkku+Sem/Time+N+Der/Dimin+N+Sg+Nom	Lávrrasvahko»š	lˈɑːβr.rɑs#vˌɑh.ko»ʃ
Lávrrasvahkku+Sem/Time+N+Der/Dimin+N+Sg+Ill+PxDu3	Lávrrasvahko»žasa>ska	lˈɑːβr.rɑs#vˌɑh.ko»žɑ.sɑ>skɑ
Lávrrasvahkku+Sem/Time+N+Der/laš+A+Attr+Der/vuohta+N+Der/viđá+Adv	Lávrrasvahko»laš>»»»vuohta»viđá	lˈɑːβr.rɑs#vˌɑh.ko»lɑʃ>»»»#vˌuoh.tɑ»vi.ðɑː
Lávrrasvahkku+Sem/Time+N+Sg+Acc+PxPl3	Lávrrasvahku>set	lˈɑːβr.rɑs#vˌɑh.ku>seh
Lávrrasvahkku+Sem/Time+N+Sg+Com	Lávrrasvahku>in	lˈɑːβr.rɑs#vˌɑh.ku>in
Lávrrasvahkku+Sem/Time+N+Der/heapmi+A+Attr	Lávrrasvahku»his>	lˈɑːβr.rɑs#vˌɑh.ku»his>
Lávrrasvahkku+Sem/Time+N+Der/huvva+V+IV+Imprt+ConNeg	Lávrrasvahku»huva>	lˈɑːβr.rɑs#vˌɑh.ku»hu.vɑ>
Lávrrasvahkku+Sem/Time+N+Sg+Acc+PxDu2	Lávrrasvahkko>de	lˈɑːβr.rɑs#vˌɑhː.ko>de
Lávrrasvahkku+Sem/Time+N+Der/huvva+V+IV+Imprt+Sg2	Lávrrasvahkko»huva>	lˈɑːβr.rɑs#vˌɑhː.ko»hu.vɑ>
Lávrrasvahkku+Sem/Time+N+Der/viđá+Adv	Lávrrasvahkko»viđá	lˈɑːβr.rɑs#vˌɑhː.ko»vi.ðɑː
Lávrrasvahkku+Sem/Time+N+Ess+PxSg3	Lávrrasvahkku>n>is	lˈɑːβr.rɑs#vˌɑhː.ku>n>is
Lávrrasvahkku+Sem/Time+N+Pl+Nom	Lávrrasvahkku>t	lˈɑːβr.rɑs#vˌɑhː.ku>h
Lávrrasvahkku+Sem/Time+N+Pl+Com	Lávrrasvahkku>iguin	lˈɑːβr.rɑs#vˌɑhː.ku>i.gujn
Lávrrasvahkku+Sem/Time+N+Sg+Nom	Lávrrasvahkku>	lˈɑːβr.rɑs#vˌɑhː.ku>
Lávrrasvahkku+Sem/Time+N+Sg+Com	Lávrrasvahkku>in	lˈɑːβr.rɑs#vˌɑhː.ku>in
Lávrrasvahkku+Sem/Time+N+Sg+Com+PxPl3	Lávrrasvahkku>in>easet	lˈɑːβr.rɑs#vˌɑhː.ku>in>ĕæ.seh
Lávrrasvahkku+Sem/Time+N+Sg+Ill	Lávrrasvahkku>i	lˈɑːβr.rɑs#vˌɑhː.ku>i
Mihkalmeassu+G3+Sem/Event+N+Sg+Acc+PxDu1	Mihkalmesso>me	mˈihː.kɑːl#mˌes.so>me
Mihkalmeassu+G3+Sem/Event+N+Sg+Nom+PxDu1	Mihkalmesso>me	mˈihː.kɑːl#mˌes.so>me
Mihkalmeassu+G3+Sem/Event+N+Sg+Nom+PxPl2	Mihkalmesso>det	mˈihː.kɑːl#mˌes.so>deh
Mihkalmeassu+G3+Sem/Event+N+Der/Dimin+N+Sg+Ill	Mihkalmesso»žii	mˈihː.kɑːl#mˌes.so»žij
Mihkalmeassu+G3+Sem/Event+N+Sg+Ill	Mihkalmessu>i	mˈihː.kɑːl#mˌes.su>i
Mihkalmeassu+G3+Sem/Event+N+Der/viđá+Adv	Mihkalmeasso»viđá	mˈihː.kɑːl#mˌĕæs.so»vi.ðɑː
Mihkalmasbasit+N+Der/Dimin+N+Pl+Nom	Mihkalmasbasá»žat	mˈihː.kɑːlə.mɑs#pˌɑ.sɑː»žɑh
Mihkalmasbasit+N+Ess	Mihkalmasbassi>n	mˈihː.kɑːlə.mɑs#pˌɑs.si>n
Mihkalmasbeaivi+N+Pl+Com+PxDu1	Mihkalmasbeivvi>id>eameguin	mˈihː.kɑːlə.mɑs#pˌejv.vi>id>ĕæ.me.gujn
Mihkalmasbeaivi+N+Sg+Nom	Mihkalmasbeaivi>	mˈihː.kɑːlə.mɑs#pˌĕæjː.vi>
Mihkalmasbeaivi+N+Der/huhtti+V+TV+VGen	Mihkalmasbeaivve»huhti>	mˈihː.kɑːlə.mɑs#pˌĕæjv.ve»huh.ti>
Mihkalmasbeaivi+N+Der/Dimin+N+Sg+Nom	Mihkalmasbeaivvá»š	mˈihː.kɑːlə.mɑs#pˌeæjv.vɑː»ʃ
Mihkalmasbeaivi+N+Der/laš+A+Der/vuohta+N+Sg+Ill	Mihkalmasbeaivvá»laš»»»vuhti>i	mˈihː.kɑːlə.mɑs#pˌeæjv.vɑː»lɑʃ»»»#vˌuh.ti>i
Mihkalmasvahkku+Sem/Time+N+Sg+Acc+PxPl2	Mihkalmasvahko>det	mˈihː.kɑːlə.mɑs#vˌɑh.ko>deh
Mihkalmasvahkku+Sem/Time+N+Sg+Nom+PxDu2	Mihkalmasvahkko>de	mˈihː.kɑːlə.mɑs#vˌɑhː.ko>de
Mihkalmasvahkku+Sem/Time+N+Pl+Gen+PxDu3	Mihkalmasvahkku>id>easkka	mˈihː.kɑːlə.mɑs#vˌɑhː.ku>id>eæs.kɑ
Máhtebeaivi+Sem/Time+N+Pl+Acc+PxPl3	Máhtebeivvi>id>easet	mˈɑːh.te#pˌejv.vi>id>ĕæ.seh
Máhtebeaivi+Sem/Time+N+Pl+Loc+PxSg1	Máhtebeivvi>in>an	mˈɑːh.te#pˌejv.vi>in>ɑn
Máhtebeaivi+Sem/Time+N+Sg+Com	Máhtebeivvi>in	mˈɑːh.te#pˌejv.vi>in
Máhtebeaivi+Sem/Time+N+Der/viđá+Adv	Máhtebeaive»viđá	mˈɑːh.te#pˌĕæjː.ve»vi.ðɑː
Máhtebeaivi+Sem/Time+N+Sg+Nom	Máhtebeaivi>	mˈɑːh.te#pˌĕæjː.vi>
Máhtebeaivi+Sem/Time+N+Der/heapmi+A+Pl+Com	Máhtebeaivve»hemi>iguin	mˈɑːh.te#pˌĕæjv.ve»he.mi>i.gujn
Máhtebeaivi+Sem/Time+N+Der/heapmi+A+Pl+Com	Máhtebeaivvi»hemi>iguin	mˈɑːh.te#pˌeæjv.vi»he.mi>i.gujn
Máhtemeasvahkku+Sem/Time+N+Sg+Gen+PxPl2	Máhtemeasvahko>det	mˈɑːh.te#mˌeæs#vˌɑh.ko>deh
Máhtemeasvahkku+Sem/Time+N+Der/Dimin+N+Pl+Nom	Máhtemeasvahko»žat	mˈɑːh.te#mˌeæs#vˌɑh.ko»žɑh
Máhtemeasvahkku+Sem/Time+N+Der/laš+A+Superl+Sg+Nom	Máhtemeasvahko»lačča>mus>	mˈɑːh.te#mˌeæs#vˌɑh.ko»lɑt.tʃɑ>mus>
Máhtemeasvahkku+Sem/Time+N+Sg+Com+PxPl3	Máhtemeasvahku>in>easet	mˈɑːh.te#mˌeæs#vˌɑh.ku>in>ĕæ.seh
Máhtemesvahkku+Sem/Time+N+Sg+Gen+PxDu3	Máhtemesvahku>ska	mˈɑːh.te#mˌes#vˌɑh.ku>skɑ
Máhtemesvahkku+Sem/Time+N+Pl+Nom	Máhtemesvahkku>t	mˈɑːh.te#mˌes#vˌɑhː.ku>h
Máhtevahkku+Sem/Time+N+Pl+Nom+PxDu3	Máhtevahkku>id>easkka	mˈɑːh.te#vˌɑhː.ku>id>eæs.kɑ
Máhtevahkku+Sem/Time+N+Sg+Acc	Máhtevahkku>	mˈɑːh.te#vˌɑhː.ku>
Máhtevahkku+Sem/Time+N+Sg+Gen	Máhtevahkku>	mˈɑːh.te#vˌɑhː.ku>
Márggasvahkku+Sem/Time+N+Sg+Acc+PxSg2	Márggasvahko>t	mˈɑːrk.kɑs#vˌɑh.ko>h
Márggasvahkku+Sem/Time+N+Der/heapmi+A+Superl+Attr	Márggasvahku»heamos>	mˈɑːrk.kɑs#vˌɑh.ku»hĕæ.mos>
Márggasvahkku+Sem/Time+N+Der/huvva+V+IV+Imprt+Pl1	Márggasvahkko»huvvu>t	mˈɑːrk.kɑs#vˌɑhː.ko»huv.vu>h
Márggasvahkku+Sem/Time+N+Sg+Acc+PxSg3	Márggasvahkku>s	mˈɑːrk.kɑs#vˌɑhː.ku>s
Márggasvahkku+Sem/Time+N+Sg+Com	Márggasvahkku>in	mˈɑːrk.kɑs#vˌɑhː.ku>in
Márjjabeaivi+Sem/Time+N+Sg+Gen+PxSg2	Márjjabeaivvá>t	mˈɑːrj.jɑ#pˌeæjv.vɑː>h
Márjjameassu+G3+Sem/Event+N+Sg+Ill	Márjjamessu>i	mˈɑːrj.jɑ#mˌes.su>i
Márjjavahkku+Sem/Time+N+Der/Dimin+N+Der/Dimin+N+Pl+Nom	Márjjavahkko»žačča>t	mˈɑːrj.jɑ#vˌɑhː.ko»žɑt.tʃɑ>h
Márjjavahkku+Sem/Time+N+Ess	Márjjavahkku>n	mˈɑːrj.jɑ#vˌɑhː.ku>n
Márjjavahkku+Sem/Time+N+Sg+Com	Márjjavahkku>in	mˈɑːrj.jɑ#vˌɑhː.ku>in
Márjjámeassu+G3+Sem/Event+N+Sg+Ill	Márjjámessu>i	mˈɑːrj.jɑː#mˌes.su>i
Márjjámeassu+G3+Sem/Event+N+Der/huvva+V+IV+ConNegII	Márjjámeassu»huvvo>	mˈɑːrj.jɑː#mˌeæs.su»huv.vo>
Norggaáittardeaddji+N+NomAg+Pl+Com	Norggaáittardeddji>iguin	nˈorkː.kɑː#ˌɑːjç.tɑr.deɟː.ci>i.gujn
Norggaáittardeaddji+N+NomAg+Pl+Loc	Norggaáittardeddji>in	nˈorkː.kɑː#ˌɑːjç.tɑr.deɟː.ci>in
Norggaáittardeaddji+N+NomAg+Pl+Loc+PxPl1	Norggaáittardeddji>in>eamet	nˈorkː.kɑː#ˌɑːjç.tɑr.deɟː.ci>in>ĕæ.meh
Norggaáittardeaddji+N+NomAg+Pl+Nom+PxPl1	Norggaáittardeddji>id>eamet	nˈorkː.kɑː#ˌɑːjç.tɑr.deɟː.ci>id>ĕæ.meh
Norggaáittardeaddji+N+NomAg+Sg+Com	Norggaáittardeddji>in	nˈorkː.kɑː#ˌɑːjç.tɑr.deɟː.ci>in
Norggaáittardeaddji+N+NomAg+Sg+Com+PxPl3	Norggaáittardeddji>in>easet	nˈorkː.kɑː#ˌɑːjç.tɑr.deɟː.ci>in>ĕæ.seh
Norggaáittardeaddji+N+NomAg+Sg+Com+PxSg2	Norggaáittardeddji>in>at	nˈorkː.kɑː#ˌɑːjç.tɑr.deɟː.ci>in>ɑh
Norggaáittardeaddji+N+NomAg+Sg+Gen	Norggaáittardeaddje>	nˈorkː.kɑː#ˌɑːjç.tɑr.dĕæɟː.ce>
Norggaáittardeaddji+N+NomAg+Der/viđá+Adv	Norggaáittardeaddje»viđá	nˈorkː.kɑː#ˌɑːjç.tɑr.dĕæɟː.ce»vi.ðɑː
Norggaáittardeaddji+N+NomAg+Sg+Loc	Norggaáittardeaddji>s	nˈorkː.kɑː#ˌɑːjç.tɑr.dĕæɟː.ci>s
Norggaáittardeaddji+N+NomAg+Sg+Acc+PxPl2	Norggaáittardeaddjá>det	nˈorkː.kɑː#ˌɑːjç.tɑr.dĕæɟː.cɑː>deh
Norggaáittardeaddji+N+NomAg+Sg+Ill	Norggaáittardeaddjá>i	nˈorkː.kɑː#ˌɑːjç.tɑr.dĕæɟː.cɑː>i
Nuvttevahkku+Sem/Time+N+Sg+Gen+PxDu2	Nuvttevahko>de	nˈuβɸ.te#vˌɑh.ko>de
Nuvttevahkku+Sem/Time+N+Der/Dimin+N+Pl+Nom	Nuvttevahko»žat	nˈuβɸ.te#vˌɑh.ko»žɑh
Nuvttevahkku+Sem/Time+N+Der/Dimin+N+Sg+Nom+PxDu3	Nuvttevahko»žeaskka	nˈuβɸ.te#vˌɑh.ko»žeæs.kɑ
Nuvttevahkku+Sem/Time+N+Der/Dimin+N+Sg+Gen	Nuvttevahko»ža	nˈuβɸ.te#vˌɑh.ko»žɑ
Nuvttevahkku+Sem/Time+N+Der/laš+A+AttrCmp+Der/jearggat+A+Pl+Nom	Nuvttevahko»laš>»»»»jearggag>at	nˈuβɸ.te#vˌɑh.ko»lɑʃ>»»»»#jˌeærk.kɑg>ɑh
Nuvttevahkku+Sem/Time+N+Der/laš+A+Sg+Nom	Nuvttevahko»laš>	nˈuβɸ.te#vˌɑh.ko»lɑʃ>
Nuvttevahkku+Sem/Time+N+Pl+Com	Nuvttevahku>iguin	nˈuβɸ.te#vˌɑh.ku>i.gujn
Nuvttevahkku+Sem/Time+N+Pl+Nom	Nuvttevahku>t	nˈuβɸ.te#vˌɑh.ku>h
Nuvttevahkku+Sem/Time+N+Sg+Acc	Nuvttevahku>	nˈuβɸ.te#vˌɑh.ku>
Nuvttevahkku+Sem/Time+N+Sg+Com	Nuvttevahku>in	nˈuβɸ.te#vˌɑh.ku>in
Nuvttevahkku+Sem/Time+N+Der/heapmi+A+Sg+Nom	Nuvttevahku»heapme>	nˈuβɸ.te#vˌɑh.ku»hĕæp.me>
Nuvttevahkku+Sem/Time+N+Der/heapmi+A+Attr	Nuvttevahku»his>	nˈuβɸ.te#vˌɑh.ku»his>
Nuvttevahkku+Sem/Time+N+Der/heapmi+A+Attr+Der/vuohta+N+Der/viđá+Adv	Nuvttevahku»his>»»»vuohta»viđá	nˈuβɸ.te#vˌɑh.ku»his>»»»#vˌuoh.tɑ»vi.ðɑː
Nuvttevahkku+Sem/Time+N+Der/huvva+V+IV+Ind+Prs+ConNeg	Nuvttevahku»huva>	nˈuβɸ.te#vˌɑh.ku»hu.vɑ>
Nuvttevahkku+Sem/Time+N+Der/huvva+V+IV+Ind+Prt+Du2	Nuvttevahku»huva>ide	nˈuβɸ.te#vˌɑh.ku»hu.vɑ>i.de
Nuvttevahkku+Sem/Time+N+Der/huvva+V+IV+Ind+Prs+Du1	Nuvttevahku»huvve>	nˈuβɸ.te#vˌɑh.ku»huv.ve>
Nuvttevahkku+Sem/Time+N+Sg+Gen+PxDu2	Nuvttevahkko>de	nˈuβɸ.te#vˌɑhː.ko>de
Nuvttevahkku+Sem/Time+N+Sg+Ill+PxPl3	Nuvttevahkko>s>easet	nˈuβɸ.te#vˌɑhː.ko>s>ĕæ.seh
Nuvttevahkku+Sem/Time+N+Der/huhtti+V+TV+VAbess	Nuvttevahkko»huhte>haga	nˈuβɸ.te#vˌɑhː.ko»huh.te>hɑ.gɑ
Nuvttevahkku+Sem/Time+N+Der/huvva+V+IV+Cond+Prs+Pl3	Nuvttevahkko»huva>še	nˈuβɸ.te#vˌɑhː.ko»hu.vɑ>ʃe
Nuvttevahkku+Sem/Time+N+Der/laš+A+Der/vuohta+N+Sg+Nom+PxDu2	Nuvttevahkko»laš»»»vuohta>de	nˈuβɸ.te#vˌɑhː.ko»lɑʃ»»»#vˌuoh.tɑ>de
Nuvttevahkku+Sem/Time+N+Der/viđá+Adv	Nuvttevahkko»viđá	nˈuβɸ.te#vˌɑhː.ko»vi.ðɑː
Nuvttevahkku+Sem/Time+N+Pl+Nom	Nuvttevahkku>t	nˈuβɸ.te#vˌɑhː.ku>h
Nuvttevahkku+Sem/Time+N+Pl+Loc+PxDu2	Nuvttevahkku>in>eatte	nˈuβɸ.te#vˌɑhː.ku>in>ĕæt.te
Nuvttevahkku+Sem/Time+N+Sg+Loc	Nuvttevahkku>s	nˈuβɸ.te#vˌɑhː.ku>s
Nuvttevahkku+Sem/Time+N+Sg+Nom	Nuvttevahkku>	nˈuβɸ.te#vˌɑhː.ku>
Nuvttevahkku+Sem/Time+N+Sg+Ill	Nuvttevahkku>i	nˈuβɸ.te#vˌɑhː.ku>i
Simmonvahkku+Sem/Time+N+Sg+Acc+PxSg2	Simmonvahko>t	sˈim.mon#vˌɑh.ko>h
Simmonvahkku+Sem/Time+N+Sg+Gen+PxDu2	Simmonvahko>de	sˈim.mon#vˌɑh.ko>de
Simmonvahkku+Sem/Time+N+Sg+Gen+PxPl2	Simmonvahko>det	sˈim.mon#vˌɑh.ko>deh
Simmonvahkku+Sem/Time+N+Der/Dimin+N+Sg+Nom	Simmonvahko»š	sˈim.mon#vˌɑh.ko»ʃ
Simmonvahkku+Sem/Time+N+Sg+Com+PxDu2	Simmonvahku>in>eatte	sˈim.mon#vˌɑh.ku>in>ĕæt.te
Simmonvahkku+Sem/Time+N+Sg+Loc+PxPl3	Simmonvahku>st>easet	sˈim.mon#vˌɑh.ku>st>ĕæ.seh
Simmonvahkku+Sem/Time+N+Sg+Loc+PxSg1	Simmonvahku>st>an	sˈim.mon#vˌɑh.ku>st>ɑn
Simmonvahkku+Sem/Time+N+Der/heapmi+A+Pl+Loc	Simmonvahku»hemi>in	sˈim.mon#vˌɑh.ku»he.mi>in
Simmonvahkku+Sem/Time+N+Sg+Ill+PxDu2	Simmonvahkko>s>eatte	sˈim.mon#vˌɑhː.ko>s>ĕæt.te
Simmonvahkku+Sem/Time+N+Der/laš+A+Superl+Attr	Simmonvahkko»leamos>	sˈim.mon#vˌɑhː.ko»lĕæ.mos>
Simmonvahkku+Sem/Time+N+Pl+Nom	Simmonvahkku>t	sˈim.mon#vˌɑhː.ku>h
Simmonvahkku+Sem/Time+N+Sg+Loc+PxSg3	Simmonvahkku>st>is	sˈim.mon#vˌɑhː.ku>st>is
St.dieđáhus+N+Pl+Com	St.dieđáhusa>iguin	st.die.ðɑː.hu.sɑ>i.gujn
St.dieđáhus+N+Sg+Com	St.dieđáhusa>in	st.die.ðɑː.hu.sɑ>in
St.dieđáhus+N+Der/Dimin+N+Der/viđá+Adv	St.dieđáhusa»š»viđá	st.die.ðɑː.hu.sɑ»ʃ»#vˌi.ðɑː
St.dieđáhus+N+Der/Dimin+N+Pl+Nom	St.dieđáhusa»žat	st.die.ðɑː.hu.sɑ»žɑh
St.dieđáhus+N+Der/Dimin+N+Sg+Acc	St.dieđáhusa»ža	st.die.ðɑː.hu.sɑ»žɑ
St.dieđáhus+N+Der/Dimin+N+Sg+Com+PxPl3	St.dieđáhusa»žiinni>set	st.die.ðɑː.hu.sɑ»žijn.ni>seh
St.dieđáhus+N+Der/Dimin+N+Sg+Loc	St.dieđáhusa»žis	st.die.ðɑː.hu.sɑ»žis
St.dieđáhus+N+Der/Dimin+N+Sg+Loc+PxSg3	St.dieđáhusa»žistti>s	st.die.ðɑː.hu.sɑ»žis.ti>s
St.dieđáhus+N+Sg+Nom	St.dieđáhus>	st.die.ðɑː.hus>
St.dieđáhus+N+Sg+Nom+PxDu3	St.dieđáhussa>>ska	st.die.ðɑː.hus.sɑ>>skɑ
St.dieđáhus+N+Sg+Ill+PxSg2	St.dieđáhussa>s>at	st.die.ðɑː.hus.sɑ>s>ɑh
St.dieđáhus+N+Sg+Ill	St.dieđáhussi>i	st.die.ðɑː.hus.si>i
Suomaáittardeaddji+N+NomAg+Pl+Com+PxSg3	Suomaáittardeddji>id>isguin	sˈuo.mɑ#ˌɑːjç.tɑr.deɟː.ci>id>is.gujn
Suomaáittardeaddji+N+NomAg+Pl+Com	Suomaáittardeddji>iguin	sˈuo.mɑ#ˌɑːjç.tɑr.deɟː.ci>i.gujn
Suomaáittardeaddji+N+NomAg+Pl+Loc+PxPl3	Suomaáittardeddji>in>easet	sˈuo.mɑ#ˌɑːjç.tɑr.deɟː.ci>in>ĕæ.seh
Suomaáittardeaddji+N+NomAg+Sg+Com+PxDu1	Suomaáittardeddji>in>eame	sˈuo.mɑ#ˌɑːjç.tɑr.deɟː.ci>in>ĕæ.me
Suomaáittardeaddji+N+NomAg+Sg+Com+PxSg2	Suomaáittardeddji>in>at	sˈuo.mɑ#ˌɑːjç.tɑr.deɟː.ci>in>ɑh
Suomaáittardeaddji+N+NomAg+Sg+Gen	Suomaáittardeaddje>	sˈuo.mɑ#ˌɑːjç.tɑr.dĕæɟː.ce>
Suomaáittardeaddji+N+NomAg+Sg+Gen+PxSg2	Suomaáittardeaddjá>t	sˈuo.mɑ#ˌɑːjç.tɑr.dĕæɟː.cɑː>h
Suomaáittardeaddji+N+Sg+Gen+NomAg+PxSg1	Suomaáittardeaddjá>n	sˈuo.mɑ#ˌɑːjç.tɑr.dĕæɟː.cɑː>n
Suomaáittardeaddji+N+Sg+Ill+NomAg+PxDu1	Suomaáittardeaddjá>s>eame	sˈuo.mɑ#ˌɑːjç.tɑr.dĕæɟː.cɑː>s>ĕæ.me
Suomaáittardeaddji+N+Sg+Ill+NomAg+PxSg1	Suomaáittardeaddjá>s>an	sˈuo.mɑ#ˌɑːjç.tɑr.dĕæɟː.cɑː>s>ɑn
Urbanbeaivi+Sem/Time+N+Pl+Acc+PxPl1	Urbanbeivvi>id>eamet	ˈurə.pɑn#pˌejv.vi>id>ĕæ.meh
Urbanbeaivi+Sem/Time+N+Pl+Com+PxPl2	Urbanbeivvi>id>eattetguin	ˈurə.pɑn#pˌejv.vi>id>ĕæt.tet.gujn
Urbanbeaivi+Sem/Time+N+Pl+Ill+PxDu2	Urbanbeivvi>idasa>de	ˈurə.pɑn#pˌejv.vi>i.dɑ.sɑ>de
Urbanbeaivi+Sem/Time+N+Pl+Loc	Urbanbeivvi>in	ˈurə.pɑn#pˌejv.vi>in
Urbanbeaivi+Sem/Time+N+Pl+Loc+PxSg1	Urbanbeivvi>in>an	ˈurə.pɑn#pˌejv.vi>in>ɑn
Urbanbeaivi+Sem/Time+N+Pl+Nom+PxDu3	Urbanbeivvi>id>easkka	ˈurə.pɑn#pˌejv.vi>id>eæs.kɑ
Urbanbeaivi+Sem/Time+N+Sg+Com+PxDu2	Urbanbeivvi>in>eatte	ˈurə.pɑn#pˌejv.vi>in>ĕæt.te
Urbanbeaivi+Sem/Time+N+Sg+Com+PxDu3	Urbanbeivvi>in>easkka	ˈurə.pɑn#pˌejv.vi>in>eæs.kɑ
Urbanbeaivi+Sem/Time+N+Sg+Com+PxPl1	Urbanbeivvi>in>eamet	ˈurə.pɑn#pˌejv.vi>in>ĕæ.meh
Urbanbeaivi+Sem/Time+N+Sg+Com+PxSg2	Urbanbeivvi>in>at	ˈurə.pɑn#pˌejv.vi>in>ɑh
Urbanbeaivi+Sem/Time+N+Der/viđá+Adv	Urbanbeaive»viđá	ˈurə.pɑn#pˌĕæjː.ve»vi.ðɑː
Urbanbeaivi+Sem/Time+N+Ess+PxDu2	Urbanbeaivi>n>eatte	ˈurə.pɑn#pˌĕæjː.vi>n>ĕæt.te
Urbanbeaivi+Sem/Time+N+Sg+Acc+PxDu1	Urbanbeaivá>me	ˈurə.pɑn#pˌĕæjː.vɑː>me
Urbanbeaivi+Sem/Time+N+Der/huvva+V+IV+Ind+Prt+Pl1	Urbanbeaivve»huva>imet	ˈurə.pɑn#pˌĕæjv.ve»hu.vɑ>i.meh
Urbanbeaivi+Sem/Time+N+Sg+Gen	Urbanbeaivvi>	ˈurə.pɑn#pˌeæjv.vi>
Urbanbeaivi+Sem/Time+N+Sg+Loc	Urbanbeaivvi>s	ˈurə.pɑn#pˌeæjv.vi>s
Urbanbeaivi+Sem/Time+N+Sg+Loc+PxSg2	Urbanbeaivvi>st>at	ˈurə.pɑn#pˌeæjv.vi>st>ɑh
Urbanbeaivi+Sem/Time+N+Sg+Acc+PxPl2	Urbanbeaivvá>det	ˈurə.pɑn#pˌeæjv.vɑː>deh
Urbánbeaivi+Sem/Time+N+Pl+Com+PxPl3	Urbánbeivvi>id>easetguin	ˈurə.pɑːn#pˌejv.vi>id>ĕæ.set.gujn
Urbánbeaivi+Sem/Time+N+Pl+Com+PxSg1	Urbánbeivvi>id>anguin	ˈurə.pɑːn#pˌejv.vi>id>ɑn.gujn
Urbánbeaivi+Sem/Time+N+Pl+Nom+PxPl3	Urbánbeivvi>id>easet	ˈurə.pɑːn#pˌejv.vi>id>ĕæ.seh
Urbánbeaivi+Sem/Time+N+Sg+Com	Urbánbeivvi>in	ˈurə.pɑːn#pˌejv.vi>in
Urbánbeaivi+Sem/Time+N+Sg+Com+PxSg1	Urbánbeivvi>in>an	ˈurə.pɑːn#pˌejv.vi>in>ɑn
Urbánbeaivi+Sem/Time+N+Der/viđá+Adv	Urbánbeaive»viđá	ˈurə.pɑːn#pˌĕæjː.ve»vi.ðɑː
Urbánbeaivi+Sem/Time+N+Ess	Urbánbeaivi>n	ˈurə.pɑːn#pˌĕæjː.vi>n
Urbánbeaivi+Sem/Time+N+Sg+Ill	Urbánbeaivá>i	ˈurə.pɑːn#pˌĕæjː.vɑː>i
Urbánbeaivi+Sem/Time+N+Sg+Gen+Allegro	Urbánbeaivve>	ˈurə.pɑːn#pˌĕæjv.ve>
Urbánbeaivi+Sem/Time+N+Der/huhtti+V+TV+Sup	Urbánbeaivve»huhtá>žit	ˈurə.pɑːn#pˌĕæjv.ve»huhː.tɑː>žih
Urbánbeaivi+Sem/Time+N+Der/huvva+V+IV+Imprt+Pl3	Urbánbeaivve»huvvo>set	ˈurə.pɑːn#pˌĕæjv.ve»huv.vo>seh
Urbánbeaivi+Sem/Time+N+Der/huvva+V+IV+Imprt+Du2	Urbánbeaivvi»huvvi>	ˈurə.pɑːn#pˌeæjv.vi»huv.vi>
Urbánbeaivi+Sem/Time+N+Der/Dimin+N+Der/viđá+Adv	Urbánbeaivvá»š»viđá	ˈurə.pɑːn#pˌeæjv.vɑː»ʃ»#vˌi.ðɑː
Vullešvahkku+Sem/Time+N+Sg+Acc+PxDu2	Vullešvahko>de	vˈul.leʃ#vˌɑh.ko>de
Vullešvahkku+Sem/Time+N+Sg+Acc+PxPl2	Vullešvahko>det	vˈul.leʃ#vˌɑh.ko>deh
Vullešvahkku+Sem/Time+N+Sg+Gen+PxDu2	Vullešvahko>de	vˈul.leʃ#vˌɑh.ko>de
Vullešvahkku+Sem/Time+N+Sg+Gen+PxPl2	Vullešvahko>det	vˈul.leʃ#vˌɑh.ko>deh
Vullešvahkku+Sem/Time+N+Sg+Gen+PxSg2	Vullešvahko>t	vˈul.leʃ#vˌɑh.ko>h
Vullešvahkku+Sem/Time+N+Der/laš+A+Comp+Attr	Vullešvahko»lut>	vˈul.leʃ#vˌɑh.ko»lut>
Vullešvahkku+Sem/Time+N+Der/laš+A+Attr	Vullešvahko»laš>	vˈul.leʃ#vˌɑh.ko»lɑʃ>
Vullešvahkku+Sem/Time+N+Der/laš+A+Sg+Nom	Vullešvahko»laš>	vˈul.leʃ#vˌɑh.ko»lɑʃ>
Vullešvahkku+Sem/Time+N+Sg+Acc+PxPl3	Vullešvahku>set	vˈul.leʃ#vˌɑh.ku>seh
Vullešvahkku+Sem/Time+N+Sg+Loc+PxDu3	Vullešvahku>st>easkka	vˈul.leʃ#vˌɑh.ku>st>eæs.kɑ
Vullešvahkku+Sem/Time+N+Der/heapmi+A+Sg+Com	Vullešvahku»hemi>in	vˈul.leʃ#vˌɑh.ku»he.mi>in
Vullešvahkku+Sem/Time+N+Der/huhtti+V+TV+Ger+PxDu3	Vullešvahku»huhti>dettiin>easkka	vˈul.leʃ#vˌɑh.ku»huh.ti>det.tijn>eæs.kɑ
Vullešvahkku+Sem/Time+N+Der/huhtti+V+TV+Ind+Prt+Sg3	Vullešvahku»huhti>i	vˈul.leʃ#vˌɑh.ku»huh.ti>i
Vullešvahkku+Sem/Time+N+Der/huhtti+V+TV+Sup	Vullešvahku»huhtá>žit	vˈul.leʃ#vˌɑh.ku»huhː.tɑː>žih
Vullešvahkku+Sem/Time+N+Der/huvva+V+IV+Imprt+Du1	Vullešvahku»huvvu>	vˈul.leʃ#vˌɑh.ku»huv.vu>
Vullešvahkku+Sem/Time+N+Sg+Acc+PxPl1	Vullešvahkko>met	vˈul.leʃ#vˌɑhː.ko>meh
Vullešvahkku+Sem/Time+N+Sg+Gen+Allegro	Vullešvahkko>	vˈul.leʃ#vˌɑhː.ko>
Vullešvahkku+Sem/Time+N+Sg+Nom+PxDu2	Vullešvahkko>de	vˈul.leʃ#vˌɑhː.ko>de
Vullešvahkku+Sem/Time+N+Der/heapmi+A+Comp+Sg+Nom	Vullešvahkko»hat>	vˈul.leʃ#vˌɑhː.ko»hɑt>
Vullešvahkku+Sem/Time+N+Der/heapmi+A+Comp+Attr	Vullešvahkko»hit>	vˈul.leʃ#vˌɑhː.ko»hit>
Vullešvahkku+Sem/Time+N+Der/huhtti+V+TV+Imprt+ConNeg	Vullešvahkko»huhte>	vˈul.leʃ#vˌɑhː.ko»huh.te>
Vullešvahkku+Sem/Time+N+Der/huvva+V+IV+VGen	Vullešvahkko»huva>	vˈul.leʃ#vˌɑhː.ko»hu.vɑ>
Vullešvahkku+Sem/Time+N+Der/laš+A+Comp+Pl+Nom	Vullešvahkko»leappo>t	vˈul.leʃ#vˌɑhː.ko»lĕæp.po>h
Vullešvahkku+Sem/Time+N+Der/laš+A+Comp+Attr	Vullešvahkko»let>	vˈul.leʃ#vˌɑhː.ko»let>
Vullešvahkku+Sem/Time+N+Der/viđá+Adv	Vullešvahkko»viđá	vˈul.leʃ#vˌɑhː.ko»vi.ðɑː
Vullešvahkku+Sem/Time+N+Pl+Acc+PxPl3	Vullešvahkku>id>easet	vˈul.leʃ#vˌɑhː.ku>id>ĕæ.seh
Vullešvahkku+Sem/Time+N+Pl+Gen+PxPl3	Vullešvahkku>id>easet	vˈul.leʃ#vˌɑhː.ku>id>ĕæ.seh
Vullešvahkku+Sem/Time+N+Pl+Nom+PxDu3	Vullešvahkku>id>easkka	vˈul.leʃ#vˌɑhː.ku>id>eæs.kɑ
Vullešvahkku+Sem/Time+N+Sg+Acc+PxPl3	Vullešvahkku>set	vˈul.leʃ#vˌɑhː.ku>seh
Vullešvahkku+Sem/Time+N+Sg+Gen+PxPl3	Vullešvahkku>set	vˈul.leʃ#vˌɑhː.ku>seh
Vullešvahkku+Sem/Time+N+Sg+Gen	Vullešvahkku>	vˈul.leʃ#vˌɑhː.ku>
Vullešvahkku+Sem/Time+N+Sg+Ill	Vullešvahkku>i	vˈul.leʃ#vˌɑhː.ku>i
akšuvdna+N+Sg+Nom+PxDu3	akšuvdna>ska	ˈɑkː.ʃuv.tnɑ>skɑ
akšuvdna+N+Sg+Nom+PxPl3	akšuvdna>set	ˈɑkː.ʃuv.tnɑ>seh
akšuvdna+N+Sg+Nom+PxSg3	akšuvdna>s	ˈɑkː.ʃuv.tnɑ>s
akšuvdna+N+Sg+Nom	akšuvdna>	ˈɑkː.ʃuv.tnɑ>
akšuvdna+N+Ess	akšuvdna>n	ˈɑkː.ʃuv.tnɑ>n
akšuvdna+N+Ess+PxSg1	akšuvdna>n>an	ˈɑkː.ʃuv.tnɑ>n>ɑn
akšuvdna+N+Ess+PxSg2	akšuvdna>n>at	ˈɑkː.ʃuv.tnɑ>n>ɑh
akšuvdna+N+Sg+Acc+PxSg1	akšuvdna>n	ˈɑkː.ʃuv.tnɑ>n
akšuvdna+N+Sg+Nom+PxSg1	akšuvdna>n	ˈɑkː.ʃuv.tnɑ>n
akšuvdna+N+Sg+Ill	akšuvdni>i	ˈɑkː.ʃuv.tni>i
akšuvdna+N+Pl+Nom	akšuvnna>t	ˈɑkː.ʃuvn.nɑ>h
akšuvdna+N+Sg+Com	akšuvnna>in	ˈɑkː.ʃuvn.nɑ>in
akšuvdna+N+Sg+Loc	akšuvnna>s	ˈɑkː.ʃuvn.nɑ>s
akšuvdna+N+Der/Dimin+N+Pl+Nom	akšuvnna»žat	ˈɑkː.ʃuvn.nɑ»žɑh
akšuvdna+N+Der/Dimin+N+Sg+Acc	akšuvnna»ža	ˈɑkː.ʃuvn.nɑ»žɑ
akšuvdna+N+Der/Dimin+N+Sg+Gen	akšuvnna»ža	ˈɑkː.ʃuvn.nɑ»žɑ
akšuvdna+N+Der/Dimin+N+Pl+Gen	akšuvnna»žiid	ˈɑkː.ʃuvn.nɑ»žijh
akšuvdna+N+Der/heapmi+A+Pl+Com	akšuvnna»hemi>iguin	ˈɑkː.ʃuvn.nɑ»he.mi>i.gujn
akšuvdna+N+Der/heapmi+A+Attr+Der/vuohta+N+Pl+Acc+PxDu2	akšuvnna»his>»»»vuođa>id>eatte	ˈɑkː.ʃuvn.nɑ»his>»»»#vˌuo.ðɑ>id>ĕæt.te
akšuvdna+N+Der/huhtti+V+TV+VAbess+A+Attr	akšuvnna»huhte>keahtes	ˈɑkː.ʃuvn.nɑ»huh.te>kĕæh.tes
akšuvdna+N+Der/huhtti+V+TV+Ind+Prt+Du2	akšuvnna»huhti>ide	ˈɑkː.ʃuvn.nɑ»huh.ti>i.de
akšuvdna+N+Der/huhtti+V+TV+Ind+Prt+Du3	akšuvnna»huhti>iga	ˈɑkː.ʃuvn.nɑ»huh.ti>i.gɑ
akšuvdna+N+Der/huvva+V+IV+Pot+Prs+Sg1	akšuvnna»huva>žan	ˈɑkː.ʃuvn.nɑ»hu.vɑ>žɑn
akšuvdna+N+Der/huvva+V+IV+VGen	akšuvnna»huva>	ˈɑkː.ʃuvn.nɑ»hu.vɑ>
akšuvdna+N+Der/huvva+V+IV+Actio+Gen	akšuvnna»huvva>n	ˈɑkː.ʃuvn.nɑ»huv.vɑ>n
akšuvdna+N+Der/huvva+V+IV+Ind+Prs+Du1	akšuvnna»huvve>	ˈɑkː.ʃuvn.nɑ»huv.ve>
akšuvdna+N+Der/huvva+V+IV+Ind+Prs+Sg3	akšuvnna»huvvá>	ˈɑkː.ʃuvn.nɑ»huvː.vɑː>
aa+Interj	aa	ˈɑː
abdiseret+V+IV+Ind+Prt+Du2	abdiseri>ide	ˈɑb.di.se.ri>i.de
ablatiiva+N+Der/viđá+Adv	ablatiiva»viđá	ˈɑb.lɑː.tijː.vɑ»vi.ðɑː
adreassa+G3+N+Sg+Ill	adressi>i	ˈɑ.dres.sˌi>i
adresseret+V+TV+Der/PassL+V+IV+Der/upmi+N+Sg+Loc+PxSg3	adressere»j»umi>st>is	ˈɑ.dres.sˌe.re»j»u.mi>st>is
aetáhtta+N+Der/viđá+Adv	aetáhtta»viđá	ˈɑ.e.tˌɑhː.tɑ»vi.ðɑː
aerográmma+N+Der/viđá+Adv	aerográmma»viđá	ˈɑe.ro.grˌɑːm.mɑ»vi.ðɑː
aerográmma+N+Sg+Ill	aerográmmi>i	ˈɑe.ro.grˌɑːm.mi>i
agnostisisma+N+Sg+Ill	agnostisismi>i	ˈɑ.gnos.tˌi.sis.mi>i
ahcit+V+IV+Der/st+V+Der/alla+V+VAbess	azá»stala>haga	ˈɑ.dsɑː»stɑ.lɑ>hɑ.gɑ
ahttat+V+IV+ConNegII	ahtto>	ˈɑhː.to>
aji+N+Der/heapmi+A+Comp+Sg+Nom	aje»habbo>	ˈɑ.je»hɑbː.po>
aji+N+Der/Dimin+N+Sg+Loc+PxPl3	adjág>»ačča>st>easet	ˈɑcː.cɑːg>»ɑt.tʃɑ>st>ĕæ.seh
ajihit+V+IV+Der/alla+V+Sup	ajáh»ala>žit	ˈɑ.jɑːh»ɑ.lɑ>žih
akleija+Sem/Plant+N+Sg+Ill	akleiji>i	ˈɑ.klej.jˌi>i
akromáhtalaš+A+Der/vuohta+N+Pl+Nom	akromáhtalaš»»»vuođa>t	ˈɑ.kro.mˌɑːh.tɑ.lɑʃ»»»#vˌuo.ðɑ>h
aldna+N+Pl+Ill	alnna>ide	ˈɑlnː.nɑː>i.de
algŋa+N+Pl+Nom	alŋŋa>t	ˈɑlŋŋ.ŋɑː>h
amfi+N+Pl+Com	amfi>iguin	ˈɑm.fi>i.gujn
amnestiija+N+Sg+Ill	amnestiiji>i	ˈɑm.nes.tij.ji>i
ampulla+N+Sg+Ill	ampulli>i	ˈɑmː.m̥pul.li>i
annekteret+V+TV+Ind+Prt+Sg3	annekteri>i	ˈɑn.nekː.hte.ri>i
aortauvssot+N+Sg+Nom	aortauvssot>	ˈɑorə.htɑ#ˌuβs.sot>
assi+N+Der/heapmi+A+Comp+Attr	ase»hut>	ˈɑ.se»hut>
asiáhta+Sem/Hum+N+Sg+Ill	asiáhti>i	ˈɑ.si.ˌɑːh.ti>i
assálaga+Adv	assálaga	ˈɑsː.sɑː.lɑ.gɑ
astat+V+TV+Der/NomAg+Sem/Hum+N+Der/viđá+Adv	asti»viđá	ˈɑsː.ti»vi.ðɑː
atrofieret+V+TV+Der/h+V+Der/adda+V+VAbess	atrofiere»hatta>haga	ˈɑ.tro.fˌi.e.re»hɑt.tɑ>hɑ.gɑ
atrofieret+V+TV+Der/PassL+V+IV+Der/upmi+N+Sg+Ill+PxSg3	atrofiere»j»upmá>s>is	ˈɑ.tro.fˌi.e.re»j»up.mɑː>s>is
atrofieret+V+TV+Ind+Prt+Pl2	atrofieri>idet	ˈɑ.tro.fˌi.e.ri>i.deh
atnit+V+TV+Der/NomAg+N+Sg+Gen+PxSg1	adná>»n	ˈɑd.nɑː>»n
atta+N+Der/Dimin+N+Sg+Nom	addag>»aš>	ˈɑdː.tɑːg>»ɑʃ>
ateasta+N+Sg+Ill	atesti>i	ˈɑ.tes.tˌi>i
attestit+V+TV+Der/asti+V+Der/PassS+V+IV+Ind+Prt+Du3	attist»astu>»iga	ˈɑtː.tist»ɑs.tu>»i.gɑ
avvit+V+TV+Der/stuvva+V+Ind+Prs+Sg3	ave»stuvvá>	ˈɑ.ve»stuvː.vɑː>
avvi+N+Sg+Loc+PxPl3	avi>st>easet	ˈɑ.vi>st>ĕæ.seh
avvit+V+TV+VAbess	avi>keahttá	ˈɑ.vi>kĕæhː.tɑː
avaleret+V+TV+Der/d+V+Inf	avalere»dit	ˈɑ.vɑː.lˌe.re»dih
ayoreo+N+Sg+Ill	ayoreo>i	ˈɑyo.re.ˌo>i
azistit+V+IV+Der/alla+V+Imprt+Du2	azást»alli>	ˈɑ.dsɑːst»ɑl.li>
ađđamahttá+Adv	ađđamahttá	ˈɑðː.ðɑː.mɑhː.tɑː
aŋkke+Adv	aŋkke	ˈɑŋŋ̊.ke
akšuvdnabeaivi+Sem/Time+N+Pl+Acc	ákšunbeivvi>id	ˈɑːkː.ʃun#pˌejv.vi>id
akšuvdnabeaivi+Sem/Time+N+Pl+Com+PxDu1	ákšunbeivvi>id>eameguin	ˈɑːkː.ʃun#pˌejv.vi>id>ĕæ.me.gujn
akšuvdnabeaivi+Sem/Time+N+Pl+Com+PxDu2	ákšunbeivvi>id>eatteguin	ˈɑːkː.ʃun#pˌejv.vi>id>ĕæt.te.gujn
akšuvdnabeaivi+Sem/Time+N+Pl+Com+PxDu3	ákšunbeivvi>id>easkkaguin	ˈɑːkː.ʃun#pˌejv.vi>id>eæs.kɑ.gujn
akšuvdnabeaivi+Sem/Time+N+Pl+Com+PxPl3	ákšunbeivvi>id>easetguin	ˈɑːkː.ʃun#pˌejv.vi>id>ĕæ.set.gujn
akšuvdnabeaivi+Sem/Time+N+Pl+Com+PxSg3	ákšunbeivvi>id>isguin	ˈɑːkː.ʃun#pˌejv.vi>id>is.gujn
akšuvdnabeaivi+Sem/Time+N+Pl+Gen+PxDu2	ákšunbeivvi>id>eatte	ˈɑːkː.ʃun#pˌejv.vi>id>ĕæt.te
akšuvdnabeaivi+Sem/Time+N+Pl+Loc	ákšunbeivvi>in	ˈɑːkː.ʃun#pˌejv.vi>in
akšuvdnabeaivi+Sem/Time+N+Pl+Nom+PxPl1	ákšunbeivvi>id>eamet	ˈɑːkː.ʃun#pˌejv.vi>id>ĕæ.meh
akšuvdnabeaivi+Sem/Time+N+Sg+Com	ákšunbeivvi>in	ˈɑːkː.ʃun#pˌejv.vi>in
akšuvdnabeaivi+Sem/Time+N+Sg+Com+PxDu2	ákšunbeivvi>in>eatte	ˈɑːkː.ʃun#pˌejv.vi>in>ĕæt.te
akšuvdnabeaivi+Sem/Time+N+Sg+Com+PxDu3	ákšunbeivvi>in>easkka	ˈɑːkː.ʃun#pˌejv.vi>in>eæs.kɑ
akšuvdnabeaivi+Sem/Time+N+Sg+Com+PxPl1	ákšunbeivvi>in>eamet	ˈɑːkː.ʃun#pˌejv.vi>in>ĕæ.meh
akšuvdnabeaivi+Sem/Time+N+Sg+Com+PxPl2	ákšunbeivvi>in>eattet	ˈɑːkː.ʃun#pˌejv.vi>in>ĕæt.teh
akšuvdnabeaivi+Sem/Time+N+Sg+Com+PxSg1	ákšunbeivvi>in>an	ˈɑːkː.ʃun#pˌejv.vi>in>ɑn
akšuvdnabeaivi+Sem/Time+N+Sg+Com+PxSg2	ákšunbeivvi>in>at	ˈɑːkː.ʃun#pˌejv.vi>in>ɑh
akšuvdnabeaivi+Sem/Time+N+Der/viđá+Adv	ákšunbeaive»viđá	ˈɑːkː.ʃun#pˌĕæjː.ve»vi.ðɑː
akšuvdnabeaivi+Sem/Time+N+Ess+PxDu1	ákšunbeaivi>n>eame	ˈɑːkː.ʃun#pˌĕæjː.vi>n>ĕæ.me
akšuvdnabeaivi+Sem/Time+N+Ess+PxPl3	ákšunbeaivi>n>easet	ˈɑːkː.ʃun#pˌĕæjː.vi>n>ĕæ.seh
akšuvdnabeaivi+Sem/Time+N+Sg+Acc+PxPl1	ákšunbeaivá>met	ˈɑːkː.ʃun#pˌĕæjː.vɑː>meh
akšuvdnabeaivi+Sem/Time+N+Sg+Nom+PxDu2	ákšunbeaivá>de	ˈɑːkː.ʃun#pˌĕæjː.vɑː>de
akšuvdnabeaivi+Sem/Time+N+Sg+Ill	ákšunbeaivá>i	ˈɑːkː.ʃun#pˌĕæjː.vɑː>i
akšuvdnabeaivi+Sem/Time+N+Sg+Gen+Allegro	ákšunbeaivve>	ˈɑːkː.ʃun#pˌĕæjv.ve>
akšuvdnabeaivi+Sem/Time+N+Sg+Acc+PxSg3	ákšunbeaivvi>s	ˈɑːkː.ʃun#pˌeæjv.vi>s
akšuvdnabeaivi+Sem/Time+N+Der/heapmi+A+Sg+Nom	ákšunbeaivvi»heapme>	ˈɑːkː.ʃun#pˌeæjv.vi»hĕæp.me>
akšuvdnabeaivi+Sem/Time+N+Der/huhtti+V+TV+Ind+Prs+Sg1	ákšunbeaivvi»huhtá>n	ˈɑːkː.ʃun#pˌeæjv.vi»huhː.tɑː>n
akšuvdnabeaivi+Sem/Time+N+Der/huvva+V+IV+Imprt+Pl1	ákšunbeaivvi»huvvo>t	ˈɑːkː.ʃun#pˌeæjv.vi»huv.vo>h
akšuvdnabeaivi+Sem/Time+N+Sg+Acc+PxPl2	ákšunbeaivvá>det	ˈɑːkː.ʃun#pˌeæjv.vɑː>deh
akšuvdnabeaivi+Sem/Time+N+Sg+Acc+PxSg2	ákšunbeaivvá>t	ˈɑːkː.ʃun#pˌeæjv.vɑː>h
akšuvdnabeaivi+Sem/Time+N+Der/Dimin+N+Sg+Nom	ákšunbeaivvá»š	ˈɑːkː.ʃun#pˌeæjv.vɑː»ʃ
akšuvdnabeaivi+Sem/Time+N+Der/laš+A+Comp+Attr	ákšunbeaivvá»lit>	ˈɑːkː.ʃun#pˌeæjv.vɑː»lit>
akšuvdnabeaivi+Sem/Time+N+Der/laš+A+Der/vuohta+N+Sg+Ill	ákšunbeaivvá»laš»»»vuhti>i	ˈɑːkː.ʃun#pˌeæjv.vɑː»lɑʃ»»»#vˌuh.ti>i
bat+Pcle	bat	pˈɑh
beaggi+Sem/Hum+N+NomAg+Pl+Ill	beggi>ide	pˈegː.ki>i.de
bekkohaddat+V+TV+Imprt+Pl2	bekkohadde>t	pˈek.ko.hɑdː.te>h
berosmeahttun+A+Ess	birosmeahttum>in	pˈiː.ros.mˌĕæhː.tum>in
beroštahtti+A+Sg+Ill	biroštahttá>i	pˈiː.roʃ.tˌɑhː.tɑː>i
biffa+G3+N+Der/heapmi+A+Ess	biffa»heapmi>n	pˈif.fɑː»heæp.mi>n
bikketášši+G3+N+Sg+Ill+PxPl3	bikketáššá>s>easet	pˈik.ket#ˌɑːʃ.ʃɑː>s>ĕæ.seh
biljas+A+Der/vuohta+N+Sg+Loc+PxSg1	biljas>»»»vuođa>st>an	pˈiʎ.ʎɑːs>»»»#vˌuo.ðɑ>st>ɑn
biŧonsápmi+Sem/Hum+Sem/Lang+N+Der/heapmi+A+Pl+Gen	biŧonsáme»hemi>id	pˈiː.θon#sˌɑː.me»he.mi>id
bleahkka+N+Sg+Ill	blehkki>i	blˈehː.ki>i
bliánta+v1+N+Sg+Ill	bliánti>i	blˈi.ɑːnː.n̥tˌi>i
bliántanjunni+v2+N+Ess	blyántanjunni>n	blˈy.ɑːnː.n̥tˌɑ#ɲˌun.ni>n
boazu+Sem/Ani+N+Der/huhtti+V+TV+Sup	boazo»huhtá>žit	pˈŏɑ.dso»huhː.tɑː>žih
botkalit+V+TV+Cond+Prs+ConNeg	botkal>ivčče>	pˈotː.hkɑl>ivhː.tʃe>
braveret+V+TV+Der/PassL+V+IV+Actio+Ess	bravere»juvvo>min	brˈɑ.ve.rˌe»juv.vo>min
brugga+N+Sg+Loc	brukka>s	brˈukː.kɑː>s
bráhkka+Sem/Build+N+Der/Dimin+N+Sg+Gen+PxDu2	bráhka»žeatte	brˈɑːh.kɑ»žĕæt.te
bráhkka+Sem/Build+N+Der/viđá+Adv	bráhkka»viđá	brˈɑhː.kɑ»vi.ðɑː
byrohoavda+Sem/Hum+N+Sg+Ill	byrohovdi>i	pˈy.ro#hˌoβː.ti>i
byrohoavda+Sem/Hum+N+Der/viđá+Adv	byrohoavda»viđá	pˈy.ro#hˌoɑβː.tɑ»vi.ðɑː
byrokratiija+N+Sg+Ill	byrokratiiji>i	pˈy.ro.krˌɑ.tij.ji>i
byrokráhtaheapme+A+Der/huvva+V+IV+Imprt+Du1	byrokráhtah»uvvu>	pˈy.rok.rˌɑːh.tɑh»uv.vu>
byråhoavda+Sem/Hum+N+Der/viđá+Adv	byråhoavda»viđá	pˈy.roː#hˌoɑβː.tɑ»vi.ðɑː
bálda+N+Ess+PxSg2	bálda>n>at	pˈɑːlː.tɑ>n>ɑh
bávttiháldi+Sem/Hum+N+Sg+Ill	bávttiháldá>i	pˈɑːβɸ.ti#hˌɑːlː.tɑː>i
báŋádit+V+IV+Actio+Ess	báŋád>eame>	pˈɑː.ŋɑːd>ĕæ.me>
bážus+N+Sg+Acc	báhčos>a	pˈɑːh.tʃos>ɑ
bážihit+V+TV+Der/adda+V+Der/PassS+V+IV+Imprt+Sg3	bážáh»addo>»jus	pˈɑː.dʃɑːh»ɑdː.to>»jus
börsafitnodat+Sem/Org+N+Sg+Nom	börsafitnodat>	pˈørə.sɑ#fˌit.no.dɑt>
börsagávpi+N+Der/viđá+Adv	börsagávpe»viđá	pˈørə.sɑ#kˌɑːβː.ɸpe»vi.ðɑː
börsakursa+N+Sg+Ill	börsakursi>i	pˈørə.sɑ#khˌurə.si>i
cadjat+V+TV+Der/st+V+VGen	caja»s	tsˈɑ.jɑː»s
cahca+N+Der/huvva+V+IV+VGen	caza»huva>	tsˈɑ.dsɑː»hu.vɑ>
cahkat+V+IV+Der/NomAg+N+Sg+Acc+PxSg2	cahkká>»t	tsˈɑhː.kɑː>»h
cakŋa+N+Sg+Ill	cakŋi>i	tsˈɑk.ŋi>i
ceakkuhit+V+TV+Der/alla+V+Der/PassL+V+IV+Imprt+Sg2	cekkoh»allo>j»uvvo>	tsˈek.koh»ɑl.lo>j»uv.vo>
cekkosmuvvat+V+IV+Der/ahtti+V+Ind+Prt+Sg2	cekkosm»ahtte>t	tsˈek.kosm»ɑhː.te>h
celkojupmi+N+Sg+Gen	celkojumi>	tsˈelə.hko.ju.mi>
cementeret+V+TV+Der/st+V+Ind+Prs+ConNeg	cementere»s	tsˈeː.menː.n̥tˌe.re»s
changeret+V+TV+Ind+Prt+Pl2	changeri>idet	tshˈɑŋŋ.ke.ri>i.deh
chatságastallan+Sem/Act+N+Der/viđá+Adv	chatságastallan»viđá	tshˈɑt#sˌɑː.gɑs.tˌɑl.lɑn»#vˌi.ðɑː
chevroteret+V+IV+Pot+Prs+ConNeg	chevrotere>š	tshˈeβː.ro.te.re>ʃ
chevroteret+V+IV+Der/h+V+Der/easti+V+Imprt+Du1	chevrotere»heastu>	tshˈeβː.ro.te.re»heæs.tu>
chevroteret+V+IV+Der/st+V+VGen	chevrotere»s	tshˈeβː.ro.te.re»s
chevroteret+V+IV+Ind+Prt+Du1	chevroteri>ime	tshˈeβː.ro.te.ri>i.me
chilibihppor+N+Der/Dimin+N+Der/Dimin+N+Ess	chilibihppor»ačča»žin	tshˈi.li#pˌihː.por»ɑt.tʃɑ»žin
chilibihppor+N+Der/heapmi+A+Attr	chilibihppor»his>	tshˈi.li#pˌihː.por»#hˌis>
chilibihppor+N+Der/heapmi+A+Attr+Der/vuohta+N+Sg+Ill	chilibihppor»his>»»»vuhti>i	tshˈi.li#pˌihː.por»#hˌis>»»»#vˌuh.ti>i
chilibihppor+N+Der/viđá+Adv	chilibihppor»viđá	tshˈi.li#pˌihː.por»#vˌi.ðɑː
ciehkut+V+IV+Der/st+V+IV+Der/NomAct+N+Sg+Gen+Allegro	ciego»steame>	tsˈĭe.go»stĕæ.me>
cihcit+V+TV+Der/stuvva+V+Cond+Prs+Sg2	cize»stuva>ledje>t	tsˈi.dse»stu.vɑ>lec.ce>h
cikcut+V+TV+Der/h+V+TV+Ind+Prs+ConNeg	civccu»t	tsˈiβɸ.tsu»h
cillat+V+IV+VGen	cila>	tsˈi.lɑː>
comeback+N+Sg+Ill	comebacki>i	tsˈo.me#pˌɑts.ki>i
crossa+N+Der/huvva+V+IV+VAbess+A+Attr	crosa»huva>keahtes	tsrˈo.sɑː»hu.vɑ>kĕæh.tes
crossa+N+Sg+Ill	crossi>i	tsrˈos.si>i
crossbána+Sem/Plc+N+Sg+Ill	crossbáni>i	tsrˈosː#pˌɑː.ni>i
crossfalástallan+Sem/Act+N+Ess	crossfalástallam>e	tsrˈosː#fˌɑ.lɑːs.tˌɑl.lɑm>e
cyber+N+Der/viđá+Adv	cyber»viđá	tsˈy.ber»#vˌi.ðɑː
cyš+Interj	cyš	tsˈyʃ
cáhpat+V+TV+Imprt+Du1	cáhppu>	tsˈɑhː.pu>
cáragramohtá+N+Ess+PxSg2	cáragramohtá>n>at	tsˈɑː.rɑg.rˌɑ#mˌohː.tɑː>n>ɑh
cázastit+V+TV+Ind+Prs+ConNeg	cázas>	tsˈɑː.dsɑs>
cæsarisma+N+Ess	cæsarisma>n	tsˈæ.sɑ.rˌisː.mɑ>n
cæsarisma+N+Pl+Com	cæsarismma>iguin	tsˈæ.sɑ.rˌis.mɑ>i.gujn
cæsarisma+N+Der/huhtti+V+TV+Pot+Prs+ConNeg	cæsarismma»huhte>š	tsˈæ.sɑ.rˌis.mɑ»huh.te>ʃ
cæsarisma+N+Der/huvva+V+IV+Imprt+ConNegII	cæsarismma»huvvo>	tsˈæ.sɑ.rˌis.mɑ»huv.vo>
čiekŋun+Sem/Act+N+Sg+Nom+PxSg1	čiekŋum>an	tšĭĕkː.ŋum>ɑn
čiekŋun+Sem/Act+N+Sg+Nom	čiekŋun>	tšĭĕkː.ŋun>
dagus+N+Sg+Ill	dahkos>ii	tˈɑh.kos>ij
dajus+N+Sg+Ill+PxSg2	dadjos>asa>t	tˈɑc.cos>ɑ.sɑ>h
davrragit+V+IV+VAbess	davrrat>haga	tˈɑβrː.rɑːt>#hˌɑ.gɑ
daŋas+Sem/Plant+N+Sg+Acc	dakŋas>a	tˈɑkː.ŋɑːs>ɑ
danhámat+A+Ess	donhámag>in	tˈon#hˌɑː.mɑg>in
danhámat+A+Pl+Nom	donhámag>at	tˈon#hˌɑː.mɑg>ɑh
danhámat+A+Sg+Loc	donhámag>is	tˈon#hˌɑː.mɑg>is
deagga+Sem/Hum+N+Sg+Ill	deggi>i	tˈegː.ki>i
deonttalaš+A+Der/vuohta+N+Sg+Loc+PxPl3	deonttalaš»»»vuođa>st>easet	tˈe.onht.tˌɑ.lɑʃ»»»#vˌuo.ðɑ>st>ĕæ.seh
deđot+A+Sg+Gen	diđog>a	tˈiː.ðog>ɑ
deđot+A+Superl+Attr	diđog>amos>	tˈiː.ðog>ɑ.mos>
diminutiiva+N+Sg+Ill	deminutiivi>i	tˈe.mi.nˌu.tij.vi>i
diminutiiva+N+Sg+Gen+PxPl3	deminutiivva>set	tˈe.mi.nˌu.tijv.vɑ>seh
diminutiiva+N+Der/heapmi+A+Pl+Acc	deminutiivva»hemi>id	tˈe.mi.nˌu.tijv.vɑ»he.mi>id
digrešuvdna+N+Sg+Ill	digrešuvdni>i	tˈi.gre.ʃˌuβː.tni>i
dikŋa+N+Sg+Loc	diŋa>s	tˈi.ŋɑː>s
divttis+A+Sg+Gen	diktás>a	tˈikː.htɑːs>ɑ
divuhit+V+TV+Ind+Prs+ConNeg	divut>	tˈiː.vut>
diŋal+N+Sg+Acc+PxSg1	dikŋal>an	tˈikː.ŋɑːl>ɑn
don+Pron+Pers+Du2+Loc	dudno>s	tˈud.no>s
don+Pron+Pers+Sg2+Acc	du>	tˈu>
don+Pron+Pers+Sg2+Ess	du>nin	tˈu>nin
dodjit+V+TV+Der/NomAg+N+Sg+Ill+PxSg2	doddjá>»s>at	tˈoɟː.cɑː>»s>ɑh
doggi+N+Der/heapmi+A+Superl+Sg+Loc	dokki»hepmos>is	tˈok.ki»hep.mos>is
doleš+N+Sg+Acc+PxDu1	dolež>eame	tˈoː.lež>ĕæ.me
dordnu+N+Sg+Nom+PxSg2	dordno>t	tˈorə.tno>h
dovtta+Sem/Ani+N+Sg+Com+PxPl3	doktag>iinni>set	tˈokː.htɑg>ijn.ni>seh
dovdan+Sem/Act+N+Ess	dovdam>in	tˈoβː.tɑːm>in
dovle+Adv+Sem/Plc	dovle	tˈoβː.le
doŋas+A+Comp+Sg+Nom	dokŋas>at>	tˈokː.ŋɑːs>ɑt>
dramáhtalaš+A+Der/vuohta+N+Sg+Com	dramáhtalaš»»»vuođa>in	drˈɑ.mɑːh.tˌɑ.lɑʃ»»»#vˌuo.ðɑ>in
drumbugoazan+N+Der/viđá+Adv	drumbugoazan»viđá	drˈumː.pu#kˌoɑ.dsɑn»#vˌi.ðɑː
duhtat+V+IV+Der/PassL+V+IV+Ind+Prt+Sg3	duhtto>»juvvu>i	tˈuhː.to>»juv.vu>i
dulágan+A+Der/vuohta+N+Sg+Ill	dulágán»»»vuhti>i	tˈu#lˌɑː.gɑːn»»»#vˌuh.ti>i
duodji+N+Pl+Com	duji>iguin	tˈu.ji>i.gujn
dynámo+N+Sg+Acc+PxSg1	dynámo>n	tˈy.nɑː.mˌo>n
dysleksiija+N+Sg+Ill	dysleksiiji>i	tˈys.lekː.sij.ji>i
dábba+N+Der/laš+A+Der/vuohta+N+Pl+Nom	dáppa»laš»»»vuođa>t	tˈɑːp.pɑ»lɑʃ»»»#vˌuo.ðɑ>h
dággi+N+Pl+Nom	dákki>t	tˈɑːk.ki>h
dákka+Adv	dákka	tˈɑːk.kɑ
dáktái+A+Pl+Nom	dáktá>t	tˈɑːkː.htɑː>h
dámmáráidu+Sem/Ani+Sem/Group+N+Der/laš+A+Der/vuohta+N+Sg+Ill	dámmáráiddo»laš»»»vuhti>i	tˈɑːm.mɑː#rˌɑːjt.to»lɑʃ»»»#vˌuh.ti>i
dánset+V+TV+Ind+Prt+Pl2	dánsi>idet	tˈɑːnː.si>i.deh
dátnjat+V+TV+Der/st+V+Imprt+Sg2	dánja»s	tˈɑːnː.jɑ»s
eana+Sem/Plc+v1+N+Der/viđá+Adv	eana>»viđá	ˈeæ.nɑ>»vi.ðɑː
eana+Sem/Plc+v1+N+Der/heapmi+A+Comp+Sg+Nom	eana»heabbo>	ˈeæ.nɑ»hĕæbː.po>
eana+Sem/Plc+v1+N+Der/heapmi+A+Attr	eana»his>	ˈeæ.nɑ»his>
eana+Sem/Plc+v1+N+Der/huvva+V+IV+Ind+Prs+Sg3	eana»huvvá>	ˈeæ.nɑ»huvː.vɑː>
eana+Sem/Plc+v1+N+Sg+Gen+PxSg2	eatnam>at	ˈeæt.nɑm>ɑh
eana+Sem/Plc+v1+N+Sg+Gen	eatnam>a	ˈeæt.nɑm>ɑ
eana+Sem/Plc+v1+N+Pl+Nom+PxSg2	eatnam>iiddá>t	ˈeæt.nɑm>ijt.tɑː>h
eana+Sem/Plc+v2+N+Ess	eanam>in	ˈeæ.nɑm>in
eana+Sem/Plc+v2+N+Pl+Nom	eatnam>at	ˈeæt.nɑm>ɑh
eana+Sem/Plc+v2+N+Sg+Gen+PxSg1	eatnam>an	ˈeæt.nɑm>ɑn
eana+Sem/Plc+v2+N+Sg+Acc	eatnam>a	ˈeæt.nɑm>ɑ
eana+Sem/Plc+v2+N+Sg+Ill+PxDu3	eatnam>asa>ska	ˈeæt.nɑm>ɑ.sɑ>skɑ
eana+Sem/Plc+v2+N+Der/Dimin+N+Sg+Ill	eatnam>»ažži>i	ˈeæt.nɑm>»ɑdː.tʃi>i
eana+Sem/Plc+v3+N+Ess	eatnam>in	ˈeæt.nɑm>in
eana+Sem/Plc+v3+N+Pl+Nom	eatnam>at	ˈeæt.nɑm>ɑh
eana+Sem/Plc+v3+N+Sg+Gen	eatnam>a	ˈeæt.nɑm>ɑ
eana+Sem/Plc+v3+N+Sg+Com	eatnam>iin	ˈeæt.nɑm>ijn
eana+Sem/Plc+v3+N+Sg+Com+PxDu3	eatnam>iinni>ska	ˈeæt.nɑm>ijn.ni>skɑ
eana+Sem/Plc+v3+N+Der/Dimin+N+Sg+Nom	eatnam»aš>	ˈeæt.nɑm»ɑʃ>
eana+Sem/Plc+v3+N+Sg+Nom	eatnan>	ˈeæt.nɑn>
eana+Sem/Plc+v3+N+Der/heapmi+A+Ess	eatnan»heapmi>n	ˈeæt.nɑn»#hˌeæp.mi>n
eana+Sem/Plc+v3+N+Der/laš+A+Comp+Pl+Loc	eatnan»laččabuin	ˈeæt.nɑn»#lˌɑt.tʃɑ.bujn
eana+Sem/Plc+v3+N+Der/laš+A+Comp+Sg+Nom	eatnan»l>it>	ˈeæt.nɑn»#l>it>
eana+Sem/Plc+v3+N+Der/viđá+Adv	eatnan»viđá	ˈeæt.nɑn»#vˌi.ðɑː
eana+Sem/Plc+N+Der/huhtti+V+TV+VAbess	eana»huhte>haga	ˈeæ.nɑ»huh.te>hɑ.gɑ
eana+Sem/Plc+N+Sg+Nom	eanan>	ˈeæ.nɑn>
eana+Sem/Plc+N+Der/laš+A+Superl+Attr	eanan>»laččamus>	ˈeæ.nɑn>»#lˌɑt.tʃɑ.mus>
eana+Sem/Plc+N+Pl+Nom	eatnam>at	ˈeæt.nɑm>ɑh
eana+Sem/Plc+N+Sg+Nom	eatnan>	ˈeæt.nɑn>
eana+Sem/Plc+N+Der/heapmi+A+Sg+Nom	eatnan»heapme>	ˈeæt.nɑn»#hˌĕæp.me>
eana+Sem/Plc+N+Der/viđá+Adv	eatnan»viđá	ˈeæt.nɑn»#vˌi.ðɑː
eatnu+Sem/Plc+N+Der/laš+A+Comp+Pl+Com	eno»labbu>iguin	ˈe.no»lɑbː.pu>i.gujn
eaŋŋa+N+Sg+Ill	eŋŋi>i	ˈeŋ.ŋi>i
eahtturuoksat+A+SgNomCmp+Der/fárddat+A+Der/vuohta+N+Sg+Ill	eahtturuoksat»»»»fárddat>»»»vuhti>i	ˈĕæhː.tu#rˌuokː.sɑt»#»»»#fˌɑːrt.tɑt>»»»#vˌuh.ti>i
eallit+V+IV+Imprt+Du1	eallu>	ˈeæl.lu>
eandalii+Adv	eandalii	ˈĕænː.tɑ.lij
ebel+Sem/Plant+N+Der/Dimin+N+Pl+Com+PxSg2	ebel»ačča>id>atguin	ˈeː.bel»ɑt.tʃɑ>id>ɑt.gujn
ebmoslieđat+N+Der/geahtes+A+Attr	ebmoslieđat>»geahtes	ˈeb.mos#lˌie.ðɑt>»#kˌĕæh.tes
ebmui+A+Sg+Acc	ebmo>	ˈeb.mo>
ecstasy+N+Ess	ecstasy>n	ˈets.stɑ.sy>n
ecstasy+N+Pl+Nom	ecstasy>t	ˈets.stɑ.sy>h
ecstasy+N+Sg+Gen+PxSg2	ecstasy>t	ˈets.stɑ.sy>h
ecstasy+N+Der/huhtti+V+TV+VAbess	ecstasy>»huhti>haga	ˈets.stɑ.sy>»huh.ti>hɑ.gɑ
ednen+N+Der/laš+A+Sg+Nom	ednen»laš>	ˈed.nen»#lˌɑʃ>
efesoslaš+Sem/Hum+N+Der/Dimin+N+Pl+Nom	efesoslačča»žat	ˈe.fe.sˌos.lɑt.tʃɑ»žɑh
efesoslaš+Sem/Hum+N+Sg+Ill	efesoslažži>i	ˈe.fe.sˌos.lɑdː.tʃi>i
egaliseret+V+TV+Ind+Prs+Du2	egalisere>beahtti>	ˈe.gɑː.lˌi.se.re>bĕæhː.ti>
egaliseret+V+TV+VAbess	egalisere>keahttá	ˈe.gɑː.lˌi.se.re>kĕæhː.tɑː
egyptalaš+Sem/Hum+N+Sg+Nom	egyptalaš>	ˈeː.gyp.tˌɑ.lɑʃ>
egá+Sem/Hum+N+Der/viđá+Adv	ega»viđá	ˈe.gɑː»vi.ðɑː
ehket+V+IV+Ind+Prt+Du1	ehki>ime	ˈeh.ki>i.me
eiddo+Pcle	eiddo	ˈejt.to
eigga+Pcle	eigga	ˈejkː.kɑː
eiseváldi+Sem/Org+N+Ess+PxSg2	eiseváldi>n>at	ˈejː.se#vˌɑːlː.ti>n>ɑh
eivve+Adv	eivve	ˈejv.ve
ekliptihkka+N+Der/huhtti+V+TV+VAbess	ekliptihka»huhti>haga	ˈek.lip.tih.kɑ»huh.ti>hɑ.gɑ
ektui+Po	ektui	ˈekː.htuj
elihtajoavku+Sem/Hum+Sem/Group+Sem/Group+N+Der/viđá+Adv	elihtajoavko»viđá	ˈeː.lih.tˌɑ#jˌŏɑβː.ɸko»vi.ðɑː
eltávval+N+Der/viđá+Adv	eltávval»viđá	ˈel#thˌɑːv.vɑl»#vˌi.ðɑː
embarkeret+V+TV+Der/stuvva+V+Imprt+Du1	embarkere»stuvvu>	ˈemː.pɑːr.hke.re»stuv.vu>
emuleret+V+TV+Der/PassL+V+IV+VGen	emulere»j»uvvo>	ˈe.mu.lˌe.re»j»uv.vo>
enheta+N+Sg+Ill	enheti>i	ˈen.he.ti>i
eno+Sem/Hum+N+Der/Dimin+N+Sg+Nom	eno»š	ˈe.no»ʃ
ensyklopediija+N+Sg+Ill	ensyklopediiji>i	ˈenː.syk.lo.pe.dij.ji>i
epidemiologalaš+A+Ess	epidemiologalažža>n	e^pi^de^mio^lo^ga^laž^ža>n+?
epihkka+N+Der/heapmi+A+Superl+Pl+Gen	epihka»hamos>iid	ˈeː.pih.kˌɑ»hɑ.mos>ijh
erren+Sem/Act+N+Sg+Loc+PxPl3	errem>istti>set	ˈer.rem>is.ti>seh
espánnjalaš+A+Sg+Com	espánnjalačča>in	ˈe.spɑːn.ɲˌɑ.lɑt.tʃɑ>in
espánnjalaš+A+Sg+Ill	espánnjalažži>i	ˈe.spɑːn.ɲˌɑ.lɑdː.tʃi>i
eseváldi+Sem/Org+N+Der/Dimin+N+Ess	eseválddá»žin	ˈe.se#vˌɑːlt.tɑː»žin
eufemisma+N+Sg+Ill	eufemismi>i	ˈeu.fe.mˌisː.mi>i
evre+N+Der/viđá+Adv	evre»viđá	ˈeβː.re»vi.ðɑː
evro+N+Der/laš+A+Der/vuohta+N+Sg+Com+PxPl2	evrro»laš»»»vuođa>in>eattet	ˈeβr.ro»lɑʃ»»»#vˌuo.ðɑ>in>ĕæt.teh
evttoheaddji+Sem/Hum+N+NomAg+Sg+Com	evttoheddji>in	ˈeβɸ.to.heɟː.ci>in
evttohit+V+TV+Der/meahttun+A+Sg+Acc	evttot>»meahttum>a	ˈeβɸ.tot>»#mˌĕæhː.tum>ɑ
expliciteret+V+TV+Ind+Prt+Pl2	expliciteri>idet	ˈeks.pli.tsi.te.ri>i.deh
exproprieret+V+TV+Cond+Prs+Pl1	expropriere>šeimme>t	ˈeks.prop.ri.e.re>ʃejm.me>h
extrapoleret+V+TV+Ind+Prt+Pl1	extrapoleri>imet	ˈekst.rɑː#phˌo.le.ri>i.meh
eŋgelas+A+Attr	eŋgalas>	ˈeŋŋ.kɑː.lɑs>
eŋgelsoadji+Sem/Ani+N+Sg+Gen+PxSg2	eŋgelsoajá>t	ˈeŋŋ.kel#sˌoɑ.jɑː>h
eretorru+A+Attr	iretorru>	ˈiː.ret#ˌor.ru>
eretorru+A+Attr+Der/vuohta+N+Sg+Ill	iretorru>»»»vuhti>i	ˈiː.ret#ˌor.ru>»»»#vˌuh.ti>i
eretorru+A+Attr+Der/vuohta+N+Der/viđá+Adv	iretorru>»»»vuohta»viđá	ˈiː.ret#ˌor.ru>»»»#vˌuoh.tɑ»vi.ðɑː
eretorru+A+Attr+Der/vuohta+N+Sg+Loc	iretorru>»»»vuođa>s	ˈiː.ret#ˌor.ru>»»»#vˌuo.ðɑ>s
eretorru+A+AttrCmp+Der/lágan+v1+A+Der/vuohta+N+Pl+Acc	iretorru>»»»»lágan»»»vuođa>id	ˈiː.ret#ˌor.ru>»»»»#lˌɑː.gɑn»»»#vˌuo.ðɑ>id
eretorru+A+AttrCmp+Der/agat+A+Ess	iretorru>»»»»agag>in	ˈiː.ret#ˌor.ru>»»»»#ˌɑ.gɑg>in
eretorru+A+AttrCmp+Der/agat+A+Sg+Nom	iretorru>»»»»agat>	ˈiː.ret#ˌor.ru>»»»»#ˌɑ.gɑt>
eretorru+A+AttrCmp+Der/fárddat+A+Ess	iretorru>»»»»fárddag>in	ˈiː.ret#ˌor.ru>»»»»#fˌɑːrt.tɑg>in
eretorru+A+AttrCmp+Der/uvssot+A+Sg+Com	iretorru>»»»»uvssog>iin	ˈiː.ret#ˌor.ru>»»»»#ˌuβs.sog>ijn
eretorru+A+AttrCmp+Der/válddat+A+Sg+Nom	iretorru>»»»»válddat>	ˈiː.ret#ˌor.ru>»»»»#vˌɑːlt.tɑt>
eretorru+A+Ess	iretorru>n	ˈiː.ret#ˌor.ru>n
eretorru+A+Pl+Acc	iretorru>id	ˈiː.ret#ˌor.ru>id
eretorru+A+Pl+Gen	iretorru>id	ˈiː.ret#ˌor.ru>id
eretorru+A+Pl+Ill	iretorru>ide	ˈiː.ret#ˌor.ru>i.de
eretorru+A+Pl+Nom	iretorru>t	ˈiː.ret#ˌor.ru>h
eretorru+A+Sg+Acc	iretorru>	ˈiː.ret#ˌor.ru>
eretorru+A+Sg+Gen	iretorru>	ˈiː.ret#ˌor.ru>
eretorru+A+Sg+Nom	iretorru>	ˈiː.ret#ˌor.ru>
eretorru+A+Sg+Com	iretorru>in	ˈiː.ret#ˌor.ru>in
eretorru+A+Sg+Ill	iretorru>i	ˈiː.ret#ˌor.ru>i
eretorru+A+Sg+Loc	iretorru>s	ˈiː.ret#ˌor.ru>s
eretorru+A+Der/vuohta+N+Sg+Ill	iretorru>»»»vuhti>i	ˈiː.ret#ˌor.ru>»»»#vˌuh.ti>i
eretorru+A+Der/vuohta+N+Sg+Nom+PxPl3	iretorru>»»»vuohta>set	ˈiː.ret#ˌor.ru>»»»#vˌuoh.tɑ>seh
eretorru+A+Der/vuohta+N+Ess	iretorru>»»»vuohta>n	ˈiː.ret#ˌor.ru>»»»#vˌuoh.tɑ>n
eretorru+A+Der/vuohta+N+Sg+Com+PxPl3	iretorru>»»»vuođa>in>easet	ˈiː.ret#ˌor.ru>»»»#vˌuo.ðɑ>in>ĕæ.seh
fanas+Sem/Veh+N+Pl+Nom	fatnas>at	fˈɑtː.nɑːs>ɑh
fauna+N+Sg+Ill	fauna>i	fˈɑu.nɑ>i
fitnat+V+IV+Der/NomAg+N+Sg+Loc+PxPl2	fidni>»st>eattet	fˈid.ni>»st>ĕæt.teh
flahtta+N+Sg+Ill	flahtti>i	flˈɑhː.ti>i
flirtet+V+TV+Ind+Prt+Pl1	flirti>imet	flˈirə.hti>i.meh
fobiija+N+Sg+Ill	fobiiji>i	fˈoː.bij.jˌi>i
fogderiija+Sem/Org+N+Sg+Ill	fogderiiji>i	fˈog.de.rij.ji>i
folieret+V+TV+Der/halla+V+Ind+Prs+Sg3	foliere»hallá>	fˈo.li.ˌe.re»hɑlː.lɑː>
fonta+N+Sg+Ill	fonti>i	fˈonː.n̥ti>i
forbma+N+Der/laš+A+Superl+Der/at+Adv	forpma»lepmos>it	fˈorpː.mɑː»lep.mos>ih
forseret+V+TV+Der/d+V+Ger+PxPl2	forsere»dettiin>eattet	fˈorə.se.re»det.tijn>ĕæt.teh
friijet+V+TV+Der/PassL+V+IV+Inf	friije»j»uvvo>t	frˈij.je»j»uv.vo>h
fronderet+V+TV+Der/PassL+V+IV+Der/upmi+N+Sg+Loc+PxDu2	frondere»j»umi>st>eatte	frˈonː.te.re»j»u.mi>st>ĕæt.te
frukta+N+Der/heapmi+A+Comp+Ess	fruvtta»heabbo>n	frˈuβɸː.tɑː»hĕæbː.po>n
frustreret+V+TV+Ind+Prt+Du3	frustreri>iga	frˈust.re.ri>i.gɑ
frákta+N+Sg+Com	frávtta>in	frˈɑːβɸ.tɑ>in
fráŋket+V+TV+Der/PassL+V+IV+Actio+Loc	fráŋke»juvvo>mis	frˈɑːŋŋ.ŋ̊ke»juv.vo>mis
fulkkeš+Adv	fulkkeš	fˈull̥.keʃ
fuopmášit+V+TV+VGen	fuopmáš>	fˈŭŏpː.mɑːʃ>
fuorrá+Sem/Hum+N+Der/huhtti+V+TV+Ind+Prt+Sg2	fuorá»huhtte>t	fˈuo.rɑː»huhː.te>h
fusjoneret+V+TV+Der/d+V+Ind+Prs+ConNeg	fusjonere»t	fˈus.jo.ne.re»h
fušoneret+V+TV+Ind+Prt+Pl2	fušoneri>idet	fˈu.ʃo.nˌe.ri>i.deh
fylka+Sem/Org+Sem/Plc+N+Sg+Ill	fylki>i	fˈylə.hki>i
fysihkar+Sem/Hum+N+Sg+Nom	fysihkar>	fˈy.sih.kˌɑr>
fábel+N+Der/viđá+Adv	fábel»viđá	fˈɑː.bel»#vˌi.ðɑː
fáddá+N+Der/Dimin+N+Pl+Nom	fáttá»žat	fˈɑːt.tɑː»žɑh
fága+N+Sg+Ill	fági>i	fˈɑː.gi>i
fállu+N+Der/heapmi+A+Attr	fálu»his>	fˈɑː.lu»his>
føydalisma+N+Der/huvva+V+IV+Pot+Prs+Sg3	føydalismma»huva>š	fˈøy.dɑ.lˌis.mɑ»hu.vɑ>ʃ
føydálariekti+N+Sg+Com+PxSg1	føydálarivtti>in>an	fˈøy.dɑː.lˌɑ#rˌiβɸ.ti>in>ɑn
falástallanruhta+Sem/Money+N+Pl+Nom	valástallanruđa>t	vˈɑ.lɑːs.tˌɑl.lɑn#rˌu.ðɑ>h
falástallanruhta+Sem/Money+N+Sg+Acc+PxDu2	valástallanruđa>de	vˈɑ.lɑːs.tˌɑl.lɑn#rˌu.ðɑ>de
falástallanruhta+Sem/Money+N+Sg+Com	valástallanruđa>in	vˈɑ.lɑːs.tˌɑl.lɑn#rˌu.ðɑ>in
falástallanruhta+Sem/Money+N+Sg+Loc	valástallanruđa>s	vˈɑ.lɑːs.tˌɑl.lɑn#rˌu.ðɑ>s
falástallanruhta+Sem/Money+N+Sg+Loc+PxSg2	valástallanruđa>st>at	vˈɑ.lɑːs.tˌɑl.lɑn#rˌu.ðɑ>st>ɑh
falástallanruhta+Sem/Money+N+Sg+Loc+PxSg3	valástallanruđa>st>is	vˈɑ.lɑːs.tˌɑl.lɑn#rˌu.ðɑ>st>is
falástallanruhta+Sem/Money+N+Der/Dimin+N+Sg+Nom	valástallanruđa»š	vˈɑ.lɑːs.tˌɑl.lɑn#rˌu.ðɑ»ʃ
falástallanruhta+Sem/Money+N+Der/Dimin+N+Der/viđá+Adv	valástallanruđa»š»viđá	vˈɑ.lɑːs.tˌɑl.lɑn#rˌu.ðɑ»ʃ»#vˌi.ðɑː
falástallanruhta+Sem/Money+N+Der/heapmi+A+Pl+Ill	valástallanruđa»hemi>ide	vˈɑ.lɑːs.tˌɑl.lɑn#rˌu.ðɑ»he.mi>i.de
falástallanruhta+Sem/Money+N+Der/heapmi+A+Attr	valástallanruđa»his>	vˈɑ.lɑːs.tˌɑl.lɑn#rˌu.ðɑ»his>
falástallanruhta+Sem/Money+N+Der/huvva+V+IV+Imprt+Pl2	valástallanruđa»huvve>t	vˈɑ.lɑːs.tˌɑl.lɑn#rˌu.ðɑ»huv.ve>h
falástallanruhta+Sem/Money+N+Sg+Nom+PxPl1	valástallanruhta>met	vˈɑ.lɑːs.tˌɑl.lɑn#rˌuh.tɑ>meh
falástallanruhta+Sem/Money+N+Der/viđá+Adv	valástallanruhta»viđá	vˈɑ.lɑːs.tˌɑl.lɑn#rˌuh.tɑ»vi.ðɑː
falástallanruhta+Sem/Money+N+Sg+Ill	valástallanruhti>i	vˈɑ.lɑːs.tˌɑl.lɑn#rˌuh.ti>i
faláštallanruhta+Sem/Money+N+Pl+Acc	valáštallanruđa>id	vˈɑ.lɑːʃ.tˌɑl.lɑn#rˌu.ðɑ>id
faláštallanruhta+Sem/Money+N+Sg+Acc+PxSg2	valáštallanruđa>t	vˈɑ.lɑːʃ.tˌɑl.lɑn#rˌu.ðɑ>h
faláštallanruhta+Sem/Money+N+Sg+Com+PxPl3	valáštallanruđa>in>easet	vˈɑ.lɑːʃ.tˌɑl.lɑn#rˌu.ðɑ>in>ĕæ.seh
faláštallanruhta+Sem/Money+N+Der/Dimin+N+Pl+Nom	valáštallanruđa»žat	vˈɑ.lɑːʃ.tˌɑl.lɑn#rˌu.ðɑ»žɑh
faláštallanruhta+Sem/Money+N+Der/Dimin+N+Sg+Acc	valáštallanruđa»ža	vˈɑ.lɑːʃ.tˌɑl.lɑn#rˌu.ðɑ»žɑ
faláštallanruhta+Sem/Money+N+Der/Dimin+N+Sg+Gen	valáštallanruđa»ža	vˈɑ.lɑːʃ.tˌɑl.lɑn#rˌu.ðɑ»žɑ
faláštallanruhta+Sem/Money+N+Der/huvva+V+IV+Imprt+Du1	valáštallanruđa»huvvu>	vˈɑ.lɑːʃ.tˌɑl.lɑn#rˌu.ðɑ»huv.vu>
faláštallanruhta+Sem/Money+N+Der/huvva+V+IV+Ind+Prs+Sg3	valáštallanruđa»huvvá>	vˈɑ.lɑːʃ.tˌɑl.lɑn#rˌu.ðɑ»huvː.vɑː>
faláštallanruhta+Sem/Money+N+Der/laš+A+Superl+Sg+Loc	valáštallanruđa»lepmos>is	vˈɑ.lɑːʃ.tˌɑl.lɑn#rˌu.ðɑ»lep.mos>is
faláštallanruhta+Sem/Money+N+Der/laš+A+Der/vuohta+N+Sg+Gen+PxSg1	valáštallanruđa»laš»»»vuohta>n	vˈɑ.lɑːʃ.tˌɑl.lɑn#rˌu.ðɑ»lɑʃ»»»#vˌuoh.tɑ>n
faláštallanruhta+Sem/Money+N+Der/viđá+Adv	valáštallanruhta»viđá	vˈɑ.lɑːʃ.tˌɑl.lɑn#rˌuh.tɑ»vi.ðɑː
faláštallanruhta+Sem/Money+N+Sg+Ill	valáštallanruhti>i	vˈɑ.lɑːʃ.tˌɑl.lɑn#rˌuh.ti>i
gii+Pron+Interr+Sg+Ill+Foc	gea>sagii	kˈeæ>sɑ.gij
gii+Pron+Interr+Sg+Nom	gii>	kˈij>
gii+Pron+Interr+Pl+Loc	gea>in	kˈeæ>in
gii+Pron+Interr+Pl+Nom	gea>t	kˈeæ>h
gii+Pron+Interr+Sg+Gen	gea>n	kˈeæ>n
gii+Pron+Interr+Sg+Acc	gea>id	kˈeæ>id
gii+Pron+Rel+Sg+Ill+Foc	gea>sagii	kˈeæ>sɑ.gij
gii+Pron+Rel+Sg+Nom	gii>	kˈij>
gii+Pron+Rel+Pl+Loc	gea>in	kˈeæ>in
gii+Pron+Rel+Sg+Gen	gea>n	kˈeæ>n
gii+Pron+Rel+Sg+Ill	gea>sa	kˈeæ>sɑ
goabbat+Pron+Recipr+Du	goabbat	kˈoɑbː.pɑh
goabbat+Pron+Recipr+Pl	guhtet	kˈuːh.teh
guhte+Pron+Interr+Sg+Nom	guhte>s	kˈuh.te>s
guhte+Pron+Interr+Sg+Ill	guhti>i	kˈuh.ti>i
guhte+Pron+Rel+Sg+Nom	guhte>s	kˈuh.te>s
guhte+Pron+Rel+Ess	guhte>n	kˈuh.te>n
guhtemuš+Pron+Interr	guhtemuš>	kˈuh.te.muʃ>
guhtemuš+Pron+Interr+Pl+Com+Attr	guđemučča>id	kˈu.ðe.mˌut.tʃɑ>id
guoibmi+Pron+Recipr+Pl+Acc+PxDu3	guimmiideaskka	kˈujm.mij.deæs.kɑ
guoibmi+Pron+Recipr+Pl+Gen+PxDu1	guimmiideame	kˈujm.mij.dĕæ.me
guoibmi+Pron+Recipr+Pl+Ill+PxDu2	guimmiidasade	kˈujm.mij.dɑ.sɑ.de
guoibmi+Pron+Recipr+Sg+Com+PxPl3	guimmiineaset	kˈujm.mij.nĕæ.seh
guoibmi+Pron+Recipr+Sg+Ill+PxDu2	guoibmáseatte	kˈuoj.pmɑː.sĕæt.te
gamar+N+Der/viđá+Adv	gamar>»viđá	kˈɑ.mɑːr>»#vˌi.ðɑː
garvemeahttun+A+Sg+Nom	garvemeahttun>	kˈɑrə.ve.mĕæhː.tun>
gaskat+V+IV+Der/PassS+V+IV+Pot+Prs+ConNeg	gasko>»>š	kˈɑsː.ko>»>ʃ
gaullisma+N+Sg+Ill	gaullismi>i	kˈɑul.lis.mi>i
genitiiva+N+Pl+Acc+PxSg3	genitiivva>id>is	kˈe.ni.tˌijv.vɑ>id>is
geografiija+N+Sg+Nom+PxSg3	geografiija>>s	kˈe.o.grˌɑ.fij.jɑ>>s
geres+Sem/Veh+N+Ess	geres>in	kˈeː.res>in
gii+Pron+Indef+Ess	geanin	kˈeæ.niːn
gii+Pron+Indef+Pl+Nom	geat	kˈeæh
giige+Pron+Indef+Pl+Gen	gea>idge	kˈeæ>id.ge
giira+N+Der/viđá+Adv	giira»viđá	kˈijː.rɑː»vi.ðɑː
giksa+Sem/Ani+N+Der/heapmi+A+Attr+Der/vuohta+N+Sg+Nom+PxSg3	givssa»his>»»»vuohta>s	kˈiβsː.sɑː»his>»»»#vˌuoh.tɑ>s
gisaidit+V+IV+PrsPrc	gisaj>eaddji	kˈi.sɑːj>ĕæɟː.ci
giđđu+N+Der/huvva+V+IV+Pot+Prs+Sg3	giđo»huva>š	kˈi.ðo»hu.vɑ>ʃ
gižži+N+Sg+Loc+PxPl2	gičči>st>eattet	kˈit.tʃi>st>ĕæt.teh
glasiologa+Sem/Hum+N+Sg+Ill	glasiologi>i	glˈɑ.sio.lˌo.gi>i
glorifiseret+V+TV+Ind+Prt+Pl2	glorifiseri>idet	glˈo.ri.fˌi.se.ri>i.deh
glottála+A+Sg+Ill	glottáli>i	glˈotː.tɑː.li>i
glássa+Sem/Ctain+N+Sg+Loc+PxPl3	glása>st>easet	glˈɑː.sɑ>st>ĕæ.seh
glássakuvla+N+Sg+Acc+PxSg1	glássakuvla>n	glˈɑːs.sɑ#khˌuβː.lɑ>n
gneaisa+N+Ess+PxDu1	gneaisa>n>eame	gnˈĕæjː.sɑ>n>ĕæ.me
gneaisa+N+Sg+Ill+PxPl1	gneaisa>s>eamet	gnˈĕæjː.sɑ>s>ĕæ.meh
gnostisisma+N+Der/viđá+Adv	gnostisisma»viđá	gnˈosː.ti.sisː.mɑ»vi.ðɑː
gnostisisma+N+Der/Dimin+N+Der/viđá+Adv	gnostisismma»š»viđá	gnˈosː.ti.sis.mɑ»ʃ»#vˌi.ðɑː
gobbalákču+Sem/Ani+N+Der/viđá+Adv	gobbalákčo»viđá	kˈobː.pɑː#lˌɑːkː.htʃo»vi.ðɑː
goidoš+Sem/Hum+N+Der/Dimin+N+Ess+PxSg1	goidoš»ažža>n>an	kˈojː.toʃ»ɑdː.tʃɑ>n>ɑn
gorket+V+TV+PrfPrc	gorke>n	kˈorə.hke>n
grafema+N+Sg+Ill	grafemi>i	grˈɑ.fe.mˌi>i
graveret+V+TV+Ind+Prt+Pl2	graveri>idet	grˈɑ.ve.rˌi>i.deh
grilla+G3+N+Der/viđá+Adv	grilla»viđá	grˈilː.lɑː»vi.ðɑː
groavis+A+Attr	groava>	grˈoɑ.vɑ>
grupperet+V+TV+Ind+Prt+Sg3	grupperi>i	grˈup.pe.ri>i
gussa+Sem/Ani+N+Der/huvva+V+IV+Pot+Prs+Pl1	gusa»huva>žat	kˈu.sɑː»hu.vɑ>žɑh
guvzat+V+TV+Imprt+Du3	guvzo>ska	kˈuβː.tso>skɑ
gymnastiseret+V+TV+Der/h+V+Der/easti+V+Imprt+Pl2	gymnastisere»heaste>t	kˈym.nɑs.ti.se.re»hĕæs.te>h
gámis+A+AttrCmp+Der/uvssat+A+Pl+Nom	gámis>»»»»uvssag>at	kˈɑː.mis>»»»»#ˌuβs.sɑg>ɑh
gápmagahtes+A+Attr+Der/vuohta+N+Der/viđá+Adv	gápmagahtes>»»»vuohta»viđá	kˈɑːp.mɑ.gɑh.tes>»»»#vˌuoh.tɑ»vi.ðɑː
gássi+G3+N+Der/huhtti+V+TV+Ind+Prs+ConNeg	gásse»huhte>	kˈɑːs.se»huh.te>
gázzi+Sem/Hum+Sem/Group+N+Der/heapmi+A+Sg+Ill	gácce»heapmá>i	kˈɑːt.tse»heæp.mɑː>i
gælalaš+A+Pl+Acc	gælalačča>id	kˈæ.lɑ.lˌɑt.tʃɑ>id
gælalaš+A+Sg+Ill	gælalažži>i	kˈæ.lɑ.lˌɑdː.tʃi>i
habas+A+Sg+Gen	hahpas>a	hˈɑhː.pɑːs>ɑ
hagarlaš+Sem/Hum+N+Pl+Acc	hagarlačča>id	hˈɑ.gɑːr.lˌɑt.tʃɑ>id
hanti+Sem/Ani+N+Der/Dimin+N+Der/viđá+Adv	hantá»š»viđá	hˈɑnː.n̥tɑː»ʃ»#vˌi.ðɑː
hapmat+V+TV+Der/PassL+V+IV+Der/supmi+N+Sg+Ill	habmo>»supmái	hˈɑb.mo>»supː.mɑːj
heađuštit+V+TV+Der/alla+V+Pot+Prs+ConNeg	heđošt»ala>š	hˈeː.ðoʃt»ɑ.lɑ>ʃ
hebréalaš+Sem/Hum+N+Sg+Loc+PxSg1	hebréalačča>st>an	hˈeb.reː.ɑ.lɑt.tʃɑ>st>ɑn
hedonisma+N+Sg+Ill	hedonismi>i	hˈe.do.nˌisː.mi>i
heŋggiidit+V+IV+Der/ahtti+V+Imprt+Pl2	heŋggiid»ahtte>t	hˈeŋk.kijd»ɑhː.te>h
hilla+N+Der/laš+A+Der/vuohta+N+Sg+Gen+PxPl3	hila»laš»»»vuođa>set	hˈi.lɑː»lɑʃ»»»#vˌuo.ðɑ>seh
hirpmusvuohta+N+Pl+Ill	hirpmusvuođa>ide	hˈirpː.mus.vuo.ðɑ>i.de
hirrát+V+IV+Der/h+V+Imprt+ConNeg	hirrá»t	hˈirː.rɑː»h
hissa+N+Der/Dimin+N+Sg+Nom	hisa»š	hˈi.sɑː»ʃ
hitnardit+V+TV+Sup	hitnard>eažžat	hˈitː.nɑːrd>eædː.tʃɑh
hivli+A+Sg+Acc	hivlli>	hˈiβl.li>
hm+Interj	hm	hm
hmm+Interj	hmm	hmː
hobas+A+Sg+Acc	hohpas>a	hˈohː.pɑːs>ɑ
hopmir+N+Der/heapmi+A+Pl+Acc	homer»hemi>id	hˈoː.mer»#hˌe.mi>id
hoteallaprošeakta+N+Sg+Ill	hoteallaprošekti>i	hˈo.teæl.lˌɑ#prˌo.ʃekː.hti>i
hovkkehuvvat+V+IV+Ind+Prs+Sg2	hovkkehuva>t	hˈoβɸ.ke.hu.vɑ>h
huksu+N+Sg+Acc+PxSg1	hukso>n	hˈukː.so>n
hupp+Interj	hupp	hˈupː
husmánni+Sem/Hum+N+Ess	husmánni>n	hˈus#mˌɑːn.ni>n
huvdet+V+TV+Der/PassL+V+IV+Actio+Loc	huvde»juvvo>mis	hˈuβː.te»juv.vo>mis
huđagit+V+IV+Ger+PxSg2	huđag>ettiin>at	hˈu.ðɑːg>et.tijn>ɑh
huškut+V+TV+Der/PassL+V+IV+Der/upmi+N+Sg+Nom+PxDu3	huško>j»upmi>ska	hˈuʃː.ko>j»up.mi>skɑ
hyasinta+N+Sg+Ill	hyasinti>i	hˈy.ɑ.sˌinː.n̥ti>i
hydraulalaš+A+Attr	hydraulalaš>	hˈyd.rɑu.lɑ.lɑʃ>
hygiena+N+Der/huvva+V+IV+Imprt+Sg2	hygiena»huva>	hˈy.gi.ˌe.nɑ»hu.vɑ>
hysteralaš+A+Sg+Nom	hysteralaš>	hˈysː.te.rɑ.lɑʃ>
hysteriija+N+Sg+Ill	hysteriiji>i	hˈysː.te.rij.ji>i
hálkaloddi+Sem/Ani+N+Sg+Com	hálkalotti>in	hˈɑːlə.hkɑ#lˌot.ti>in
hámat+N+Ess	hámah>in	hˈɑː.mɑh>in
hápmi+N+Pl+Nom	hámi>t	hˈɑː.mi>h
hávrut+V+IV+Der/st+V+Der/easti+V+Der/PassS+V+IV+Ind+Prt+Sg3	hávrro»stestu>»i	hˈɑːβr.ro»stes.tu>»i
håløygalaš+Sem/Hum+N+Sg+Nom	håløygalaš>	hˈoːl.øy.gɑ.lɑʃ>
håløygalaš+Sem/Hum+N+Sg+Ill+PxPl2	håløygalažža>s>eattet	hˈoːl.øy.gɑ.lɑdː.tʃɑ>s>ĕæt.teh
ieš+Pron+Refl+Acc+PxPl1	ieža>met	ˈie.dʃɑ>meh
ieš+Pron+Refl+Com+PxDu3	ieža>ineaskka	ˈie.dʃɑ>i.neæs.kɑ
ieš+Pron+Refl+Com+PxPl2	ieža>ineattet	ˈie.dʃɑ>i.nĕæt.teh
ieš+Pron+Refl+Com+PxPl3	ieža>ineaset	ˈie.dʃɑ>i.nĕæ.seh
ieš+Pron+Refl+Com+PxSg1	ieža>inan	ˈie.dʃɑ>i.nɑn
ieš+Pron+Refl+Du+Nom	ieža>	ˈie.dʃɑ>
ieš+Pron+Refl+Ess+PxDu3	iehča>neaskka	ˈieh.tʃɑ>neæs.kɑ
ieš+Pron+Refl+Ess+PxPl1	iehča>neamet	ˈieh.tʃɑ>nĕæ.meh
ieš+Pron+Refl+Gen+PxDu3+Attr	ald	ˈɑld
ieš+Pron+Refl+Gen+PxSg3+Attr	ald	ˈɑld
ieš+Pron+Refl+Ill+PxPl1	alcca>met	ˈɑll̥ː.tsɑː>meh
ieš+Pron+Refl+Ill+PxSg2	alla>sat	ˈɑlː.lɑː>sɑh
ieš+Pron+Refl+Loc+PxDu1	alddá>neame	ˈɑltː.tɑː>nĕæ.me
ieš+Pron+Refl+Pl+Nom	ieža>	ˈie.dʃɑ>
ieš+Pron+Refl+Sg+Nom	ieš>	ˈieʃ>
ii+V+IV+Neg+Imprt+Du1	allu>	ˈɑl.lu>
ii+V+IV+Neg+Imprt+Du2	alli>	ˈɑl.li>
ii+V+IV+Neg+Imprt+Du3	allo>ska	ˈɑl.lo>skɑ
ii+V+IV+Neg+Imprt+Pl1	allo>t	ˈɑl.lo>h
ii+V+IV+Neg+Imprt+Pl2	alle>t	ˈɑl.le>h
ii+V+IV+Neg+Imprt+Sg3	allo>s	ˈɑl.lo>s
ii+V+IV+Neg+Ind+Pl1	ea>t	ˈeæ>h
ii+V+IV+Neg+Ind+Pl3	ea>i	ˈeæ>i
ii+V+IV+Neg+Ind+Sg2	i>t	ˈi>h
ii+V+IV+Neg+Sup+Du1	ama>me	ˈɑ.mɑː>me
ii+V+IV+Neg+Sup+Du2	ama>de	ˈɑ.mɑː>de
ii+V+IV+Neg+Sup+Du3	ama>ska	ˈɑ.mɑː>skɑ
ii+V+IV+Neg+Sup+Pl1	ama>met	ˈɑ.mɑː>meh
idja+Sem/Time+N+Pl+Nom	ija>t	ˈi.jɑː>h
identifikašuvdna+N+Sg+Gen+PxPl1	identifikašuvdna>met	ˈiː.denː.n̥tˌi.fi.kˌɑ.ʃuv.tnɑ>meh
iežáhuhttit+V+TV+Imprt+Du1	iežáhuhttu>	ˈie.dʃɑː.hˌuhː.tu>
ignoreret+V+TV+Ind+Prt+Pl2	ignoreri>idet	ˈig.no.re.ri>i.deh
ignoreret+V+TV+Ind+Prt+Sg3	ignoreri>i	ˈig.no.re.ri>i
ihkkonráigi+N+Der/viđá+Adv	ihkkonráige»viđá	ˈihː.kon#rˌɑːjː.ke»vi.ðɑː
ihpil+Sem/Hum+N+Der/geahtes+A+Attr	ihpil»geahtes	ˈihː.pil»#kˌĕæh.tes
iihii+Interj	iihii	ˈij.hij
iivá+N+Der/viđá+Adv	iiva»viđá	ˈijː.vɑː»vi.ðɑː
iivá+N+Pl+Nom	iivvá>t	ˈijvː.vɑː>h
ikona+Sem/Hum+Sem/Org+N+Sg+Ill	ikoni>i	ˈi.ko.nˌi>i
ikonostása+N+Sg+Ill	ikonostási>i	ˈi.ko.nˌosː.tɑː.si>i
ikte+Adv+Sem/Time	ikte	ˈikː.hte
iktit+V+TV+Der/st+V+VGen	ivtte»s	ˈiβɸ.te»s
iktit+V+TV+Der/st+V+Der/alla+V+Imprt+Sg2	ivttá»stala>	ˈiβɸː.tɑː»stɑ.lɑ>
iktit+V+TV+Der/st+V+Der/alla+V+Imprt+Pl2	ivttá»stalle>t	ˈiβɸː.tɑː»stɑl.le>h
illu+N+Der/laš+A+Comp+Sg+Nom	ilo»let>	ˈi.lo»let>
ilmmuhit+V+TV+Der/adda+V+Ind+Prt+ConNeg	ilmmoh»adda>n	ˈilm.moh»ɑdː.tɑ>n
ilá+Adv	ilá	ˈiː.lɑː
imaš+A+Sg+Nom	imaš>	ˈi.mɑːʃ>
imaš+N+Ess	imaš>in	ˈi.mɑːʃ>in
imaš+A+AttrCmp+Der/ivnnat+A+Ess	imaš>»»»»ivnnag>in	ˈi.mɑːʃ>»»»»#ˌiβn.nɑg>in
imašhámat+A+Der/vuohta+N+Sg+Ill	imašhámat>»»»vuhti>i	ˈi.mɑːʃ#hˌɑː.mɑt>»»»#vˌuh.ti>i
imeš+Adv	imeš	ˈiː.meʃ
imiteret+V+TV+Imprt+Pl1	imitere>jedno>t	ˈi.mi.tˌe.re>jed.no>h
imiteret+V+TV+Ind+Prt+Du1	imiteri>ime	ˈi.mi.tˌe.ri>i.me
impedimentoassi+N+Sg+Acc+PxSg2	impedimentoasá>t	ˈimː.m̥pe.di.ment#ˌoɑ.sɑː>h
imaš+A+Pl+Nom	ipmah>at	ˈipː.mɑːh>ɑh
imaš+N+Sg+Ill	ipmah>ii	ˈipː.mɑːh>ij
inkluderet+V+TV+Ind+Prt+Sg3	inkluderi>i	ˈin.klu.de.ri>i
ipmi+Sem/Hum+N+Sg+Gen+Allegro	ime>	ˈi.me>
ipmái+A+Pl+Gen	ibmá>id	ˈib.mɑː>id
ipmái+A+Sg+Loc	ibmá>s	ˈib.mɑː>s
ipmái+A+Superl+Ess	ibmá>mussa>n	ˈib.mɑː>mus.sɑ>n
ipod+N+Pl+Ill+PxDu2	ipoda>idas>eatte	ˈi.po.ðˌɑ>i.dɑs>ĕæt.te
ipod+N+Sg+Ill	ipodi>i	ˈi.po.ðˌi>i
iras+A+Attr+Der/vuohta+N+Der/viđá+Adv	iras>»»»vuohta»viđá	ˈi.rɑːs>»»»#vˌuoh.tɑ»vi.ðɑː
iskárčoahkkin+Sem/Act+N+Sg+Acc+PxPl2	iskárčoahkkim>eattet	ˈisː.kɑːr#tʃˌŏɑhː.kim>ĕæt.teh
itnut+V+IV+Pot+Prs+Du2	ino>žeahppi>	ˈi.no>žĕæhː.pi>
itnat+V+IV+Imprt+Pl2	idni>t	ˈid.ni>h
itnut+V+IV+Der/NomAg+N+Sg+Ill+PxDu3	idno>»s>easkka	ˈid.no>»s>eæs.kɑ
itnut+V+IV+Imprt+Du1	idnu>	ˈid.nu>
itnut+V+IV+Der/l+V+Der/adda+V+Imprt+Pl2	itno»laddi>t	ˈit.no»lɑdː.ti>h
itáliaráisuoidni+Sem/Plant+N+Der/viđá+Adv	itáliaráisuoidne»viđá	ˈi.tɑː.lˌi.ɑ#rˌɑːj#sˌŭoj.tne»vi.ðɑː
ivdni+N+Der/huvva+V+IV+Sup	ivnne»huva>žit	ˈiβn.ne»hu.vɑ>žih
iđa+N+Der/heapmi+A+Sg+Com	iđa»hemi>in	ˈi.ðɑː»he.mi>in
iđedassii+Adv	iđedassii	ˈi.ðe.ðˌɑs.sij
jieš+Pron+Refl+Du+Nom	jieža>	jˈie.dʃɑ>
jieš+Pron+Refl+Ess	jiehča>nassii	jˈieh.tʃɑ>nɑs.sij
jieš+Pron+Refl+Pl+Nom	jieža>	jˈie.dʃɑ>
jieš+Pron+Refl+Sg+Nom	jieš>	jˈieʃ>
jieš+Pron+Refl+Acc+PxSg1	jiehča>n	jˈieh.tʃɑ>n
juobbágoabbá+Pron+Indef+Ess	juobbá>ngoabbá>n	jˈuobː.pɑː>n#kˌoɑbː.pɑː>n
juobbágoabbá+Pron+Indef+Pl+Acc	juoppá>idgoappá>id	jˈŭŏpː.pɑː>id#kˌoɑp.pɑː>id
juobbágoabbá+Pron+Indef+Pl+Gen	juoppá>idgoappá>id	jˈŭŏpː.pɑː>id#kˌoɑp.pɑː>id
juobbágoabbá+Pron+Indef+Pl+Ill	juobbá>idegoabbá>ide	jˈuobː.pɑː>i.de#kˌoɑbː.pɑː>i.de
juobbágoabbá+Pron+Indef+Pl+Loc	juoppá>ingoappá>in	jˈŭŏpː.pɑː>in#kˌoɑp.pɑː>in
juobbágoabbá+Pron+Indef+Pl+Nom	juobbá>tgoabbá>t	jˈuobː.pɑː>t#kˌoɑbː.pɑː>h
juobbágoabbá+Pron+Indef+Sg+Acc	juoppá>goappá>	jˈŭŏpː.pɑː>#kˌoɑp.pɑː>
juobbágoabbá+Pron+Indef+Sg+Com	juoppá>ingoappá>in	jˈŭŏpː.pɑː>in#kˌoɑp.pɑː>in
juobbágoabbá+Pron+Indef+Sg+Gen	juoppá>goappá>	jˈŭŏpː.pɑː>#kˌoɑp.pɑː>
juobbágoabbá+Pron+Indef+Sg+Ill+Attr	juoppá>goappá>	jˈŭŏpː.pɑː>#kˌoɑp.pɑː>
juobbágoabbá+Pron+Indef+Sg+Ill	juobbá>igoabbá>i	jˈuobː.pɑː>i#kˌoɑbː.pɑː>i
juobbágoabbá+Pron+Indef+Sg+Loc	juoppá>sgoappá>s	jˈŭŏpː.pɑː>s#kˌoɑp.pɑː>s
juobbágoabbá+Pron+Indef+Sg+Nom	juobbá>goabbá>	jˈuobː.pɑː>#kˌoɑbː.pɑː>
ja/dahje+CC	ja/dahje	jˈɑ/dɑh.je
jabbut+V+IV+Der/st+V+Ind+Prt+ConNeg	jappu»stan	jˈɑp.pu»stɑn
jaggi+Sem/Hum+N+Der/heapmi+A+Superl+Sg+Nom	jakki»heamos>	jˈɑk.ki»hĕæ.mos>
jahki+Sem/Time+N+Sg+Acc+PxDu2	jagá>de	jˈɑ.gɑː>de
jakŋat+V+IV+Imprt+ConNeg	jaŋa>	jˈɑ.ŋɑː>
jappas+A+Sg+Acc	jabbas>a	jˈɑbː.pɑːs>ɑ
jaril+Adv	jaril	jˈɑ.riːl
jassa+Sem/Plc+N+Der/laš+A+Der/vuohta+N+Sg+Ill	jasa»laš»»»vuhti>i	jˈɑ.sɑː»lɑʃ»»»#vˌuh.ti>i
jaŋádat+Sem/Wthr+N+Sg+Nom	jaŋádat>	jˈɑ.ŋɑː.ðˌɑt>
jeagil+Sem/Plant+N+Der/geahtes+A+Attr	jeagel>»geahtes	jˈĕæ.gel>»#kˌĕæh.tes
jelgii+Adv	jelgii	jˈelə.kij
jepp+Interj	jepp	jˈepː
jeret+N+Ess	jereh>in	jˈeː.reh>in
jes+CS	jes	jˈes
jevdet+V+TV+Der/NomAg+N+Sg+Nom	jevde>»j»eaddji»	jˈeβː.te>»j»ĕæɟː.ci»
jeđđet+V+TV+Ind+Prt+Du3	jeđđi>iga	jˈeð.ði>i.gɑ
jidnii+A+Der/vuohta+N+Sg+Ill	jidne»»»vuhti>i	jˈid.ne»»»#vˌuh.ti>i
jiegŋái+A+Sg+Nom	jiegŋá>i	jˈieg.ŋɑː>i
jieris+A+Ess	jieris>in	jˈie.ris>in
jikkat+N+Ess	jigga>n	jˈigː.kɑː>n
jingoisma+N+Sg+Com+PxPl3	jingoismma>in>easet	jˈiŋŋ.ko.is.mɑ>in>ĕæ.seh
jis+CS	jis	jˈis
jitnosii+Adv	jitnosii	jˈit.no.sij
jocca+N+Der/huhtti+V+TV+Ger	jocca»huhte>din	jˈotː.tsɑː»huh.te>din
jokŋa+Sem/Plant+N+Der/huhtti+V+TV+VGen	joŋa»huhti>	jˈo.ŋɑː»huh.ti>
jovssus+N+Sg+Acc+PxPl2	joksos>eattet	jˈokː.sos>ĕæt.teh
joŋahisjahki+Sem/Time+N+Ess+PxSg2	joŋahisjahki>n>at	jˈo.ŋɑː.hˌis#jˌɑh.ki>n>ɑh
judda+N+Sg+Gen+PxPl2	jutta>det	jˈutː.tɑː>deh
judda+N+Der/laš+A+Sg+Nom	jutta»laš>	jˈutː.tɑː»lɑʃ>
jugus+N+Der/viđá+Adv	jugus»viđá	jˈuː.gus»#vˌi.ðɑː
juhkat+V+TV+VGen	juga>	jˈu.gɑː>
juice+N+Sg+Com+PxSg1	juici>in>an	jˈujː.çtsi>in>ɑn
julla+N+Pl+Gen	jula>id	jˈu.lɑː>id
jupmat+V+IV+Der/NomAg+N+Der/viđá+Adv	jubma>»»viđá	jˈub.mɑː>»»vi.ðɑː
jussut+V+IV+Der/h+V+TV+VAbess+A+Attr	jusu»tkeahtes	jˈu.su»t#khˌĕæh.tes
juvssus+N+Der/Dimin+N+Pl+Com+PxPl3	juksos>»ačča>id>easetguin	jˈukː.sos>»ɑt.tʃɑ>id>ĕæ.set.gujn
juŋgá+N+Ess+PxDu2	juŋgá>n>eatte	jˈuŋŋ.kɑː>n>ĕæt.te
jábmejassii+Adv	jábmejassii	jˈɑːb.me.jɑs.sij
jáddat+V+IV+Der/PassS+V+IV+Ind+Prt+Sg3	jáddu>»i	jˈɑːdː.tu>»i
jáddat+V+IV+Pot+Prs+ConNeg	játta>š	jˈɑːt.tɑ>ʃ
jáktabeana+Sem/Ani+N+Sg+Nom+PxSg2	jáktabeatnag>at	jˈɑːkː.htɑ#pˌeæt.nɑg>ɑh
jámas+A+AttrCmp+Der/čalmmat+A+Pl+Acc	jápma>»»»»čalmmag>iid	jˈɑːp.mɑ>»»»»#tʃˌɑlm.mɑg>ijh
jánas+A+AttrCmp+Der/asat+A+Der/vuohta+N+Sg+Ill	játna>»»»»asat>»»»vuhti>i	jˈɑːt.nɑ>»»»»#ˌɑ.sɑt>»»»#vˌuh.ti>i
jápmit+V+IV+Der/st+V+Ind+Prs+ConNeg	jámi»s	jˈɑː.mi»s
járfu+N+Der/huvva+V+IV+Ger	járffu»huva>din	jˈɑːrf.fu»hu.vɑ>din
játnat+V+IV+Der/d+V+Sup	jána»deažžat	jˈɑː.nɑ»deædː.tʃɑh
jávsti+N+Sg+Gen+Allegro	jávstte>	jˈɑːβs.te>
jázzhámat+A+Ess	jázzhámag>in	jˈɑːzz#hˌɑː.mɑg>in
kantuvra+Sem/Plc+N+Sg+Nom+PxDu3	gántuvra>ska	kˈɑːnː.n̥tuv.rɑ>skɑ
kantuvra+Sem/Plc+N+Sg+Nom+PxPl3	gántuvra>set	kˈɑːnː.n̥tuv.rɑ>seh
kantuvra+Sem/Plc+N+Sg+Nom+PxSg3	gántuvra>s	kˈɑːnː.n̥tuv.rɑ>s
kantuvra+Sem/Plc+N+Sg+Nom	gántuvra>	kˈɑːnː.n̥tuv.rɑ>
kantuvra+Sem/Plc+N+Sg+Ill	gántuvri>i	kˈɑːnː.n̥tuv.ri>i
kantuvra+Sem/Plc+N+Sg+Nom+PxSg3	kantuvra>s	khˈɑnː.n̥tuv.rɑ>s
kantuvra+Sem/Plc+N+Sg+Nom+PxDu3	kontuvra>ska	khˈonː.n̥tuv.rɑ>skɑ
kantuvra+Sem/Plc+N+Sg+Nom+PxSg3	kontuvra>s	khˈonː.n̥tuv.rɑ>s
kantuvra+Sem/Plc+N+Sg+Nom	kontuvra>	khˈonː.n̥tuv.rɑ>
kantuvra+Sem/Plc+N+Ess+PxPl3	kantuvra>n>easet	khˈɑnː.n̥tuv.rɑ>n>ĕæ.seh
kantuvra+Sem/Plc+N+Sg+Gen+PxSg1	kantuvra>n	khˈɑnː.n̥tuv.rɑ>n
kantuvra+Sem/Plc+N+Sg+Ill	kantuvri>i	khˈɑnː.n̥tuv.ri>i
kantuvra+Sem/Plc+N+Der/laš+A+Der/vuohta+N+Pl+Nom	kantuvrra»laš»»»vuođa>t	khˈɑnː.n̥tuvr.rɑ»lɑʃ»»»#vˌuo.ðɑ>h
kantuvra+Sem/Plc+N+Ess	kontuvra>n	khˈonː.n̥tuv.rɑ>n
kantuvra+Sem/Plc+N+Sg+Ill	kontuvri>i	khˈonː.n̥tuv.ri>i
kantuvra+Sem/Plc+N+Der/heapmi+A+Superl+Attr	kontuvrra»hamos>	khˈonː.n̥tuvr.rɑ»hɑ.mos>
kantuvra+Sem/Plc+N+Der/huvva+V+IV+Imprt+Sg2	kontuvrra»huva>	khˈonː.n̥tuvr.rɑ»hu.vɑ>
kantuvra+Sem/Plc+N+Der/heapmi+A+Pl+Ill	gántor»hemi>ide	kˈɑːnː.n̥tor»#hˌe.mi>i.de
kantuvra+Sem/Plc+N+Der/heapmi+A+Attr	gántor»his>	kˈɑːnː.n̥tor»#hˌis>
kantuvra+Sem/Plc+N+Der/heapmi+A+Attr+Der/vuohta+N+Sg+Ill	gántor»his>»»»vuhti>i	kˈɑːnː.n̥tor»#hˌis>»»»#vˌuh.ti>i
kantuvra+Sem/Plc+N+Der/viđá+Adv	gántor»viđá	kˈɑːnː.n̥tor»#vˌi.ðɑː
kantuvra+Sem/Plc+N+Ess	gánttor>in	kˈɑːnn̥.tor>in
kantuvra+Sem/Plc+N+Sg+Gen+PxPl1	gánttor>eamet	kˈɑːnn̥.tor>ĕæ.meh
kantuvra+Sem/Plc+N+Pl+Ill+PxPl3	gánttor>iiddás>easet	kˈɑːnn̥.tor>ijt.tɑːs>ĕæ.seh
kantuvra+Sem/Plc+N+Der/Dimin+N+Sg+Nom	gánttor»aš>	kˈɑːnn̥.tor»ɑʃ>
kantuvra+Sem/Plc+N+Der/viđá+Adv	gánttor»viđá	kˈɑːnn̥.tor»#vˌi.ðɑː
kantuvra+Sem/Plc+N+Sg+Acc+PxDu3	kontor>easkka	khˈonː.n̥tor>eæs.kɑ
kantuvra+Sem/Plc+N+Sg+Gen	kontor>a	khˈonː.n̥tor>ɑ
kantuvra+Sem/Plc+N+Der/geahtes+A+Attr	kontor>»keahtes	khˈonː.n̥tor>»#khˌĕæh.tes
kantuvra+Sem/Plc+N+Der/laš+A+Superl+Sg+Acc	kontor»l>epmos>a	khˈonː.n̥tor»#l>ep.mos>ɑ
kantuvra+Sem/Plc+N+Der/viđá+Adv	kontor»viđá	khˈonː.n̥tor»#vˌi.ðɑː
kantuvra+Sem/Plc+N+Sg+Acc	konttor>a	khˈonn̥.tor>ɑ
kantuvra+Sem/Plc+N+Pl+Gen	konttor>iid	khˈonn̥.tor>ijh
kantuvra+Sem/Plc+N+Der/Dimin+N+Pl+Nom	konttor»ačča>t	khˈonn̥.tor»ɑt.tʃɑ>h
kanovdna+N+Sg+Nom+PxSg3	kanovdna>s	khˈɑ.nov.tnˌɑ>s
kanovdna+N+Sg+Acc+PxDu1	kanovdna>me	khˈɑ.nov.tnˌɑ>me
kabarea+N+Der/huhtti+V+TV+Ind+Prs+Sg2	kabarea>»huhtá>t	khˈɑ.bɑː.rˌeæ>»huhː.tɑː>h
kaffeiidna+N+Sg+Gen+PxPl2	kaffeiinna>det	khˈɑf.fe.ijn.nɑ>deh
kaoliidna+N+Sg+Nom	kaoliidna>	khˈɑ.o.lˌij.tnɑ>
kempe+Sem/Hum+N+Der/laš+A+Comp+Sg+Nom	kemppe»lat>	khˈemm̥.pe»lɑt>
kioska+Sem/Org+N+Der/huvva+V+IV+Ger	kioskka»huva>diin	khˈios.kɑ»hu.vɑ>dijn
kivi+N+Sg+Acc+PxPl2	kivi>ttet	khˈi.vi>tːeh
kjemikála+N+Sg+Ill+PxSg2	kjemikála>s>at	kjˈe.mi.kˌɑː.lɑ>s>ɑh
kjemikála+N+Sg+Ill	kjemikáli>i	kjˈe.mi.kˌɑː.li>i
klareret+V+TV+Ind+Prt+Du2	klareri>ide	klˈɑ.re.rˌi>i.de
klausuleret+V+TV+Ind+Prt+Du3	klausuleri>iga	klˈɑu.su.lˌe.ri>i.gɑ
klementiidna+N+Sg+Ill	klementiidni>i	klˈeː.menː.n̥tˌij.tni>i
klinalaš+A+Attr	klinalaš>	klˈi.nɑː.lˌɑʃ>
kluovva+N+Der/huvva+V+IV+Imprt+Sg2	kluova»huva>	klˈuo.vɑ»hu.vɑ>
klusiila+N+Sg+Loc+PxSg2	klusiilla>st>at	klˈuː.sijl.lˌɑ>st>ɑh
knaderiija+N+Der/laš+A+Der/vuohta+N+Sg+Ill	knaderiija»laš»»»vuhti>i	knˈɑ.de.rˌij.jɑ»lɑʃ»»»#vˌuh.ti>i
kneakta+Sem/Hum+N+Sg+Ill	knekti>i	knˈekː.hti>i
knihppet+V+TV+Ind+Prt+Pl1	knihppi>imet	knˈihː.pi>i.meh
kognišuvdna+N+Sg+Nom+PxPl3	kognišuvdna>set	khˈo.gni.ʃˌuβː.tnɑ>seh
konspireret+V+IV+VAbess	konspirere>haga	khˈon.spi.re.re>hɑ.gɑ
kotangeanta+N+Sg+Com+PxDu1	kotangeantta>in>eame	khˈo.tɑːn.gˌeænn̥.tɑ>in>ĕæ.me
kreperet+V+IV+Ind+Prt+Du2	kreperi>ide	krˈe.pe.rˌi>i.de
krubbá+N+Sg+Ill	krubbá>i	krˈubː.pɑː>i
kráhter+N+Sg+Loc	kráhter>is	krˈɑːh.ter>is
krönikeret+V+IV+Ind+Prt+ConNeg	krönikere>n	krˈø.ni.kˌe.re>n
kumma+N+Sg+Ill	kummi>i	khˈum.mi>i
kuntepillar+N+Der/viđá+Adv	kuntepillar»viđá	khˈunː.n̥te.pil.lɑr»#vˌi.ðɑː
kuolla+N+Der/Dimin+N+Der/viđá+Adv	kuola»š»viđá	khˈuo.lɑ»ʃ»#vˌi.ðɑː
kvartsihtta+N+Der/huvva+V+IV+Ind+Prt+Du2	kvartsihta»huva>ide	kvˈɑrt.sih.tɑ»hu.vɑ>i.de
kvestuvra+N+Sg+Ill	kvestuvri>i	kvˈesː.tuv.ri>i
kvárta+Sem/Time+N+Sg+Ill	kvárti>i	kvˈɑːrə.hti>i
kvárta+Sem/Time+N+Der/heapmi+A+Sg+Com	kvártta»hemi>in	kvˈɑːrr̥.tɑ»he.mi>in
kámmir+Sem/Plc+N+Der/heapmi+A+Attr	kámer»his>	khˈɑː.mer»#hˌis>
kåseret+V+IV+Ind+Prt+Du2	kåseri>ide	khˈoː.se.rˌi>i.de
kåseret+V+IV+Ind+Prt+Du3	kåseri>iga	khˈoː.se.rˌi>i.gɑ
kåseret+V+IV+Ind+Prt+Sg3	kåseri>i	khˈoː.se.rˌi>i
kåseriija+N+Der/huvva+V+IV+Ind+Prs+Sg2	kåseriija»huva>t	khˈoː.se.rˌij.jɑ»hu.vɑ>h
logi+Num+Ess	logi>n	lˈo.gi>n
logi+Num+Ess	lohki>n	lˈoh.ki>n
logi+Num+Pl+Acc	logi>id	lˈo.gi>id
logi+Num+Pl+Com	logi>iguin	lˈo.gi>i.gujn
logi+Num+Pl+Ill+Attr	logi>id	lˈo.gi>id
logi+Num+Pl+Loc	logi>in	lˈo.gi>in
logi+Num+Sg+Acc	logi>	lˈo.gi>
logi+Num+Sg+Com	logi>in	lˈo.gi>in
logi+Num+Sg+Gennammasaš+A+Der/vuohta+N+Der/viđá+Adv	logi»nammasaš»»»vuohta»viđá	lˈo.gi»#nˌɑm.mɑ.sɑʃ»»»#vˌuoh.tɑ»vi.ðɑː
logi+Num+Sg+Genčorgi+Sem/Time+N+Sg+Acc+PxSg2	logi»čorggá>t	lˈo.gi»#tʃˌorkː.kɑː>h
logi+Num+Sg+Nom	logi>	lˈo.gi>
lágan+v1+A+Der/vuohta+N+Sg+Ill	lágan»»»vuhti>i	lˈɑː.gɑn»»»#vˌuh.ti>i
lágan+v2+A+Pl+Nom	lágán>at	lˈɑː.gɑːn>ɑh
lágan+v2+A+Pl+Com	lágán>iiguin	lˈɑː.gɑːn>ij.gujn
lágan+v2+A+Sg+Ill	lágán>ii	lˈɑː.gɑːn>ij
lágan+v2+A+Der/vuohta+N+Sg+Ill	lágán»»»vuhti>i	lˈɑː.gɑːn»»»#vˌuh.ti>i
lágan+v2+A+Der/vuohta+N+Der/viđá+Adv	lágán»»»vuohta»viđá	lˈɑː.gɑːn»»»#vˌuoh.tɑ»vi.ðɑː
lágaš+v1+A+Der/vuohta+N+Sg+Ill	lágaš»»»vuhti>i	lˈɑː.gɑʃ»»»#vˌuh.ti>i
lágaš+v1+A+Pl+Nom	lágaž>at	lˈɑː.gɑž>ɑh
lágaš+v2+A+Attr	lágáš>	lˈɑː.gɑːʃ>
lágaš+v2+A+Der/vuohta+N+Sg+Ill	lágáš»»»vuhti>i	lˈɑː.gɑːʃ»»»#vˌuh.ti>i
lágaš+v2+A+Ess	lágáž>in	lˈɑː.gɑːž>in
lágaš+v2+A+Pl+Nom	lágáž>at	lˈɑː.gɑːž>ɑh
lágaš+A+Sg+Ill	lágáž>ii	lˈɑː.gɑːž>ij
lahpat+V+TV+Der/st+V+VAbess	laba»shaga	lˈɑ.bɑː»s#hˌɑ.gɑ
lajuheapme+A+Comp+Attr	lajuh>ut>	lˈɑ.juh>ut>
laksi+N+Der/huvva+V+IV+Imprt+Du1	lavsse»huvvu>	lˈɑβs.se»huv.vu>
laktit+V+TV+Ind+Prs+Sg1	lavttá>n	lˈɑβɸː.tɑː>n
lamas+A+Ess	lamas>in	lˈɑ.mɑːs>in
lanseret+V+TV+VAbess	lansere>haga	lˈɑnː.se.re>hɑ.gɑ
lapmat+V+IV+Der/PassS+V+IV+ConNegII	labmo>»jehko>	lˈɑb.mo>»jeh.ko>
laskat+V+IV+Cond+Prs+Sg3	laskka>šii	lˈɑs.kɑː>ʃij
latnji+Sem/Ani+N+Sg+Gen+Allegro	lanje>	lˈɑnː.je>
lateanta+A+Sg+Nom	lateanta>	lˈɑ.tĕænː.n̥tˌɑ>
leat+V+IV+ConNegII	lehko>	lˈeh.ko>
leat+V+IV+Imprt+Sg1	lehko>n	lˈeh.ko>n
leat+V+IV+Ind+Prt+Sg3	l>ei	l>ej
leat+V+IV+Inf	l>eat	l>eæh
leat+V+IV+Pot+Prs+ConNeg	l>eš	l>eʃ
leat+V+IV+PrfPrc	leama>šan	lˈeæ.mɑ>ʃɑn
leat+V+IV+PrsPrc	leahkki	lˈĕæhː.kiː
leninisma+N+Der/viđá+Adv	leninisma»viđá	lˈe.ni.nˌisː.mɑ»vi.ðɑː
lera+N+Sg+Nom+PxPl3	lera>set	lˈe.rɑː>seh
lette+N+Der/viđá+Adv	lette»viđá	lˈet.te»vi.ðɑː
levget+V+IV+Ind+Prt+Du1	levgi>ime	lˈeβː.ki>i.me
licensieret+V+TV+Sup	licensiere>žit	lˈi.tsen.sˌi.e.re>žih
lippázas+N+Sg+Gen+PxPl2	lippázasa>det	lˈipː.pɑː.dsɑ.sɑ>deh
lobmui+A+Superl+Sg+Nom	lobmo>mus>	lˈob.mo>mus>
logis+N+Coll+Ess	logis>in	lˈoː.gis>in
logoforalaš+A+Pl+Loc	logoforalačča>in	lˈo.go.fˌo.rɑ.lˌɑt.tʃɑ>in
loksa+Sem/Hum+N+Sg+Acc+PxSg1	loksa>n	lˈokː.sɑː>n
loktut+V+TV+Ind+Prs+Sg2	lovttu>t	lˈoβɸ.tu>h
lonjas+A+Sg+Nom	lonjas>	lˈonː.jɑːs>
lođas+N+Ess	lođas>in	lˈo.ðɑːs>in
luhččehaddat+V+IV+Cond+Prs+Du3	luhččehatta>leigga>	lˈuhː.tʃe.hɑt.tɑ>lejk.kɑ>
luksajohtin+Sem/Act+N+Sg+Gen	luksajohtin>	lˈukː.sɑː#jˌohː.tin>
lupmu+N+Sg+Nom+PxSg2	lupmo>t	lˈup.mo>h
lutnjat+V+IV+Imprt+Sg2	lunja>	lˈunː.jɑː>
lydegiella+Sem/Lang+N+Sg+Ill	lydegilli>i	lˈy.de#kˌil.li>i
lydisoleret+V+TV+Der/h+V+Ind+Prs+ConNeg	lydisolere»t	lˈyd#ˌi.so.lˌe.re»h
lykaoniagiella+Sem/Lang+N+Sg+Ill	lykaoniagilli>i	lˈy.kɑ.ˌo.ni.ɑ#kˌil.li>i
lyra+N+Pl+Nom	lyra>t	lˈy.rɑ>h
lyralaš+A+Ess	lyralažža>n	lˈy.rɑ.lˌɑdː.tʃɑ>n
lyrihkka+N+Der/huhtti+V+TV+Ger	lyrihka»huhte>dettiin	lˈy.rih.kˌɑ»huh.te>det.tijn
lyrihkkačoakkáldat+N+Ess	lyrihkkačoakkáldahka>n	lˈy.rihː.kˌɑ#tʃˌoɑk.kɑːl.dɑh.kɑ>n
lyrihkka+N+Sg+Ill	lyrihkki>i	lˈy.rihː.kˌi>i
láiki+A+Sg+Ill	láiká>i	lˈɑːjː.çkɑː>i
lákcut+V+IV+Der/l+V+Der/adda+V+Der/PassS+V+IV+Ind+Prt+Sg3	lákco»laddu>»i	lˈɑːkː.htso»lɑdː.tu>»i
lámas+A+Der/vuohta+N+Pl+Nom	lámas>»»»vuođa>t	lˈɑː.mɑs>»»»#vˌuo.ðɑ>h
lámas+A+Comp+Attr	lápmas>ut>	lˈɑːp.mɑs>ut>
lánjas+Sem/Plc+N+Der/viđá+Adv	lánjas>»viđá	lˈɑːnː.jɑs>»#vˌi.ðɑː
lávttas+N+Pl+Nom	láktas>at	lˈɑːkː.htɑs>ɑh
læstadianisma+N+Sg+Ill	læstadianismi>i	lˈæsː.tɑ.ði.ɑ.nis.mi>i
læstadianisma+N+Sg+Com	læstadianismma>in	lˈæsː.tɑ.ði.ɑ.nis.mɑ>in
læstadianisma+N+Der/huvva+V+IV+Imprt+Pl2	læstadianismma»huvvi>t	lˈæsː.tɑ.ði.ɑ.nis.mɑ»huv.vi>h
læstadiánalašvuohta+N+Sg+Ill+PxSg2	læstadiánalašvuohta>s>at	lˈæsː.tɑ.ði.ɑː.nɑ.lɑʃ.vuoh.tɑ>s>ɑh
mašiidna+N+Sg+Nom+PxDu3	mašiidna>ska	mˈɑ.ʃij.tnˌɑ>skɑ
mašiidna+N+Sg+Nom+PxPl3	mašiidna>set	mˈɑ.ʃij.tnˌɑ>seh
mašiidna+N+Sg+Nom+PxSg3	mašiidna>s	mˈɑ.ʃij.tnˌɑ>s
mašiidna+N+Sg+Nom	mašiidna>	mˈɑ.ʃij.tnˌɑ>
mašiidna+N+Sg+Acc+PxPl1	mašiidna>met	mˈɑ.ʃij.tnˌɑ>meh
mašiidna+N+Sg+Acc+PxSg1	mašiidna>n	mˈɑ.ʃij.tnˌɑ>n
mašiidna+N+Sg+Gen+PxSg1	mašiidna>n	mˈɑ.ʃij.tnˌɑ>n
mašiidna+N+Sg+Ill	mašiidni>i	mˈɑ.ʃij.tnˌi>i
mašiidna+N+Pl+Com+PxDu1	mašiinna>id>eameguin	mˈɑ.ʃijn.nˌɑ>id>ĕæ.me.gujn
mašiidna+N+Sg+Acc+PxPl3	mašiinna>set	mˈɑ.ʃijn.nˌɑ>seh
mašiidna+N+Sg+Com	mašiinna>in	mˈɑ.ʃijn.nˌɑ>in
mašiidna+N+Sg+Loc	mašiinna>s	mˈɑ.ʃijn.nˌɑ>s
mašiidna+N+Der/Dimin+N+Der/Dimin+N+Sg+Nom+PxDu3	mašiinna»žažža>>ska	mˈɑ.ʃijn.nˌɑ»žɑdː.tʃɑ>>skɑ
mašiidna+N+Der/huvva+V+IV+Pot+Prs+Du3	mašiinna»huva>žeaba>	mˈɑ.ʃijn.nˌɑ»hu.vɑ>žeæ.bɑ>
mašiidna+N+Der/huvva+V+IV+Ind+Prt+Sg1	mašiinna»huvve>n	mˈɑ.ʃijn.nˌɑ»huv.ve>n
mii+Pron+Interr+Sg+Acc	máid	mˈɑːjh
mii+Pron+Interr+Sg+Nom	mii>	mˈij>
mii+Pron+Interr+Ess	ma>nin	mˈɑ>nin
mii+Pron+Interr+Pl+Acc	ma>id	mˈɑ>id
mii+Pron+Interr+Pl+Nom	ma>t	mˈɑ>h
mii+Pron+Interr+Sg+Acc	ma>id	mˈɑ>id
mii+Pron+Rel+Sg+Acc	máid	mˈɑːjh
mii+Pron+Rel+Sg+Nom	mii>	mˈij>
mii+Pron+Rel+Sg+Acc	ma>id	mˈɑ>id
madda+N+Der/huvva+V+IV+VAbess+A+Attr	matta»huva>keahtes	mˈɑtː.tɑː»hu.vɑ>kĕæh.tes
mapuche+N+Pl+Loc+PxSg3	mapuchi>in>is	mˈɑ.puts.hˌi>in>is
maras+Sem/Plc+N+Sg+Nom	maras>	mˈɑ.rɑːs>
mccarthyisma+N+Der/viđá+Adv	mccarthyisma»viđá	mtstsˈɑrt.hy.isː.mɑ»vi.ðɑː
mccarthyisma+N+Sg+Loc	mccarthyismma>s	mtstsˈɑrt.hy.is.mɑ>s
mccarthyisma+N+Der/Dimin+N+Pl+Nom	mccarthyismma»žat	mtstsˈɑrt.hy.is.mɑ»žɑh
meatnut+V+TV+Der/PassL+V+IV+Der/upmi+N+Sg+Nom+PxPl3	medno>j»upmi>set	mˈed.no>j»up.mi>seh
meatnut+V+TV+VAbess	meanu>keahttá	mˈeæ.nu>kĕæhː.tɑː
mehtersystema+N+Sg+Ill	mehtersystemi>i	mˈeːh.ter#sˌysː.te.mi>i
mihkke+Pron+Indef+Sg+Acc	maide	mˈɑjː.te
miinai+Pron+Indef+Acc	ma>idnai	mˈɑ>id.nɑj
miinai+Pron+Indef+Gen	ma>idnai	mˈɑ>id.nɑj
miinai+Pron+Indef+Gen	ma>nnai	mˈɑ>nːɑj
miinai+Pron+Indef+Loc	ma>sai	mˈɑ>sɑj
mii+Pron+Indef+Sg+Gen	man	mˈɑn
mii+Pron+Indef+Sg+Nom	mii	mˈij
mittodit+V+TV+Ind+Prt+Pl2	mittod>eidde>t	mˈit.tod>ejt.te>h
mii+Pron+Indef+Sg+Acc+	máid	mˈɑːjh
mjau+Interj	mjau	mjˈɑu
moattebealat+A+Sg+Ill	maottibealag>ii	mˈɑ.ot.tˌi#pˌeæ.lɑg>ij
moattebealat+A+Attr	maottibealat>	mˈɑ.ot.tˌi#pˌeæ.lɑt>
moattebealat+A+Sg+Nom	maottibealat>	mˈɑ.ot.tˌi#pˌeæ.lɑt>
moarrut+V+IV+Pot+Prs+Sg3	moro>š	mˈo.ro>ʃ
moccáskit+V+IV+Der/meahttun+A+Comp+Attr	moccás>»meahttus>ut>	mˈotː.tsɑːs>»#mˌĕæhː.tus>ut>
mollat+V+TV+Pot+Prs+Du3	mola>žeaba>	mˈo.lɑː>žeæ.bɑ>
monokultuvrralašvuohta+N+Sg+Gen+PxDu2	monokultuvrralašvuođa>de	mˈo.no#khˌulː.l̥tuvr.rɑ.lɑʃ.vuo.ðɑ>de
moraš+N+Der/heapmi+A+Attr+Der/vuohta+N+Sg+Ill	moraš>»his>»»»vuhti>i	mˈo.rɑːʃ>»#hˌis>»»»#vˌuh.ti>i
mousseret+V+IV+Ind+Prt+Sg3	mousseri>i	mˈous.se.ri>i
mun+Pron+Pers+Du1+Com	munnu>in	mˈun.nu>in
mun+Pron+Pers+Du1+Loc	munno>s	mˈun.no>s
mun+Pron+Pers+Pl1+Ess	mi>nin	mˈi>nin
muddu+Sem/Time+N+Sg+Gen+Allegro	mutto>	mˈut.to>
muskel+N+Der/viđá+Adv	muskel»viđá	mˈusː.kel»#vˌi.ðɑː
muttar+N+Pl+Nom	muddar>at	mˈudː.tɑːr>ɑh
myhta+N+Sg+Ill	myhti>i	mˈyh.ti>i
myrra+N+Der/heapmi+A+Pl+Loc	myra>»hemi>in	mˈy.rɑ>»he.mi>in
mámmon+N+Sg+Ill+PxDu3	mámmon>asa>ska	mˈɑːm.mon>ɑ.sɑ>skɑ
mámmon+N+Der/viđá+Adv	mámmon»viđá	mˈɑːm.mon»#vˌi.ðɑː
möbleret+V+TV+Ind+Prt+Du3	möbleri>iga	mˈøb.le.ri>i.gɑ
møbleret+V+TV+VGen	møblere>	mˈøb.le.re>
møbleret+V+TV+Ind+Prt+Du1	møbleri>ime	mˈøb.le.ri>i.me
nuppelohkái+Num+Ess	>nubbinlogi>n	>nubː.pin#lˌo.gi>n
nuppelohkái+Num+Ess	>nubbinlohki>n	>nubː.pin#lˌoh.ki>n
nuppelohkái+Num+Sg+Loc	>nuppelogi>s	>nup.pe#lˌo.gi>s
nuppelohkái+Num+Sg+Gensahán+Sem/Act+N+Sg+Gen	>nuppelogi»sahán>	>nup.pe#lˌo.gi»#sˌɑ.hɑːn>
nuppelohkái+Num+Sg+Genčorgi+Sem/Time+N+Sg+Nom	>nuppelogi»čorgi>	>nup.pe#lˌo.gi»#tʃˌorə.ki>
nuppelohkái+Num+Sg+Genčorgi+Sem/Time+N+Sg+Gen+Allegro	>nuppelogi»čorgge>	>nup.pe#lˌo.gi»#tʃˌork.ke>
nuppelohkái+Num+Sg+Attr	>nuppelot>	>nup.pe#lˌot>
nuppelohkái+Num+Pl+Com	>nuppiidlogi>iguin	>nup.pijd#lˌo.gi>i.gujn
nuppelohkái+Num+Pl+Ill	>nuppiidelogi>ide	>nup.pij.de#lˌo.gi>i.de
nuppelohkái+Num+Pl+Com	>nuppiiguinlogi>iguin	>nup.pij.gujn#lˌo.gi>i.gujn
nuppelohkái+Num+Pl+Loc	>nuppiinlogi>in	>nup.pijn#lˌo.gi>in
nuppelohkái+Num+Sg+Com	>nuppiinlogi>in	>nup.pijn#lˌo.gi>in
nuppelohkái+Num+Pl+Nom	>nuppitlogi>t	>nupː.pit#lˌo.gi>h
nubbi+Pron+Recipr+Pl+Acc+PxDu1	nuppi>ideame	nˈup.pi>i.dĕæ.me
nubbi+Pron+Recipr+Pl+Acc+PxDu2	nuppi>ideatte	nˈup.pi>i.dĕæt.te
nubbi+Pron+Recipr+Pl+Acc+PxDu3	nuppi>ideaskka	nˈup.pi>i.deæs.kɑ
nubbi+Pron+Recipr+Pl+Acc+PxPl1	nuppi>ideamet	nˈup.pi>i.dĕæ.meh
nubbi+Pron+Recipr+Pl+Acc+PxPl2	nuppi>ideattet	nˈup.pi>i.dĕæt.teh
nubbi+Pron+Recipr+Pl+Acc+PxPl3	nuppi>ideaset	nˈup.pi>i.dĕæ.seh
nubbi+Pron+Recipr+Pl+Com+PxDu1	nuppi>ideameguin	nˈup.pi>i.dĕæ.me.gujn
nubbi+Pron+Recipr+Pl+Com+PxDu2	nuppi>ideatteguin	nˈup.pi>i.dĕæt.te.gujn
nubbi+Pron+Recipr+Pl+Com+PxPl1	nuppi>ideametguin	nˈup.pi>i.dĕæ.met.gujn
nubbi+Pron+Recipr+Pl+Com+PxPl3	nuppi>ideasetguin	nˈup.pi>i.dĕæ.set.gujn
nubbi+Pron+Recipr+Pl+Gen+PxDu1	nuppi>ideame	nˈup.pi>i.dĕæ.me
nubbi+Pron+Recipr+Pl+Gen+PxDu3	nuppi>ideaskka	nˈup.pi>i.deæs.kɑ
nubbi+Pron+Recipr+Pl+Gen+PxPl1	nuppi>ideamet	nˈup.pi>i.dĕæ.meh
nubbi+Pron+Recipr+Pl+Gen+PxPl2	nuppi>ideattet	nˈup.pi>i.dĕæt.teh
nubbi+Pron+Recipr+Pl+Ill+PxDu1	nuppi>idasame	nˈup.pi>i.dɑ.sɑ.me
nubbi+Pron+Recipr+Pl+Ill+PxDu3	nuppi>idasaska	nˈup.pi>i.dɑ.sɑs.kɑ
nubbi+Pron+Recipr+Pl+Ill+PxPl1	nuppi>idasamet	nˈup.pi>i.dɑ.sɑ.meh
nubbi+Pron+Recipr+Pl+Ill+PxPl2	nuppi>idasadet	nˈup.pi>i.dɑ.sɑ.deh
nubbi+Pron+Recipr+Pl+Ill+PxPl3	nuppi>idasaset	nˈup.pi>i.dɑ.sɑ.seh
nubbi+Pron+Recipr+Pl+Loc+PxPl1	nuppi>ineamet	nˈup.pi>i.nĕæ.meh
nubbi+Pron+Recipr+Pl+Loc+PxPl3	nuppi>ineaset	nˈup.pi>i.nĕæ.seh
naššuvdna+Sem/Org+Sem/Plc+N+Sg+Nom+PxSg2	naššuvdna>t	nˈɑʃː.ʃuv.tnɑ>h
na+Pcle	na	nˈɑ
naftalena+N+Sg+Ill	naftaleni>i	nˈɑf.tɑː.le.ni>i
naiggistit+V+IV+Der/alla+V+Der/PassS+V+IV+Pot+Prs+Sg3	naiggást»allo>»>ža	nˈɑjkː.kɑːst»ɑl.lo>»>žɑ
nebá+Sem/Hum+N+Der/viđá+Adv	neba»viđá	nˈe.bɑː»vi.ðɑː
neillet+Sem/Plant+N+Der/viđá+Adv	neillet»viđá	nˈejl.let»#vˌi.ðɑː
nektariidna+N+Sg+Ill	nektariidni>i	nˈekː.htɑ.rij.tni>i
neogrammatihkalaš+A+Der/vuohta+N+Der/viđá+Adv	neogrammatihkalaš»»»vuohta»viđá	nˈe.o.grˌɑm.mɑ.tih.kɑ.lɑʃ»»»#vˌuoh.tɑ»vi.ðɑː
neutralisašuvdna+N+Sg+Ill	neutralisašuvdni>i	nˈeut.rɑ.li.sɑ.ʃuv.tni>i
niibi+N+Ess	niibi>n	nˈijː.pi>n
ninna+N+Pl+Nom+PxSg2	nina>id>at	nˈi.nɑː>id>ɑh
ninna+N+Sg+Loc	nina>s	nˈi.nɑː>s
ninna+N+Der/laš+A+Attr+Der/vuohta+N+Ess	nina»laš>»»»vuohta>n	nˈi.nɑː»lɑʃ>»»»#vˌuoh.tɑ>n
nistásit+V+IV+Der/NomAg+N+Pl+Com+PxSg3	nistás»eddji»id>isguin	nˈisː.tɑːs»eɟː.ci»id>is.gujn
njeaiddáhallat+V+IV+Imprt+Pl1	njeaiddáhallu>t	ɲˈeæjt.tɑː.hɑl.lu>h
njiekču+N+Sg+Acc+PxPl1	njikčo>met	ɲˈikː.htʃo>meh
njággu+Sem/Ani+N+Sg+Ill	njággu>i	ɲˈɑːgː.ku>i
njáskansahá+N+Der/viđá+Adv	njáskansaha»viđá	ɲˈɑːsː.kɑn#sˌɑ.hɑ»vi.ðɑː
noveallafilbma+N+Sg+Ill	noveallafilbmi>i	nˈo.veæl.lˌɑ#fˌilə.pmi>i
nođđu+N+Sg+Gen+PxSg2	nođo>t	nˈo.ðo>h
nubbi+A+Ord+Sg+Acc	nuppe>	nˈup.pe>
nudisma+N+Pl+Nom	nudismma>t	nˈuː.dis.mˌɑ>h
nugo+CS	nugo	nˈuː.go
nuppos+Adv	nuppos	nˈup.pos
nyanseret+V+TV+Der/NomAct+N+Der/viđá+Adv	nyansere>»n»viđá	nˈy.ɑn.sˌe.re>»n»#vˌi.ðɑː
nyanseret+V+TV+Der/d+V+VGen	nyansere»t	nˈy.ɑn.sˌe.re»h
nyanseret+V+TV+Ind+Prt+Du2	nyanseri>ide	nˈy.ɑn.sˌe.ri>i.de
nylona+N+Sg+Ill	nyloni>i	nˈy.lo.nˌi>i
nyánsaerohus+N+Sg+Ill+PxSg2	nyánsaerohussa>s>at	nˈy.ɑːn.sˌɑ#ˌe.ro.hˌus.sɑ>s>ɑh
nádjat+V+TV+Der/halla+V+Ger+PxSg1	nája»hala>dettiin>an	nˈɑː.jɑ»hɑ.lɑ>det.tijn>ɑn
námá+N+Der/Dimin+N+Ess	námá»žin	nˈɑː.mɑː»žin
náskál+N+Der/heapmi+A+Sg+Ill	náskál»heapmá>i	nˈɑːsː.kɑːl»#hˌeæp.mɑː>i
návat+N+Der/huvva+V+IV+Pot+Prs+ConNeg	náva»huva>š	nˈɑː.vɑ»hu.vɑ>ʃ
návt+Adv	návt	nˈɑːvh
náššat+V+TV+Imprt+Pl2	nášše>t	nˈɑːʃ.ʃe>h
okta+Num+Sg+Nom	akta>	ˈɑkː.htɑ>
oktagoalmmátlohkái+Num+Ess	akta>goalmmátlohki>n	ˈɑkː.htɑ>#kˌoɑlm.mɑːt#lˌoh.ki>n
oktalogátlohkái+Num+Sg+Nom	akta>logátlohká>i	ˈɑkː.htɑ>#lˌo.gɑːt#lˌohː.kɑː>i
oktanuppelohkái+Num+Sg+Attr	akta>nnuppelot>	ˈɑkː.htɑ>n#nˌup.pe#lˌot>
oktaovccátlohkái+Num+Ess	akta>ovccátlohki>n	ˈɑkː.htɑ>#ˌoβɸ.tsɑːt#lˌoh.ki>n
oktaovccátlohkái+Num+Sg+Nom	akta>ovccátlohká>i	ˈɑkː.htɑ>#ˌoβɸ.tsɑːt#lˌohː.kɑː>i
oktaduhátlogát+A+Ord+Sg+Loc+PxPl1	aktaduhátlogád>isttá>met	ˈɑkː.htɑ#tˌu.hɑːt#lˌo.gɑːd>is.tɑː>meh
oktage+Pron+Indef+Sg+Nom	akta>ge	ˈɑkː.htɑ>ge
oktačuohti+Num+Sg+Nom	aktačuohti>	ˈɑkː.htɑ#tʃˌuoh.ti>
oktaguđatlohkái+Num+Pl+Ill+Attr	avtta>idguđatlogi>id	ˈɑβɸː.tɑː>id#kˌu.ðɑt#lˌo.gi>id
oktalogátlohkái+Num+Pl+Nom	avtta>tlogátlogi>t	ˈɑβɸː.tɑː>t#lˌo.gɑːt#lˌo.gi>h
oktalogátlohkái+Num+Sg+Ill	avtta>logátlohká>i	ˈɑβɸː.tɑː>#lˌo.gɑːt#lˌohː.kɑː>i
oktanuppelohkái+Num+Ess	avtta>tnuppelogi>n	ˈɑβɸː.tɑː>t#nˌup.pe#lˌo.gi>n
oktaovccátlohkái+Num+Ess	avtta>tovccátlogi>n	ˈɑβɸː.tɑː>t#ˌoβɸ.tsɑːt#lˌo.gi>n
oktaovccátlohkái+Num+Pl+Attr	avtta>idovccátlot>	ˈɑβɸː.tɑː>id#ˌoβɸ.tsɑːt#lˌot>
oktaovccátlohkái+Num+Pl+Nom	avtta>tovccátlogi>t	ˈɑβɸː.tɑː>t#ˌoβɸ.tsɑːt#lˌo.gi>h
oktaviđatlohkái+Num+Sg+Attr+Der/beaivásaš+A+Ess	avtta>viđátlot»»»»beaivásažža>n	ˈɑβɸː.tɑː>#vˌi.ðɑːt#lˌot»#»»»beæj.vɑː.sɑdː.tʃɑ>n
oktaviđátlohkái+Num+Ess	avtta>tviđátlogi>n	ˈɑβɸː.tɑː>t#vˌi.ðɑːt#lˌo.gi>n
oktaviđátlohkái+Num+Pl+Loc	avtta>inviđatlogi>in	ˈɑβɸː.tɑː>in#vˌi.ðɑt#lˌo.gi>in
oktačihččetlohkái+Num+Ess	avtta>tčihččetlogi>n	ˈɑβɸː.tɑː>t#tʃˌihː.tʃet#lˌo.gi>n
oktačihččetlohkái+Num+Sg+Com	avtta>inčihččetlogi>in	ˈɑβɸː.tɑː>in#tʃˌihː.tʃet#lˌo.gi>in
oažžut+V+TV+Ind+Prt+ConNeg	ožžo>n	ˈodː.tʃo>n
oandut+V+IV+Ind+Prs+Sg1	oanddu>n	ˈoɑnt.tu>n
oazis+N+Der/geahtes+A+Attr	oazes>»keahtes	ˈŏɑ.dses>»#khˌĕæh.tes
obdukšunlatnja+Sem/Plc+N+Sg+Ill	obdukšunlatnji>i	ˈob.dukː.ʃun#lˌɑt.ɲi>i
ockulteret+V+IV+Der/h+V+Ind+Prs+ConNeg	ockultere»t	ˈots.kul.hte.re»h
ockulteret+V+IV+Der/PassL+V+IV+Ind+Prt+Sg3	ockultere»j»uvvu>i	ˈots.kul.hte.re»j»uv.vu>i
odjodaddat+V+TV+Ind+Prs+Du1	odjodadde>	ˈoc.co.ðɑdː.te>
ofelastit+V+TV+Der/PassS+V+IV+Imprt+Sg2	ofelasto>»>	ˈo.fe.lˌɑsː.to>»>
ogohallat+V+TV+Der/NomAg+N+Sg+Loc	ogohalli>»s	ˈo.go.hˌɑl.li>»s
ogon+Sem/Hum+N+Der/viđá+Adv	ogon»viđá	ˈoː.gon»#vˌi.ðɑː
ohki+Sem/Hum+N+Der/heapmi+A+Attr+Der/vuohta+N+Sg+Ill	oge»his>»»»vuhti>i	ˈo.ge»his>»»»#vˌuh.ti>i
ohki+Sem/Hum+N+Pl+Loc+PxPl2	ogi>in>eattet	ˈo.gi>in>ĕæt.teh
ohcamuš+N+Pl+Ill+PxSg2	ohcamuša>idasa>t	ˈohː.tsɑː.mu.ʃɑ>i.dɑ.sɑ>h
oinnolašvuohta+N+Pl+Nom	oinnolašvuođa>t	ˈojn.no.lɑʃ.vuo.ðɑ>h
oivošguovlu+Sem/Plc+N+Sg+Acc+PxDu1	oivošguvlo>me	ˈojː.voʃ#kˌuβː.lo>me
ojá+Interj	ojá	ˈoː.jɑː
ok+Adv	ok	ˈok
okci+N+Sg+Acc+PxDu3	ovcci>ska	ˈoβɸ.tsi>skɑ
oktaviđatlohkái+Num+Sg+Loc	ovtta>viđátlogi>s	ˈoβɸː.tɑː>#vˌi.ðɑːt#lˌo.gi>s
olli+N+Sg+Gen+Allegro	ole>	ˈo.le>
olli+Sem/Plc+N+Sg+Acc+PxSg2	olá>t	ˈo.lɑː>h
ollu+A+Sg+Ill	ollu>i	ˈol.lu>i
omiidgoahti+Sem/Build+N+Pl+Ill	omiidgođi>ide	ˈoː.mijd#kˌo.ði>i.de
ooh+Interj	ooh	ˈoːh
ooo+Interj	ooo	ˈooː
opmu+N+Sg+Acc+PxPl2	omo>det	ˈoːo
oppas+Sem/Wthr+N+Sg+Nom+PxDu3	obbas>easkka	ˈo.mo>deh
ovccis+N+Coll+Sg+Nom+PxSg1	okcás>an	ˈobː.pɑːs>eæs.kɑ
ovet+V+IV+Ind+Prt+Sg3	ovi>i	ˈokː.htsɑːs>ɑn
oxideret+V+TV+Ind+Prt+Sg3	oxideri>i	ˈo.vi>i
ozovdna+N+Sg+Ill	ozovdni>i	ˈoks.i.ðe.ri>i
ođas+N+Der/laš+A+Der/vuohta+N+Der/viđá+Adv	ođas>»laš»»»vuohta»viđá	ˈo.dsov.tnˌi>i
ođut+N+Sg+Ill+PxDu3	ođuh>asa>ska	ˈo.ðɑːs>»#lˌɑʃ»»»#vˌuoh.tɑ»vi.ðɑː
ođut+N+Der/Dimin+N+Sg+Ill	ođuh»ažži>i	ˈoː.ðuh>ɑ.sɑ>skɑ
ođut+N+Der/viđá+Adv	ođut»viđá	ˈoː.ðuh»ɑdː.tʃi>i
ožžodit+V+IV+Actio+Gen	ožžod>an	ˈoː.ðut»#vˌi.ðɑː
ožžodit+V+IV+Ind+Prt+Sg2	ožžod>it	ˈodː.tʃod>ɑn
ožžodit+V+IV+Ind+Prs+ConNeg	ožžot>	ˈodː.tʃod>ih
ovdaprojekterengolut+N+Der/heapmi+A+Comp+Sg+Nom	váktagolo»hat>	ˈodː.tʃot>
ovdaprojekterengolut+N+Der/heapmi+A+Pl+Gen	váktagolo»hemi>id	vˈɑːkː.htɑ#kˌo.lo»hɑt>
ovdaprojekterengolut+N+Der/heapmi+A+Sg+Com	váktagolo»hemi>in	vˈɑːkː.htɑ#kˌo.lo»he.mi>id
ovdaprojekterengolut+N+Der/heapmi+A+Attr+Der/vuohta+N+Sg+Nom	váktagolo»his>»»»vuohta>	vˈɑːkː.htɑ#kˌo.lo»he.mi>in
ovdaprojekterengolut+N+Der/huhtti+V+TV+VGen	váktagolo»huhti>	vˈɑːkː.htɑ#kˌo.lo»his>»»»#vˌuoh.tɑ>
ovdaprojekterengolut+N+Der/huhtti+V+TV+Der/PassS+V+IV+Ind+Prt+Pl2	váktagolo»huhttu>»idet	vˈɑːkː.htɑ#kˌo.lo»huh.ti>
ovdaprojekterengolut+N+Der/Dimin+N+Pl+Nom	váktagolo»žat	vˈɑːkː.htɑ#kˌo.lo»huhː.tu>»i.deh
ovdaprojekterengolut+N+Der/Dimin+N+Ess	váktagolo»žin	vˈɑːkː.htɑ#kˌo.lo»žɑh
ovdaprojekterengolut+N+Der/Dimin+N+Pl+Com	váktagolo»žiiguin	vˈɑːkː.htɑ#kˌo.lo»žin
ovdaprojekterengolut+N+Der/Dimin+N+Pl+Loc+PxSg3	váktagolo»žiinni>s	vˈɑːkː.htɑ#kˌo.lo»žij.gujn
ovdaprojekterengolut+N+Pl+Com	váktagolu>iguin	vˈɑːkː.htɑ#kˌo.lo»žijn.ni>s
ovdaprojekterengolut+N+Pl+Gen	váktagolu>id	vˈɑːkː.htɑ#kˌo.lu>i.gujn
ovdaprojekterengolut+N+Pl+Gen+PxSg2	váktagolu>id>at	vˈɑːkː.htɑ#kˌo.lu>id
ovdaprojekterengolut+N+Pl+Loc+PxPl2	váktagolu>in>eattet	vˈɑːkː.htɑ#kˌo.lu>id>ɑh
ovdaprojekterengolut+N+Pl+Nom	váktagolu>t	vˈɑːkː.htɑ#kˌo.lu>in>ĕæt.teh
ovdaprojekterengolut+N+Der/heapmi+A+Comp+Sg+Loc	váktagolu»habbo>s	vˈɑːkː.htɑ#kˌo.lu>h
ovdaprojekterengolut+N+Der/huhtti+V+TV+Ger	váktagolu»huhte>din	vˈɑːkː.htɑ#kˌo.lu»hɑbː.po>s
ovdaprojekterengolut+N+Der/huhtti+V+TV+Ger	váktagolu»huhti>dettiin	vˈɑːkː.htɑ#kˌo.lu»huh.te>din
ovdaprojekterengolut+N+Der/huhtti+V+TV+Cond+Prs+Sg1	váktagolu»huhtá>šin	vˈɑːkː.htɑ#kˌo.lu»huh.ti>det.tijn
ovdaprojekterengolut+N+Ess	váktagollu>n	vˈɑːkː.htɑ#kˌo.lu»huhː.tɑː>ʃin
poastamáhppa+v2+N+Pl+Nom	boastamáhpa>t	vˈɑːkː.htɑ#kˌol.lu>n
poastamáhppa+v2+N+Sg+Gen+PxSg3	boastamáhpa>s	pˈŏɑsː.tɑ#mˌɑːh.pɑ>h
poastamáhppa+v2+N+Sg+Loc	boastamáhpa>s	pˈŏɑsː.tɑ#mˌɑːh.pɑ>s
poastamáhppa+v2+N+Der/Dimin+N+Sg+Nom	boastamáhpa»š	pˈŏɑsː.tɑ#mˌɑːh.pɑ>s
poastamáhppa+v2+N+Der/huhtti+V+TV+VAbess	boastamáhpa»huhti>keahttá	pˈŏɑsː.tɑ#mˌɑːh.pɑ»ʃ
poastamáhppa+v2+N+Der/huhtti+V+TV+Sup	boastamáhpa»huhtá>žit	pˈŏɑsː.tɑ#mˌɑːh.pɑ»huh.ti>kĕæhː.tɑː
poastamáhppa+v2+N+Der/huvva+V+IV+Cond+Prs+Du3	boastamáhpa»huva>leigga>	pˈŏɑsː.tɑ#mˌɑːh.pɑ»huhː.tɑː>žih
poastamáhppa+v2+N+Der/huvva+V+IV+Sup	boastamáhpa»huva>žit	pˈŏɑsː.tɑ#mˌɑːh.pɑ»hu.vɑ>lejk.kɑ>
poastamáhppa+v2+N+Der/huvva+V+IV+Imprt+Pl2	boastamáhpa»huvve>t	pˈŏɑsː.tɑ#mˌɑːh.pɑ»hu.vɑ>žih
poastamáhppa+v2+N+Der/laš+A+Der/vuohta+N+Sg+Ill	boastamáhpa»laš»»»vuhti>i	pˈŏɑsː.tɑ#mˌɑːh.pɑ»huv.ve>h
poastamáhppa+N+Pl+Com	boastamáhpa>iguin	pˈŏɑsː.tɑ#mˌɑːh.pɑ»lɑʃ»»»#vˌuh.ti>i
poastamáhppa+N+Pl+Gen	boastamáhpa>id	pˈŏɑsː.tɑ#mˌɑːh.pɑ>i.gujn
poastamáhppa+N+Pl+Nom	boastamáhpa>t	pˈŏɑsː.tɑ#mˌɑːh.pɑ>id
poastamáhppa+N+Sg+Com	boastamáhpa>in	pˈŏɑsː.tɑ#mˌɑːh.pɑ>h
poastamáhppa+N+Sg+Loc	boastamáhpa>s	pˈŏɑsː.tɑ#mˌɑːh.pɑ>in
poastamáhppa+N+Sg+Loc+PxPl3	boastamáhpa>st>easet	pˈŏɑsː.tɑ#mˌɑːh.pɑ>s
poastamáhppa+N+Der/Dimin+N+Pl+Nom	boastamáhpa»žat	pˈŏɑsː.tɑ#mˌɑːh.pɑ>st>ĕæ.seh
poastamáhppa+N+Der/heapmi+A+Sg+Com	boastamáhpa»hemi>in	pˈŏɑsː.tɑ#mˌɑːh.pɑ»žɑh
poastamáhppa+N+Der/heapmi+A+Attr+Der/vuohta+N+Sg+Ill	boastamáhpa»his>»»»vuhti>i	pˈŏɑsː.tɑ#mˌɑːh.pɑ»he.mi>in
poastamáhppa+N+Der/huhtti+V+TV+Ger	boastamáhpa»huhti>diin	pˈŏɑsː.tɑ#mˌɑːh.pɑ»his>»»»#vˌuh.ti>i
poastamáhppa+N+Der/huhtti+V+TV+Imprt+Pl2	boastamáhpa»huhtti>t	pˈŏɑsː.tɑ#mˌɑːh.pɑ»huh.ti>dijn
poastamáhppa+N+Der/huvva+V+IV+Ind+Prt+Pl3	boastamáhpa»huvve>	pˈŏɑsː.tɑ#mˌɑːh.pɑ»huhː.ti>h
poastamáhppa+v2+N+Ess	boastamáhppa>n	pˈŏɑsː.tɑ#mˌɑːh.pɑ»huv.ve>
poastamáhppa+v2+N+Ess+PxSg1	boastamáhppa>n>an	pˈŏɑsː.tɑ#mˌɑhː.pɑ>n
poastamáhppa+v2+N+Sg+Acc+PxPl1	boastamáhppa>met	pˈŏɑsː.tɑ#mˌɑhː.pɑ>n>ɑn
poastamáhppa+v2+N+Sg+Acc+PxSg1	boastamáhppa>n	pˈŏɑsː.tɑ#mˌɑhː.pɑ>meh
poastamáhppa+v2+N+Der/viđá+Adv	boastamáhppa»viđá	pˈŏɑsː.tɑ#mˌɑhː.pɑ>n
poastamáhppa+v2+N+Sg+Ill	boastamáhppi>i	pˈŏɑsː.tɑ#mˌɑhː.pɑ»vi.ðɑː
poastamáhppa+N+Sg+Gen+PxSg1	boastamáhppa>n	pˈŏɑsː.tɑ#mˌɑhː.pi>i
poastamáhppa+N+Sg+Ill+PxSg1	boastamáhppa>s>an	pˈŏɑsː.tɑ#mˌɑhː.pɑ>n
poastamáhppa+N+Der/viđá+Adv	boastamáhppa»viđá	pˈŏɑsː.tɑ#mˌɑhː.pɑ>s>ɑn
poastamáhppa+N+Sg+Ill	boastamáhppi>i	pˈŏɑsː.tɑ#mˌɑhː.pɑ»vi.ðɑː
pakeha+Sem/Hum+N+Sg+Ill	pakehi>i	pˈŏɑsː.tɑ#mˌɑhː.pi>i
passiiva+N+Sg+Ill	passiivi>i	phˈɑ.ke.hˌi>i
pelleteret+V+TV+Der/stuvva+V+VGen	pelletere»stuva>	phˈɑs.sij.vi>i
petrovla+N+Sg+Ill	petrovli>i	phˈel.le.te.re»stu.vɑ>
philosophicum+N+Sg+Nom	philosophicum>	phˈet.rov.li>i
philosophicum+N+Sg+Ill	philosophicumi>i	phˈi.lo.sˌop.hi.tsum>
pilára+N+Der/viđá+Adv	pilára»viđá	phˈi.lo.sˌop.hi.tsu.mi>i
pistovla+N+Sg+Acc+PxSg1	pistovla>n	phˈi.lɑː.rˌɑ»vi.ðɑː
plutonisma+N+Der/heapmi+A+Ess	plutonismma»heapmi>n	phˈisː.tov.lɑ>n
pläderet+V+IV+Ind+Prt+Pl1	pläderi>imet	plˈu.to.nˌis.mɑ»heæp.mi>n
pneumáhtalaš+A+Attr	pneumáhtalaš>	plˈæ.de.rˌi>i.meh
pneumáhtalaš+A+Der/vuohta+N+Sg+Ill	pneumáhtalaš»»»vuhti>i	pnˈeu.mɑːh.tˌɑ.lɑʃ>
pneumáhtalaš+A+Der/vuohta+N+Sg+Acc+PxPl2	pneumáhtalaš»»»vuođa>det	pnˈeu.mɑːh.tˌɑ.lɑʃ»»»#vˌuh.ti>i
pneumáhtalaš+A+Sg+Ill	pneumáhtalažži>i	pnˈeu.mɑːh.tˌɑ.lɑʃ»»»#vˌuo.ðɑ>deh
poava+Sem/Hum+N+Der/viđá+Adv	poava»viđá	pnˈeu.mɑːh.tˌɑ.lɑdː.tʃi>i
pohtehtos+N+Der/viđá+Adv	pohtehtos»viđá	phˈoɑ.vɑ»vi.ðɑː
poseret+V+IV+Ind+Prt+Pl1	poseri>imet	phˈoːh.teh.tos»#vˌi.ðɑː
povla+N+Ess	povla>n	phˈo.se.rˌi>i.meh
povla+N+Pl+Nom	povlla>t	phˈoβː.lɑː>n
pošeret+V+TV+Der/h+V+VAbess	pošere»tkeahttá	phˈoβlː.lɑː>h
praktihkar+Sem/Hum+N+Pl+Nom+PxSg3	praktihkkar>iiddi>s	phˈo.ʃe.rˌe»t#khˌĕæhː.tɑː
prognoseret+V+TV+Der/PassL+V+IV+Der/upmi+N+Pl+Acc+PxSg1	prognosere»j»umi>id>an	prˈɑkː.htihː.kɑr>ijt.ti>s
prøvet+V+TV+Ind+Prt+Du3	prøvi>iga	prˈo.gno.sˌe.re»j»u.mi>id>ɑn
pseudonyma+N+Sg+Ill	pseudonymi>i	prˈø.vi>i.gɑ
psykoanalyseret+V+TV+Pot+Prs+Pl3	psykoanalysere>žit	psˈeu.do.nˌy.mi>i
puh+Interj	puh	psˈy.ko#ˌɑ.nɑ.lˌy.se.re>žih
puŋka+N+Der/viđá+Adv	puŋka»viđá	phˈuh
pyramida+N+Pl+Gen+PxDu2	pyramida>id>eatte	phˈuŋŋ.ŋ̊kɑ»vi.ðɑː
pyramida+N+Sg+Ill	pyramidi>i	phˈy.rɑ.mˌi.dɑ>id>ĕæt.te
pytagoralaš+A+Der/vuohta+N+Ess	pytagoralaš»»»vuohta>n	phˈy.rɑ.mˌi.di>i
pálla+N+Sg+Ill	pálli>i	phˈy.tɑ.gˌo.rɑ.lɑʃ»»»#vˌuoh.tɑ>n
pándá+Sem/Ani+N+Sg+Com	pánddá>in	phˈɑːl.li>i
párastallat+V+IV+VAbess	párastala>haga	phˈɑːnt.tɑː>in
pøŋka+N+Sg+Com+PxPl3	pøŋkka>in>easet	phˈɑː.rɑs.tˌɑ.lɑ>hɑ.gɑ
pøŋka+N+Sg+Loc+PxSg3	pøŋkka>st>is	phˈøŋŋ̊.kɑ>in>ĕæ.seh
ruvdnaprinsa+v2+Sem/Hum+N+Ess	kruvdnaprinsa>n	phˈøŋŋ̊.kɑ>st>is
ruvdnaprinsa+v2+Sem/Hum+N+Ess+PxPl3	kruvdnaprinsa>n>easet	krˈuβː.tnɑ#prˌinː.sɑ>n
ruvdnaprinsa+v2+Sem/Hum+N+Sg+Ill	kruvdnaprinsi>i	krˈuβː.tnɑ#prˌinː.sɑ>n>ĕæ.seh
ruvdnaprinsa+v2+Sem/Hum+N+Sg+Com+PxPl1	kruvdnaprinssa>in>eamet	krˈuβː.tnɑ#prˌinː.si>i
ruvdnaprinsa+v2+Sem/Hum+N+Sg+Loc	kruvdnaprinssa>s	krˈuβː.tnɑ#prˌins.sɑ>in>ĕæ.meh
ruvdnaprinsa+v2+Sem/Hum+N+Der/huhtti+V+TV+Cond+Prs+Sg2	kruvdnaprinssa»huhtá>šit	krˈuβː.tnɑ#prˌins.sɑ>s
ruvdnaprinsa+v2+Sem/Hum+N+Der/huvva+V+IV+Ind+Prt+Pl2	kruvdnaprinssa»huva>idet	krˈuβː.tnɑ#prˌins.sɑ»huhː.tɑː>ʃih
ruvdnaprinsa+v2+Sem/Hum+N+Der/laš+A+Superl+Pl+Nom	kruvdnaprinssa»lamos>at	krˈuβː.tnɑ#prˌins.sɑ»hu.vɑ>i.deh
ruvdnaprinsa+Sem/Hum+N+Ess	kruvdnaprinsa>n	krˈuβː.tnɑ#prˌins.sɑ»lɑ.mos>ɑh
ruvdnaprinsa+Sem/Hum+N+Sg+Gen+PxPl1	kruvdnaprinsa>met	krˈuβː.tnɑ#prˌinː.sɑ>n
ruvdnaprinsa+Sem/Hum+N+Sg+Ill	kruvdnaprinsi>i	krˈuβː.tnɑ#prˌinː.sɑ>meh
ruvdnaprinsa+Sem/Hum+N+Sg+Com+PxSg3	kruvdnaprinssa>in>is	krˈuβː.tnɑ#prˌinː.si>i
ruvdnaprinsa+Sem/Hum+N+Der/huhtti+V+TV+Ger+PxDu3	kruvdnaprinssa»huhte>dettiin>easkka	krˈuβː.tnɑ#prˌins.sɑ>in>is
ruvdnaprinsa+v4+Sem/Hum+N+Der/viđá+Adv	kruvnnaprinsa»viđá	krˈuβː.tnɑ#prˌins.sɑ»huh.te>det.tijn>eæs.kɑ
ruvdnaprinsa+v4+Sem/Hum+N+Sg+Ill	kruvnnaprinsi>i	krˈuβnː.nɑː#prˌinː.sɑ»vi.ðɑː
ruvdnaprinsa+v4+Sem/Hum+N+Pl+Gen+PxPl3	kruvnnaprinssa>id>easet	krˈuβnː.nɑː#prˌinː.si>i
ruvdnaprinsa+v4+Sem/Hum+N+Der/heapmi+A+Superl+Pl+Ill	kruvnnaprinssa»hepmos>iidda	krˈuβnː.nɑː#prˌins.sɑ>id>ĕæ.seh
ruvdnaprinsa+v4+Sem/Hum+N+Der/huhtti+V+TV+VAbess	kruvnnaprinssa»huhte>haga	krˈuβnː.nɑː#prˌins.sɑ»hep.mos>ijt.tɑ
ruvdnaprinsa+v4+Sem/Hum+N+Der/huvva+V+IV+Sup	kruvnnaprinssa»huva>žit	krˈuβnː.nɑː#prˌins.sɑ»huh.te>hɑ.gɑ
ruvdnaprinsa+v4+Sem/Hum+N+Der/laš+A+Der/vuohta+N+Sg+Ill	kruvnnaprinssa»laš»»»vuhti>i	krˈuβnː.nɑː#prˌins.sɑ»hu.vɑ>žih
ruvdnaprinsa+Sem/Hum+N+Sg+Acc+PxPl1	kruvnnaprinsa>met	krˈuβnː.nɑː#prˌins.sɑ»lɑʃ»»»#vˌuh.ti>i
ruvdnaprinsa+Sem/Hum+N+Sg+Loc	kruvnnaprinssa>s	krˈuβnː.nɑː#prˌinː.sɑ>meh
ruvdnaprinsa+Sem/Hum+N+Der/Dimin+N+Sg+Nom	kruvnnaprinssa»š	krˈuβnː.nɑː#prˌins.sɑ>s
rabas+A+Comp+Attr	rahpas>et>	krˈuβnː.nɑː#prˌins.sɑ»ʃ
rabbi+N+Der/huhtti+V+TV+Ger+PxPl3	rappe»huhti>dettiin>easet	rˈɑhː.pɑːs>et>
rakŋut+V+IV+VGen	raŋu>	rˈɑp.pe»huh.ti>det.tijn>ĕæ.seh
rakŋat+V+IV+Imprt+Pl2	ragŋe>t	rˈɑ.ŋu>
rakčut+V+IV+Der/st+V+Der/alla+V+Imprt+ConNeg	ravččo»stala>	rˈɑg.ŋe>h
rasttidit+V+TV+VAbess	rasttit>haga	rˈɑβɸ.tʃo»stɑ.lɑ>
rattát+Adv	rattát	rˈɑs.tit>#hˌɑ.gɑ
raččas+A+Superl+Attr	ražžas>amos>	rˈɑtː.tɑːh
rejiseret+V+TV+Ind+Prt+Sg3	rejiseri>i	rˈɑdː.tʃɑːs>ɑ.mos>
reŋko+N+Der/viđá+Adv	reŋko»viđá	rˈe.ji.sˌe.ri>i
ribbeloddi+Sem/Ani+N+Sg+Com+PxPl1	ribbelotti>in>eamet	rˈeŋŋ.ŋ̊ko»vi.ðɑː
riffal+N+Der/viđá+Adv	riffal»viđá	rˈibː.pe#lˌot.ti>in>ĕæ.meh
riita+N+Sg+Acc	riitta>	rˈif.fɑːl»#vˌi.ðɑː
rimsi+Sem/Hum+N+Sg+Gen+PxPl1	rimsá>met	rˈijçç.tɑː>
ritnut+V+IV+Imprt+Du2	ridnu>	rˈimː.sɑː>meh
roggat+V+TV+VAbess	rokka>haga	rˈid.nu>
roggat+V+TV+Der/h+V+TV+VGen	rokka»t	rˈokː.kɑː>hɑ.gɑ
rojas+A+Attr+Der/vuohta+N+Sg+Ill	rodja>»»»vuhti>i	rˈokː.kɑː»h
rolla+G3+N+Der/heapmi+A+Comp+Sg+Ill	rolla»hebbu>i	rˈocː.cɑː>»»»#vˌuh.ti>i
rotnu+Sem/Ani+N+Der/heapmi+A+Pl+Gen	ronu»hemi>id	rˈolː.lɑː»hebː.pu>i
rusá+A+Sg+Ill	rosá>i	rˈo.nu»he.mi>id
rusá+A+Der/vuohta+N+Sg+Ill	rosá>»»»vuhti>i	rˈo.sɑː>i
ruineret+V+TV+Ind+Prt+Du1	ruineri>ime	rˈo.sɑː>»»»#vˌuh.ti>i
ruigu+Sem/Hum+Sem/Ani+N+Der/viđá+Adv	ruigo»viđá	rˈu.i.nˌe.ri>i.me
rumšu+Sem/Hum+N+Ess	rumšu>n	rˈujː.ko»vi.ðɑː
rutnut+V+IV+Der/h+V+TV+Imprt+Sg3	runu»hus	rˈumː.ʃu>n
rytma+N+Der/viđá+Adv	rytma»viđá	rˈu.nu»hus
rytma+N+Sg+Ill	rytmi>i	rˈytː.mɑ»vi.ðɑː
rytma+N+Der/huvva+V+IV+Ind+Prt+Sg1	rytmma»huvve>n	rˈytː.mi>i
rytmmalaš+A+Comp+Attr	rytmmal>it>	rˈytm.mɑ»huv.ve>n
rytmmalaš+A+Attr	rytmmalaš>	rˈytm.mɑl>it>
rádjat+V+TV+VGen	rája>	rˈytm.mɑ.lɑʃ>
rápma+N+Sg+Ill	rápmi>i	rˈɑː.jɑ>
ráppenguoibmi+Sem/Hum+N+Der/viđá+Adv	ráppenguoibme»viđá	rˈɑːp.mi>i
rásehuvvat+V+IV+Der/ahtti+V+TV+Cond+Prs+Pl3	rásih»uhtá>ledje>	rˈɑːp.pen#kˌŭoj.pme»vi.ðɑː
ráŋggohaddat+V+IV+Imprt+ConNeg	ráŋggohatta>	rˈɑː.sih»uh.tɑː>lec.ce>
røntgenfotograferet+V+TV+Der/PassL+V+IV+Actio+Ess	røntgenfotografere»juvvo>min	rˈɑːŋk.ko.hɑt.tɑ>
røntgenlatnja+Sem/Plc+N+Sg+Ill	røntgenlatnji>i	rˈønt.gen#fˌo.to.grˌɑ.fe.re»juv.vo>min
saguheapme+A+Der/huvva+V+IV+Sup	saguh»uva>žit	rˈønt.gen#lˌɑt.ɲi>i
sallut+V+TV+Der/h+V+TV+VGen	salu»t	sˈɑ.guh»u.vɑ>žih
schematiseret+V+TV+Ind+Prt+Du2	schematiseri>ide	sˈɑ.lu»h
schematiseret+V+TV+Ind+Prt+Du3	schematiseri>iga	stshˈe.mɑː.tˌi.se.ri>i.de
shaket+V+TV+Ind+Prt+Sg3	shaki>i	stshˈe.mɑː.tˌi.se.ri>i.gɑ
shampoo+N+Sg+Com	shampoo>in	shˈɑ.ki>i
show+Sem/Event+N+Sg+Nom	show>	shˈɑmː.m̥po.o>in
skadjá+Sem/Build+N+Pl+Nom	skajá>t	shˈoβ>
skovvi+N+Pl+Nom	skovi>t	skˈɑ.jɑː>h
skugga+N+Der/viđá+Adv	skugga»viđá	skˈo.vi>h
skytalaš+Sem/Hum+N+Der/Dimin+N+Sg+Gen+PxDu3	skytalačča»žeaskka	skˈugː.kɑː»vi.ðɑː
sloveniagielat+A+Ess	sloveniagielag>in	skˈy.tɑ.lˌɑt.tʃɑ»žeæs.kɑ
sloveniagielat+A+Pl+Nom	sloveniagielag>at	ʃlˈo.ve.nˌi.ɑ#kˌie.lɑg>in
smealčča+N+Der/Dimin+N+Sg+Gen+PxSg1	smealčag>»ažža>n	ʃlˈo.ve.nˌi.ɑ#kˌie.lɑg>ɑh
smiđđut+V+IV+Ind+Prt+ConNeg	smiđđo>n	smˈĕælː.l̥tʃɑg>»ɑdː.tʃɑ>n
smoggi+Sem/Hum+N+Der/viđá+Adv	smogge»viđá	smˈið.ðo>n
son+Pron+Pers+Pl3+Gen	si>n	smˈogː.ke»vi.ðɑː
son+Pron+Pers+Sg3+Nom	so>n	sˈi>n
sollat+V+TV+Imprt+Sg2	sola>	sˈo>n
sorjjas+A+Comp+Sg+Nom	sorjas>it>	sˈo.lɑː>
speađđu+N+Sg+Gen+PxDu2	speđo>de	sˈorə.jɑs>it>
stereorusttet+N+Der/Dimin+N+Sg+Nom	stereorustteg»aš>	spˈe.ðo>de
stylista+Sem/Hum+N+Sg+Gen+PxDu1	stylista>me	stˈe.re.ˌo#rˌus.teg»ɑʃ>
sveisenelektroda+N+Sg+Ill	sveisenelektrodi>i	stˈy.lis.tˌɑ>me
swingaklubba+Sem/Hum+Sem/Group+N+Pl+Nom	swingaklubba>t	svˈejː.sen#ˌe.lekt.rˌo.di>i
swiŋga+N+Sg+Acc+PxPl1	swiŋga>met	sβˈiŋŋ.kɑː#klˌubː.pɑ>h
swiŋga+N+Der/viđá+Adv	swiŋga»viđá	sβˈiŋŋ.kɑː>meh
swiŋŋaeahket+Sem/Time+N+Der/Dimin+N+Sg+Ill	swiŋŋaeahked»ažži>i	sβˈiŋŋ.kɑː»vi.ðɑː
sylinddar+N+Sg+Com+PxPl1	sylindar>iinná>met	sβˈiŋ.ŋɑː#ˌĕæh.ked»ɑdː.tʃi>i
sŋiran+N+Sg+Acc	sŋiram>a	sˈy.lin.dˌɑr>ijn.nɑː>meh
sŋiran+N+Sg+Ill+PxSg1	sŋiram>asa>n	sŋˈi.rɑːm>ɑ
sŋiran+N+Der/heapmi+A+Attr	sŋiran»his>	sŋˈi.rɑːm>ɑ.sɑ>n
show+Sem/Event+N+Der/Dimin+N+Der/Dimin+N+Sg+Nom	šova>»žaš>	sŋˈi.rɑːn»#hˌis>
show+Sem/Event+N+Der/heapmi+A+Comp+Attr	šova>»hit>	ʃˈo.vɑː>»žɑʃ>
show+Sem/Event+N+Der/heapmi+A+Superl+Pl+Com	šova>»hamos>iiguin	ʃˈo.vɑː>»hit>
show+Sem/Event+N+Der/heapmi+A+Superl+Pl+Com	šova>»hepmos>iiguin	ʃˈo.vɑː>»hɑ.mos>ij.gujn
show+Sem/Event+N+Der/heapmi+A+Ess	šova>»heapmi>n	ʃˈo.vɑː>»hep.mos>ij.gujn
show+Sem/Event+N+Der/heapmi+A+Pl+Loc	šova>»hemi>in	ʃˈo.vɑː>»heæp.mi>n
show+Sem/Event+N+Der/heapmi+A+Attr	šova>»his>	ʃˈo.vɑː>»he.mi>in
show+Sem/Event+N+Der/huhtti+V+TV+Pot+Prs+Sg3	šova>»huhte>š	ʃˈo.vɑː>»his>
show+Sem/Event+N+Der/huhtti+V+TV+Ger	šova>»huhti>diin	ʃˈo.vɑː>»huh.te>ʃ
show+Sem/Event+N+Der/huhtti+V+TV+Imprt+Du2	šova>»huhtti>	ʃˈo.vɑː>»huh.ti>dijn
show+Sem/Event+N+Der/huhtti+V+TV+ConNegII	šova>»huhtto>	ʃˈo.vɑː>»huhː.ti>
show+Sem/Event+N+Der/huhtti+V+TV+Cond+Prs+Du2	šova>»huhtá>šeidde>	ʃˈo.vɑː>»huhː.to>
show+Sem/Event+N+Der/huhtti+V+TV+Ind+Prs+Sg1	šova>»huhtá>n	ʃˈo.vɑː>»huhː.tɑː>ʃejt.te>
show+Sem/Event+N+Der/huhtti+V+TV+Ind+Prs+Sg2	šova>»huhtá>t	ʃˈo.vɑː>»huhː.tɑː>n
show+Sem/Event+N+Der/huvva+V+IV+Ger+PxDu1	šova>»huva>dettiin>eame	ʃˈo.vɑː>»huhː.tɑː>h
show+Sem/Event+N+Der/huvva+V+IV+Ind+Prt+Du1	šova>»huva>ime	ʃˈo.vɑː>»hu.vɑ>det.tijn>ĕæ.me
show+Sem/Event+N+Der/huvva+V+IV+Ind+Prs+Sg3	šova>»huvvá>	ʃˈo.vɑː>»hu.vɑ>i.me
show+Sem/Event+N+Sg+Nom	šovv>	ʃˈo.vɑː>»huvː.vɑː>
show+Sem/Event+N+Ess	šovva>n	ʃˈovː>
show+Sem/Event+N+Pl+Com+PxSg2	šovva>id>atguin	ʃˈovː.vɑː>n
show+Sem/Event+N+Pl+Gen	šovva>id	ʃˈovː.vɑː>id>ɑt.gujn
show+Sem/Event+N+Pl+Ill	šovva>ide	ʃˈovː.vɑː>id
show+Sem/Event+N+Pl+Nom+PxSg1	šovva>id>an	ʃˈovː.vɑː>i.de
show+Sem/Event+N+Sg+Acc	šovva>	ʃˈovː.vɑː>id>ɑn
show+Sem/Event+N+Sg+Nom+PxSg1	šovva>n	ʃˈovː.vɑː>
show+Sem/Event+N+Sg+Nom+PxSg2	šovva>t	ʃˈovː.vɑː>n
show+Sem/Event+N+Sg+Ill	šovvi>i	ʃˈovː.vɑː>h
tabloidamedia+Sem/Org+N+Sg+Com	tabloidamedia>in	ʃˈov.vi>i
taoista+Sem/Hum+N+Der/heapmi+A+Comp+Sg+Ill	taoistta»hebbu>i	thˈɑb.loj.dɑ#mˌe.di.ɑ>in
teosofiija+N+Sg+Ill	teosofiiji>i	thˈɑ.ojst.tˌɑ»hebː.pu>i
teáhterfierpmádat+Sem/Org+N+Sg+Nom	teáhterfierpmádat>	thˈe.o.sˌo.fij.ji>i
thaigiella+Sem/Lang+N+Sg+Ill	thaigilli>i	thˈe.ɑːh.tˌer#fˌĭĕrpː.mɑː.dɑt>
thymusráksá+N+Der/viđá+Adv	thymusráksa»viđá	thˈɑj#kˌil.li>i
thymusráksá+N+Der/heapmi+A+Comp+Sg+Com	thymusrávssá»habbu>in	thˈy.mus#rˌɑːkː.sɑ»vi.ðɑː
tieltá+Sem/Build+N+Sg+Ill	tieltá>i	thˈy.mus#rˌɑːβs.sɑː»hɑbː.pu>in
tilla+G3+N+Der/huvva+V+IV+Ger	tilla»huva>din	thˈĭelː.l̥tɑː>i
tinet+V+TV+Ind+Prt+Pl2	tini>idet	thˈilː.lɑː»hu.vɑ>din
titoisma+N+Sg+Ill	titoismi>i	thˈi.ni>i.deh
tivoli+Sem/Plc+N+Pl+Nom	tivoli>t	thˈiː.toj.smˌi>i
toaleahttaveasku+N+Ess	toaleahttaveasku>n	thˈi.vo.lˌi>h
toksiidna+N+Sg+Com+PxPl3	toksiinna>in>easet	thˈo.ɑ.lˌĕæhː.tɑ#vˌĕæsː.ku>n
totem+N+Ess	totem>in	thˈokː.sijn.nɑ>in>ĕæ.seh
toucheret+V+TV+Der/PassL+V+IV+Der/upmi+N+Pl+Nom+PxSg1	touchere»j»umi>id>an	thˈoː.tem>in
treddjo+Sem/Clth+N+Sg+Com+PxSg3	tredju>in>is	thˈouts.he.re»j»u.mi>id>ɑn
tremuleret+V+TV+Sup	tremulere>žit	trˈec.cu>in>is
trilogiija+N+Der/Dimin+N+Der/viđá+Adv	trilogiija»š»viđá	trˈe.mu.lˌe.re>žih
tsara+N+Der/laš+A+Sg+Ill	tsara»lažži>i	trˈi.lo.gˌij.jɑ»ʃ»#vˌi.ðɑː
tsunámi+N+Sg+Loc	tsunámi>s	tsˈɑ.rɑː»lɑdː.tʃi>i
tsára+N+Pl+Acc+PxSg2	tsára>id>at	tsˈu.nɑː.mˌi>s
tuberkulosa+N+Sg+Gen+PxDu1	tuberkulosa>me	tsˈɑː.rɑ>id>ɑh
tullehallat+V+IV+Ind+Prs+Du2	tullehalla>beahtti>	thˈuː.ber.hkˌu.lo.sɑ>me
tuollu+Sem/Org+Sem/Build+N+Der/Dimin+N+Der/viđá+Adv	tulo»š»viđá	thˈul.le.hɑl.lɑ>bĕæhː.ti>
tuollu+Sem/Org+Sem/Build+N+Sg+Nom+PxDu1	tullo>me	thˈu.lo»ʃ»#vˌi.ðɑː
tuvala+A+Attr	tuvala>	thˈul.lo>me
tyranniija+N+Sg+Ill	tyranniiji>i	thˈu.vɑː.lˌɑ>
tyranniseret+V+TV+Ind+Prt+Pl1	tyranniseri>imet	thˈy.rɑn.nˌij.ji>i
tákta+N+Sg+Ill+PxDu1	tákta>s>eame	thˈy.rɑn.nˌi.se.ri>i.meh
táksta+N+Pl+Com+PxDu2	távstta>id>eatteguin	thˈɑːkː.htɑ>s>ĕæ.me
tálga+N+Der/heapmi+A+Comp+Attr	tálgga»hat>	thˈɑːβs.tɑ>id>ĕæt.te.gujn
tára+N+Sg+Gen+PxDu3	tára>ska	thˈɑːlk.kɑ»hɑt>
távvaloahppu+N+Pl+Nom	távvaloahpu>t	thˈɑː.rɑ>skɑ
tøffa+A+Ess	tøffa>n	thˈɑːv.vɑl#ˌoɑh.pu>h
tøffa+A+Pl+Ill	tøffa>ide	thˈøf.fɑ>n
tøffa+A+Der/at+Adv	tøffa>t	thˈøf.fɑ>i.de
tøffa+A+Der/vuohta+N+Sg+Ill	tøffa>»»»vuhti>i	thˈøf.fɑ>h
tøffa+A+Sg+Ill	tøffi>i	thˈøf.fɑ>»»»#vˌuh.ti>i
ubmesápmelaš+Sem/Hum+N+Sg+Nom	ubmesápmelaš>	thˈøf.fi>i
ubmesápmi+Sem/Hum+N+Ess	ubmesápmi>n	ˈub.me#sˌɑːp.me.lɑʃ>
ubmisápmi+Sem/Hum+N+Sg+Nom	ubmisápmi>	ˈub.me#sˌɑːp.mi>n
udju+A+Der/at+Adv	ujo>t	ˈub.mi#sˌɑːp.mi>
udnu+N+Der/viđá+Adv	udno»viđá	ˈu.jo>h
udnu+N+Der/laš+A+Comp+Sg+Nom	utno»lit>	ˈud.no»vi.ðɑː
udnu+N+Pl+Ill+PxPl3	utnu>idasa>set	ˈut.no»lit>
ufiddinuššat+V+IV+Ger	ufiddinuša>din	ˈut.nu>i.dɑ.sɑ>seh
ufiddinuššat+V+IV+Der/st+V+Ind+Prs+ConNeg	ufiddinuša»s	ˈuː.fidː.tˌi.nu.ʃɑ>din
ugralaš+A+Sg+Nom	ugralaš>	ˈuː.fidː.tˌi.nu.ʃɑ»s
uitu+N+Der/heapmi+A+Ess	uittu»heapmi>n	ˈug.rɑː.lɑʃ>
ujusvuohta+N+Sg+Ill	ujusvuhti>i	ˈujç.tu»heæp.mi>n
uksa+N+Sg+Acc+PxPl1	uksa>met	ˈuː.jus.vˌuh.ti>i
uksu+N+Sg+Gen+PxPl1	ukso>met	ˈukː.sɑː>meh
uksaliidda+Adv+Sem/Plc+Comp	uksaliidda	ˈukː.so>meh
uksu+N+Sg+Acc+PxSg2	uvsso>t	ˈukː.sɑː.lijt.tɑ
uksu+N+Sg+Loc+PxPl3	uvssu>st>easet	ˈuβs.so>h
uminddet+A+Attr	uminddet>	ˈuβs.su>st>ĕæ.seh
umas+A+AttrCmp+Der/lágaš+A+Sg+Acc	umas>»»»»lágáž>a	ˈu#mˌint.tet>
ummolcizáš+Sem/Ani+N+Sg+Nom	ummolcizáš>	ˈu.mɑːs>»»»»#lˌɑː.gɑːž>ɑ
ummolcizáš+Sem/Ani+N+Sg+Acc	ummolcizáž>a	ˈum.mol#tsˌi.dsɑːʃ>
unjárgalaš+Sem/Hum+N+Sg+Ill+PxDu2	unjárgalažža>s>eatte	ˈum.mol#tsˌi.dsɑːž>ɑ
unjárgalaš+Sem/Hum+N+Sg+Ill	unjárgalažži>i	ˈu.ɲɑːr.gˌɑ.lɑdː.tʃɑ>s>ĕæt.te
unni+A+AttrCmp+Der/juvllat+Sem/Veh+A+Ess	una>»»»»juvllag>in	ˈu.ɲɑːr.gˌɑ.lɑdː.tʃi>i
unohas+A+Sg+Nom	unohas>	ˈu.nɑː>»»»»#jˌuβl.lɑg>in
upmolcizáš+Sem/Ani+N+Ess	upmolcizáž>in	ˈu.no.hˌɑs>
upmolguodja+N+Ess+PxSg1	upmolguodja>n>an	ˈup.mol#tsˌi.dsɑːž>in
uppá+N+Der/huhtti+V+TV+Ind+Prs+Du3	uppá»huhtti>ba	ˈup.mol#kˌuoc.cɑ>n>ɑn
uskánit+V+IV+Der/adda+V+Ind+Prs+Sg3	uskán»addá>	ˈupː.pɑː»huhː.ti>bɑ
usurperet+V+TV+Der/PassL+V+IV+Actio+Com	usurpere»juvvo>miin	ˈusː.kɑːn»ɑdː.tɑː>
utilisma+N+Der/laš+A+Sg+Nom	utilismma»laš>	ˈuː.sur.hpˌe.re»juv.vo>mijn
uvdna+N+Sg+Ill	uvdni>i	ˈu.ti.lˌis.mɑ»lɑʃ>
uvssamuš+A+Superl+Sg+Ill	uvssamužži>i	ˈuβː.tni>i
uđas+N+Sg+Nom	uđas>	ˈuβsː.sɑː.mudː.tʃi>i
uđas+N+Der/heapmi+A+Sg+Com	uđas>»hemi>in	ˈu.ðɑːs>
uđas+N+Sg+Loc	uđđas>is	ˈu.ðɑːs>»#hˌe.mi>in
uđámat+Sem/Ani+N+Der/geahtes+A+Attr	uđámat>»keahtes	ˈuðː.ðɑːs>is
uŋgáragiella+Sem/Lang+N+Sg+Ill	uŋgáragilli>i	ˈu.ðɑː.mˌɑt>»#khˌĕæh.tes
uŋgárgiella+Sem/Lang+N+Sg+Ill	uŋgárgilli>i	ˈuŋŋ.kɑː.rɑ#kˌil.li>i
uš+Interj	uš	ˈuŋŋ.kɑːr#kˌil.li>i
váikkuhangaskoapmegeavaheapmi+Sem/Act+N+Pl+Acc	gaskgaskaoapmegeavahemi>id	ˈuʃ
váikkuhangaskoapmegeavaheapmi+Sem/Act+N+Pl+Ill+PxDu3	gaskgaskaoapmegeavahemi>idasa>ska	kˈɑsk#kˌɑsː.kɑ#ˌŏɑp.me#kˌeæ.vɑ.hˌe.mi>id
váikkuhangaskoapmegeavaheapmi+Sem/Act+N+Pl+Nom+PxSg1	gaskgaskaoapmegeavahemi>id>an	kˈɑsk#kˌɑsː.kɑ#ˌŏɑp.me#kˌeæ.vɑ.hˌe.mi>i.dɑ.sɑ>skɑ
váikkuhangaskoapmegeavaheapmi+Sem/Act+N+Sg+Com	gaskgaskaoapmegeavahemi>in	kˈɑsk#kˌɑsː.kɑ#ˌŏɑp.me#kˌeæ.vɑ.hˌe.mi>id>ɑn
váikkuhangaskoapmegeavaheapmi+Sem/Act+N+Sg+Com+PxPl1	gaskgaskaoapmegeavahemi>in>eamet	kˈɑsk#kˌɑsː.kɑ#ˌŏɑp.me#kˌeæ.vɑ.hˌe.mi>in
váikkuhangaskoapmegeavaheapmi+Sem/Act+N+Pl+Nom	gaskgaskaoapmegeavaheami>t	kˈɑsk#kˌɑsː.kɑ#ˌŏɑp.me#kˌeæ.vɑ.hˌe.mi>in>ĕæ.meh
váikkuhangaskoapmegeavaheapmi+Sem/Act+N+Sg+Acc	gaskgaskaoapmegeavaheami>	kˈɑsk#kˌɑsː.kɑ#ˌŏɑp.me#kˌeæ.vɑ.hˌeæ.mi>h
váikkuhangaskoapmegeavaheapmi+Sem/Act+N+Sg+Nom	gaskgaskaoapmegeavaheapmi>	kˈɑsk#kˌɑsː.kɑ#ˌŏɑp.me#kˌeæ.vɑ.hˌeæ.mi>
váikkuhangaskoapmegeavaheapmi+Sem/Act+N+Sg+Acc+PxPl2	gaskgaskaoapmegeavaheamá>det	kˈɑsk#kˌɑsː.kɑ#ˌŏɑp.me#kˌeæ.vɑ.hˌeæp.mi>
váikkuhangaskoapmegeavaheapmi+Sem/Act+N+SgCmp+Der/viđá+Adv	gaskgaskaoapmegeavah»anviđá	kˈɑsk#kˌɑsː.kɑ#ˌŏɑp.me#kˌeæ.vɑ.hˌeæ.mɑː>deh
váikkuhangask'oapmegeavaheapmi+Sem/Act+N+Pl+Nom+PxPl1	gask'gaskaoapmegeavahemi>id>eamet	kˈɑsk#kˌɑsː.kɑ#ˌŏɑp.me#kˌeæ.vɑh»ɑn.vi.ðɑː
váikkuhangask'oapmegeavaheapmi+Sem/Act+N+Sg+Com+PxDu2	gask'gaskaoapmegeavahemi>in>eatte	kˈɑsk'#kˌɑsː.kɑ#ˌŏɑp.me#kˌeæ.vɑ.hˌe.mi>id>ĕæ.meh
váikkuhangask'oapmegeavaheapmi+Sem/Act+N+Sg+Com+PxSg3	gask'gaskaoapmegeavahemi>in>is	kˈɑsk'#kˌɑsː.kɑ#ˌŏɑp.me#kˌeæ.vɑ.hˌe.mi>in>ĕæt.te
váikkuhangask'oapmegeavaheapmi+Sem/Act+N+Ess	gask'gaskaoapmegeavaheapmi>n	kˈɑsk'#kˌɑsː.kɑ#ˌŏɑp.me#kˌeæ.vɑ.hˌe.mi>in>is
váikkuhangask'oapmegeavaheapmi+Sem/Act+N+Sg+Nom+PxPl3	gask'gaskaoapmegeavaheapmi>set	kˈɑsk'#kˌɑsː.kɑ#ˌŏɑp.me#kˌeæ.vɑ.hˌeæp.mi>n
váikkuhangask'oapmegeavaheapmi+Sem/Act+N+SgCmp+Der/viđá+Adv	gask'gaskaoapmegeavah»anviđá	kˈɑsk'#kˌɑsː.kɑ#ˌŏɑp.me#kˌeæ.vɑ.hˌeæp.mi>seh
vai+CC	vai	kˈɑsk'#kˌɑsː.kɑ#ˌŏɑp.me#kˌeæ.vɑh»ɑn.vi.ðɑː
vajus+N+Sg+Com+PxSg3	vadjos>iinni>s	vˈɑj
vakŋa+N+Ess+PxSg2	vakŋa>n>at	vˈɑc.cos>ijn.ni>s
vanas+N+Sg+Nom	vanas>	vˈɑkː.ŋɑː>n>ɑh
veardni+N+Sg+Com+PxPl1	vertni>in>eamet	vˈɑ.nɑːs>
veavva+N+Ess+PxDu2	veavva>n>eatte	vˈert.ni>in>ĕæ.meh
veažir+N+Der/geahtes+A+Attr	veažer>»geahtes	vˈeæv.vɑ>n>ĕæt.te
vegetašuvdna+N+Ess+PxDu2	vegetašuvdna>n>eatte	vˈĕæ.dʃer>»#kˌĕæh.tes
veháš+Pron+Indef+Sg+Nom	veháš>	vˈe.ge.tˌɑ.ʃuv.tnɑ>n>ĕæt.te
vejolaš+A+Der/vuohta+N+Sg+Ill	vejolaš»»»vuhti>i	vˈeː.hɑːʃ>
vesá+Sem/Plant+N+Der/viđá+Adv	vesa»viđá	vˈe.jo.lˌɑʃ»»»#vˌuh.ti>i
vevvel+N+Der/heapmi+A+Sg+Com	vevvel»hemi>in	vˈe.sɑː»vi.ðɑː
vevvet+V+TV+Ind+Prt+Pl1	vevvi>imet	vˈev.vel»#hˌe.mi>in
veđor+N+Der/Dimin+N+Sg+Nom	vehtor>»aš>	vˈev.vi>i.meh
veđor+N+Der/viđá+Adv	veđor»viđá	vˈeːh.tor>»ɑʃ>
vitnji+N+Pl+Com	vinji>iguin	vˈeː.ðor»#vˌi.ðɑː
vitnji+N+Der/Dimin+N+Der/viđá+Adv	vinjá»š»viđá	vˈinː.ji>i.gujn
voi+Interj	voi	vˈinː.jɑː»ʃ»#vˌi.ðɑː
vokalista+Sem/Hum+N+Sg+Ill	vokalisti>i	vˈoj
volumaivdni+N+Sg+Ill+PxDu3	volumaivdná>s>easkka	vˈo.kɑː.lˌisː.ti>i
vomeret+V+TV+Ind+Prt+Pl2	vomeri>idet	vˈo.lu.mˌɑ#ˌiβː.tnɑː>s>eæs.kɑ
vooi+Interj	vooi	vˈo.me.rˌi>i.deh
vuddjii+A+Der/vuohta+N+Sg+Ill	vuddje»»»vuhti>i	vˈo.oj
vuhpodit+V+TV+VAbess	vuhpot>keahttá	vˈuɟː.ce»»»#vˌuh.ti>i
vujohat+Sem/Plc+N+Der/Dimin+N+Sg+Ill	vujohaga»žii	vˈuːh.pot>#khˌĕæhː.tɑː
vujon+N+Sg+Ill+PxDu2	vujon>asa>de	vˈu.jo.hˌɑ.gɑ»žij
vuktii+A+Pl+Nom	vukte>t	vˈuː.jon>ɑ.sɑ>de
vulgäriseret+V+TV+Ind+Prt+Du3	vulgäriseri>iga	vˈukː.hte>h
vulobealde+Pr	vulobealde	vˈulə.kæ.ri.se.ri>i.gɑ
vulos+Adv	vulos	vˈu.lo#pˌĕælː.te
vustet+V+IV+Ind+Prt+Sg3	vusti>i	vˈuː.los
vuvdojupmái+Adv	vuvdojupmái	vˈusː.ti>i
vuvdot+V+IV+Ind+Prt+Du2	vuvdu>ide	vˈuβː.to.jupː.mɑːj
váfi+A+Der/viđá+Adv	váfi>»viđá	vˈuβː.tu>i.de
váguhit+V+TV+VGen	vágut>	vˈɑː.fi>»vi.ðɑː
váimmus+N+Pl+Nom	váibmos>at	vˈɑː.gut>
váiput+V+TV+Actio+Nom	váipu>n	vˈɑːj.pmos>ɑh
vánat+A+Pl+Nom	vánag>at	vˈɑːjː.çpu>n
vánis+A+Pl+Com	vátnás>iiguin	vˈɑː.nɑg>ɑh
várri+Sem/Plc+N+Sg+Gen+PxSg2	várá>t	vˈɑːt.nɑːs>ij.gujn
vátni+N+Sg+Acc+PxPl2	váná>det	vˈɑː.rɑː>h
váttis+A+Comp+Attr	váddás>at>	vˈɑː.nɑː>deh
vázzit+V+IV+Der/h+V+Der/easti+V+Ger	vácci»heastti>dettiin	vˈɑːdː.tɑːs>ɑt>
váđas+N+Pl+Nom	váhtas>at	vˈɑːt.tsi»heæs.ti>det.tijn
wagnerianisma+N+Der/viđá+Adv	wagnerianisma»viđá	vˈɑːh.tɑs>ɑh
wagnerianisma+N+Sg+Ill	wagnerianismi>i	βˈɑg.ne.ri.ɑ.nis.mɑ»vi.ðɑː
wagnerianisma+N+Sg+Acc+PxSg2	wagnerianismma>t	βˈɑg.ne.ri.ɑ.nis.mi>i
wagnerianisma+N+Sg+Gen+PxPl3	wagnerianismma>set	βˈɑg.ne.ri.ɑ.nis.mɑ>h
wagnerianisma+N+Sg+Loc+PxSg2	wagnerianismma>st>at	βˈɑg.ne.ri.ɑ.nis.mɑ>seh
webbáiki+Sem/Plc+N+Sg+Gen+PxDu1	webbáiká>me	βˈɑg.ne.ri.ɑ.nis.mɑ>st>ɑh
webbáiki+Sem/Plc+N+Sg+Gen+PxDu2	webbáikká>de	βˈeb#pˌɑːjː.çkɑː>me
webbáiki+Sem/Plc+N+Der/Dimin+N+Sg+Nom	webbáikká»š	βˈeb#pˌɑːjç.kɑː>de
webdoaimmaheaddji+Sem/Hum+N+NomAg+Sg+Com	webdoaimmaheddji>in	βˈeb#pˌɑːjç.kɑː»ʃ
webgálvu+N+Der/viđá+Adv	webgálvo»viđá	βˈeb.doɑjm.mɑ.heɟː.ci>in
webgálvu+N+Sg+Nom	webgálvu>	βˈeb#kˌɑːlə.vo»vi.ðɑː
webrámma+N+Der/huvva+V+IV+Sup	webrámma»huva>žit	βˈeb#kˌɑːlə.vu>
websiidu+N+Sg+Acc+PxSg3	websiiddu>s	βˈeb#rˌɑːm.mɑ»hu.vɑ>žih
websiidu+N+Sg+Loc+PxSg1	websiiddu>st>an	βˈeb#sˌijt.tu>s
websiidu+N+Der/heapmi+A+Pl+Ill	websiiddu»hemi>ide	βˈeb#sˌijt.tu>st>ɑn
whiskey+N+Sg+Loc	whiskey>s	βˈeb#sˌijt.tu»he.mi>i.de
whiskey+N+Sg+Loc+PxSg2	whiskey>st>at	βhˈisː.ke.y>s
whiskey+N+Der/heapmi+A+Comp+Attr	whiskey>»hut>	βhˈisː.ke.y>st>ɑh
wienergáhkku+Sem/Food+N+Der/huhtti+V+TV+VAbess+A+Attr	wienergáhko»huhte>keahtes	βhˈisː.ke.y>»hut>
wienerklassisisma+N+Sg+Ill	wienerklassisismi>i	βˈĭe.ner#kˌɑːh.ko»huh.te>kĕæh.tes
wienerklassisisma+N+Pl+Nom	wienerklassisismma>t	βˈĭe.ner#klˌɑs.si.sisː.mi>i
wienerválsa+N+Sg+Ill	wienerválsi>i	βˈĭe.ner#klˌɑs.si.sis.mɑ>h
wienerválsa+N+Sg+Loc+PxPl2	wienerválssa>st>eattet	βˈĭe.ner#vˌɑːlə.si>i
wienerválsa+N+Der/huvva+V+IV+Pot+Prs+Sg3	wienerválssa»huva>š	βˈĭe.ner#vˌɑːls.sɑ>st>ĕæt.teh
woaw+Interj	woaw	βˈĭe.ner#vˌɑːls.sɑ»hu.vɑ>ʃ
wátta+N+Der/Dimin+N+Pl+Nom	wátta»žat	βˈoɑβ
wátta+N+Der/viđá+Adv	wátta»viđá	βˈɑːt.tɑ»žɑh
wátta+N+Sg+Ill	wátti>i	βˈɑːt.tɑ»vi.ðɑː
xantoma+N+Der/Dimin+N+Der/viđá+Adv	xantoma»š»viđá	βˈɑːt.ti>i
xantoma+N+Der/viđá+Adv	xantoma»viđá	ks.ɑnː.n̥to.mɑ»ʃ»#vˌi.ðɑː
xantoma+N+Sg+Ill	xantomi>i	ks.ɑnː.n̥to.mɑ»vi.ðɑː
xerograferet+V+TV+Cond+Prs+Sg3	xerografere>šii	ks.ɑnː.n̥to.mi>i
xerograferet+V+TV+Der/PassL+V+IV+Actio+Com	xerografere»juvvo>miin	ks.e.ro.grɑ.fe.re>ʃij
xerograferet+V+TV+Ind+Prt+Du1	xerograferi>ime	ks.e.ro.grɑ.fe.re»juv.vo>mijn
xerograferet+V+TV+Ind+Prt+Du3	xerograferi>iga	ks.e.ro.grɑ.fe.ri>i.me
xerografiija+N+Der/huhtti+V+TV+VGen	xerografiija»huhti>	ks.e.ro.grɑ.fe.ri>i.gɑ
xerografiija+N+Sg+Ill	xerografiiji>i	ks.e.ro.grɑ.fij.jɑ»huh.ti>
xerográfa+N+Der/huhtti+V+TV+Cond+Prs+Sg1	xerográfa»huhtá>lin	ks.e.ro.grɑ.fij.ji>i
xerográfa+N+Der/laš+A+Ess	xerográfa»lažža>n	ks.e.ro.grɑː.fɑ»huhː.tɑː>lin
xerográfa+N+Der/viđá+Adv	xerográfa»viđá	ks.e.ro.grɑː.fɑ»lɑdː.tʃɑ>n
xerográfa+N+Sg+Ill	xerográfi>i	ks.e.ro.grɑː.fɑ»vi.ðɑː
xylograferet+V+TV+Pot+Prs+Sg3	xylografere>š	ks.e.ro.grɑː.fi>i
xylograferet+V+TV+VGen	xylografere>	ks.y.lo.grɑ.fe.re>ʃ
xylograferet+V+TV+Der/halla+V+VAbess	xylografere»hala>keahttá	ks.y.lo.grɑ.fe.re>
xylograferet+V+TV+Der/PassL+V+IV+Actio+Nom	xylografere»juvvo>n	ks.y.lo.grɑ.fe.re»hɑ.lɑ>kĕæhː.tɑː
xylograferet+V+TV+Ind+Prt+Du1	xylograferi>ime	ks.y.lo.grɑ.fe.re»juv.vo>n
xylograferet+V+TV+Ind+Prt+Du2	xylograferi>ide	ks.y.lo.grɑ.fe.ri>i.me
xylograferet+V+TV+Ind+Prt+Du3	xylograferi>iga	ks.y.lo.grɑ.fe.ri>i.de
xylograferet+V+TV+Ind+Prt+Sg3	xylograferi>i	ks.y.lo.grɑ.fe.ri>i.gɑ
xylografiija+N+Der/huhtti+V+TV+Cond+Prs+Sg1	xylografiija»huhtá>šedje>n	ks.y.lo.grɑ.fe.ri>i
xylografiija+N+Der/huvva+V+IV+Imprt+Pl2	xylografiija»huvvi>t	ks.y.lo.grɑ.fij.jɑ»huhː.tɑː>ʃec.ce>n
xylografiija+N+Sg+Ill	xylografiiji>i	ks.y.lo.grɑ.fij.jɑ»huv.vi>h
yeh+Interj	yeh	ks.y.lo.grɑ.fij.ji>i
yena+N+Pl+Loc	yena>in	ˈyeh
yena+N+Sg+Ill+PxSg3	yena>s>is	ˈye.nɑ>in
yena+N+Der/Dimin+N+Sg+Acc	yena»ža	ˈye.nɑ>s>is
yena+N+Der/huhtti+V+TV+Ger	yena»huhte>din	ˈye.nɑ»žɑ
yena+N+Der/huhtti+V+TV+VAbess+A+Attr	yena»huhte>keahtes	ˈye.nɑ»huh.te>din
yena+N+Der/huhtti+V+TV+VAbess	yena»huhti>haga	ˈye.nɑ»huh.te>kĕæh.tes
yena+N+Sg+Ill	yeni>i	ˈye.nɑ»huh.ti>hɑ.gɑ
yoghurt+N+Ess	yoghurt>in	ˈye.ni>i
yoghurt+N+Sg+Acc+PxPl3	yoghurt>easet	ˈyog.hurt>in
yoghurt+N+Sg+Nom+PxPl3	yoghurt>easet	ˈyog.hurt>ĕæ.seh
yoghurt+N+Der/geahtes+A+Attr	yoghurt»geahtes	ˈyog.hurt>ĕæ.seh
yoghurt+N+Der/laš+A+Comp+Ess	yoghurt»laččabun	ˈyog.hurt»#kˌĕæh.tes
yoghurt+N+Der/laš+A+Sg+Ill	yoghurt»lažžii	ˈyog.hurt»#lˌɑt.tʃɑ.bun
yoghurt+N+Der/viđá+Adv	yoghurt»viđá	ˈyog.hurt»#lˌɑdː.tʃij
yupikgielat+A+Ess	yupikgielag>in	ˈyog.hurt»#vˌi.ðɑː
yupikgielat+A+Sg+Acc	yupikgielag>a	ˈyu.pik#kˌie.lɑg>in
yupikgielat+A+Attr	yupikgielat>	ˈyu.pik#kˌie.lɑg>ɑ
yup’ik+N+Sg+Nom	yup’ik>	ˈyu.pik#kˌie.lɑt>
yup’ik+N+Ess+PxSg2	yup’ika>n>at	ˈyup’ik>
yup’ik+N+Sg+Ill	yup’iki>i	ˈyup’i.kɑ>n>ɑh
yurta+N+Der/viđá+Adv	yurta»viđá	ˈyup’i.ki>i
yurta+N+Sg+Ill	yurti>i	ˈyurə.htɑ»vi.ðɑː
yurtadealtá+Sem/Build+N+Sg+Ill	yurtadealtá>i	ˈyurə.hti>i
yurta+N+Pl+Loc+PxPl1	yurtta>in>eamet	ˈyurə.htɑ#tˌĕælː.l̥tɑː>i
yurta+N+Der/huhtti+V+TV+Ger	yurtta»huhti>dettiin	ˈyurr̥.tɑ>in>ĕæ.meh
zapatista+Sem/Hum+N+Sg+Acc+PxDu1	zapatista>me	ˈyurr̥.tɑ»huh.ti>det.tijn
zapatista+Sem/Hum+N+Sg+Ill+PxPl1	zapatista>s>eamet	zˈɑ.pɑː.tˌisː.tɑ>me
zapatista+Sem/Hum+N+Der/viđá+Adv	zapatista»viđá	zˈɑ.pɑː.tˌisː.tɑ>s>ĕæ.meh
zapatista+Sem/Hum+N+Sg+Ill	zapatisti>i	zˈɑ.pɑː.tˌisː.tɑ»vi.ðɑː
zapatistaveahka+Sem/Hum+Sem/Group+N+Sg+Ill	zapatistavehki>i	zˈɑ.pɑː.tˌisː.ti>i
zapatistaveahka+Sem/Hum+Sem/Group+N+Der/viđá+Adv	zapatistaveahka»viđá	zˈɑ.pɑː.tˌisː.tɑ#vˌeh.ki>i
zapatista+Sem/Hum+N+Pl+Acc	zapatistta>id	zˈɑ.pɑː.tˌisː.tɑ#vˌeæh.kɑ»vi.ðɑː
zapatista+Sem/Hum+N+Sg+Gen+PxPl3	zapatistta>set	zˈɑ.pɑː.tˌis.tɑ>id
zapatista+Sem/Hum+N+Sg+Com+PxPl1	zapatistta>in>eamet	zˈɑ.pɑː.tˌis.tɑ>seh
zapatista+Sem/Hum+N+Der/Dimin+N+Sg+Acc	zapatistta»ža	zˈɑ.pɑː.tˌis.tɑ>in>ĕæ.meh
zapatista+Sem/Hum+N+Der/heapmi+A+Sg+Com	zapatistta»hemi>in	zˈɑ.pɑː.tˌis.tɑ»žɑ
zenbuddhisma+N+Ess	zenbuddhisma>n	zˈɑ.pɑː.tˌis.tɑ»he.mi>in
zenbuddhisma+N+Sg+Ill+PxDu2	zenbuddhisma>s>eatte	zˈen#pˌud.dhis.mɑ>n
zenbuddhisma+N+Sg+Ill+PxPl1	zenbuddhisma>s>eamet	zˈen#pˌud.dhis.mɑ>s>ĕæt.te
zenbuddhisma+N+Der/viđá+Adv	zenbuddhisma»viđá	zˈen#pˌud.dhis.mɑ>s>ĕæ.meh
zenbuddhisma+N+Sg+Ill	zenbuddhismi>i	zˈen#pˌud.dhis.mɑ»vi.ðɑː
zenbuddhisma+N+Pl+Gen+PxDu3	zenbuddhismma>id>easkka	zˈen#pˌud.dhis.mi>i
zenbuddhisma+N+Pl+Nom	zenbuddhismma>t	zˈen#pˌud.dhis.mɑ>id>eæs.kɑ
zenbuddhisma+N+Sg+Gen+PxPl3	zenbuddhismma>set	zˈen#pˌud.dhis.mɑ>h
zenbuddhisma+N+Der/heapmi+A+Sg+Com	zenbuddhismma»hemi>in	zˈen#pˌud.dhis.mɑ>seh
zenbuddhisma+N+Der/huhtti+V+TV+Imprt+Pl2	zenbuddhismma»huhtte>t	zˈen#pˌud.dhis.mɑ»he.mi>in
zenbuddhista+Sem/Hum+N+Der/viđá+Adv	zenbuddhista»viđá	zˈen#pˌud.dhis.mɑ»huhː.te>h
zenbuddhista+Sem/Hum+N+Sg+Ill	zenbuddhisti>i	zˈen#pˌud.dhis.tɑ»vi.ðɑː
zenbuddhista+Sem/Hum+N+Der/huvva+V+IV+Actio+Ess	zenbuddhistta»huvva>me	zˈen#pˌud.dhis.ti>i
zoologa+Sem/Hum+N+Der/huhtti+V+TV+Sup	zoologa»huhtá>žit	zˈen#pˌud.dhis.tɑ»huv.vɑ>me
zoologa+Sem/Hum+N+Sg+Ill	zoologi>i	zˈo.o.lˌo.gɑ»huhː.tɑː>žih
zoologiija+N+Pl+Nom	zoologiija>t	zˈo.o.lˌo.gi>i
zoologiija+N+Sg+Nom+PxSg3	zoologiija>>s	zˈo.o.lˌo.gij.jɑ>h
zoologiija+N+Der/Dimin+N+Der/viđá+Adv	zoologiija»š»viđá	zˈo.o.lˌo.gij.jɑ>>s
zoologiija+N+Der/huhtti+V+TV+Sup	zoologiija»huhtá>žit	zˈo.o.lˌo.gij.jɑ»ʃ»#vˌi.ðɑː
zoologiija+N+Sg+Ill	zoologiiji>i	zˈo.o.lˌo.gij.jɑ»huhː.tɑː>žih
Ándenbeaivahkku+Sem/Time+N+Sg+Acc+PxPl2	Ándenbeaivahko>det	zˈo.o.lˌo.gij.ji>i
Ándenbeaivahkku+Sem/Time+N+Sg+Gen+PxPl2	Ándenbeaivahko>det	ˈɑːnː.ten#pˌeæj#vˌɑh.ko>deh
Ándenbeaivahkku+Sem/Time+N+Sg+Gen+PxSg2	Ándenbeaivahko>t	ˈɑːnː.ten#pˌeæj#vˌɑh.ko>deh
Ándenbeaivahkku+Sem/Time+N+Der/Dimin+N+Sg+Nom	Ándenbeaivahko»š	ˈɑːnː.ten#pˌeæj#vˌɑh.ko>h
Ándenbeaivahkku+Sem/Time+N+Der/Dimin+N+Der/viđá+Adv	Ándenbeaivahko»š»viđá	ˈɑːnː.ten#pˌeæj#vˌɑh.ko»ʃ
Ándenbeaivahkku+Sem/Time+N+Pl+Gen	Ándenbeaivahku>id	ˈɑːnː.ten#pˌeæj#vˌɑh.ko»ʃ»#vˌi.ðɑː
Ándenbeaivahkku+Sem/Time+N+Pl+Nom	Ándenbeaivahku>t	ˈɑːnː.ten#pˌeæj#vˌɑh.ku>id
Ándenbeaivahkku+Sem/Time+N+Sg+Loc+PxDu3	Ándenbeaivahku>st>easkka	ˈɑːnː.ten#pˌeæj#vˌɑh.ku>h
Ándenbeaivahkku+Sem/Time+N+Der/heapmi+A+Comp+Sg+Nom	Ándenbeaivahku»hut>	ˈɑːnː.ten#pˌeæj#vˌɑh.ku>st>eæs.kɑ
Ándenbeaivahkku+Sem/Time+N+Der/huhtti+V+TV+Ind+Prs+Du1	Ándenbeaivahku»huhtte>	ˈɑːnː.ten#pˌeæj#vˌɑh.ku»hut>
Ándenbeaivahkku+Sem/Time+N+Der/huhtti+V+TV+Der/PassS+V+IV+Ger	Ándenbeaivahku»huhtto>»>din	ˈɑːnː.ten#pˌeæj#vˌɑh.ku»huhː.te>
Ándenbeaivahkku+Sem/Time+N+Der/huvva+V+IV+VAbess	Ándenbeaivahku»huva>haga	ˈɑːnː.ten#pˌeæj#vˌɑh.ku»huhː.to>»>din
Ándenbeaivahkku+Sem/Time+N+Sg+Nom+PxDu2	Ándenbeaivahkko>de	ˈɑːnː.ten#pˌeæj#vˌɑh.ku»hu.vɑ>hɑ.gɑ
Ándenbeaivahkku+Sem/Time+N+Sg+Nom+PxPl1	Ándenbeaivahkko>met	ˈɑːnː.ten#pˌeæj#vˌɑhː.ko>de
Ándenbeaivahkku+Sem/Time+N+Sg+Nom+PxSg2	Ándenbeaivahkko>t	ˈɑːnː.ten#pˌeæj#vˌɑhː.ko>meh
Ándenbeaivahkku+Sem/Time+N+Der/viđá+Adv	Ándenbeaivahkko»viđá	ˈɑːnː.ten#pˌeæj#vˌɑhː.ko>h
Ándenbeaivahkku+Sem/Time+N+Ess	Ándenbeaivahkku>n	ˈɑːnː.ten#pˌeæj#vˌɑhː.ko»vi.ðɑː
Ándenbeaivahkku+Sem/Time+N+Ess+PxSg3	Ándenbeaivahkku>n>is	ˈɑːnː.ten#pˌeæj#vˌɑhː.ku>n
Ándenbeaivahkku+Sem/Time+N+Pl+Nom	Ándenbeaivahkku>t	ˈɑːnː.ten#pˌeæj#vˌɑhː.ku>n>is
Ándenbeaivahkku+Sem/Time+N+Pl+Com	Ándenbeaivahkku>iguin	ˈɑːnː.ten#pˌeæj#vˌɑhː.ku>h
Ándenbeaivahkku+Sem/Time+N+Pl+Nom+PxDu1	Ándenbeaivahkku>id>eame	ˈɑːnː.ten#pˌeæj#vˌɑhː.ku>i.gujn
Ándenbeaivahkku+Sem/Time+N+Sg+Gen+PxDu3	Ándenbeaivahkku>ska	ˈɑːnː.ten#pˌeæj#vˌɑhː.ku>id>ĕæ.me
Ándenbeaivahkku+Sem/Time+N+Sg+Nom	Ándenbeaivahkku>	ˈɑːnː.ten#pˌeæj#vˌɑhː.ku>skɑ
Ándenbeaivahkku+Sem/Time+N+Sg+Com+PxDu1	Ándenbeaivahkku>in>eame	ˈɑːnː.ten#pˌeæj#vˌɑhː.ku>
Ánnávahkku+Sem/Time+N+Sg+Gen+PxPl2	Ánnávahko>det	ˈɑːnː.ten#pˌeæj#vˌɑhː.ku>in>ĕæ.me
Ánnávahkku+Sem/Time+N+Sg+Gen+PxSg2	Ánnávahko>t	ˈɑːn.nɑː#vˌɑh.ko>deh
Ánnávahkku+Sem/Time+N+Der/laš+A+Der/vuohta+N+Sg+Gen	Ánnávahko»laš»»»vuođa>	ˈɑːn.nɑː#vˌɑh.ko>h
Ánnávahkku+Sem/Time+N+Pl+Ill+PxPl1	Ánnávahku>idasa>met	ˈɑːn.nɑː#vˌɑh.ko»lɑʃ»»»#vˌuo.ðɑ>
Ánnávahkku+Sem/Time+N+Sg+Gen+PxPl2	Ánnávahkko>det	ˈɑːn.nɑː#vˌɑh.ku>i.dɑ.sɑ>meh
Ánnávahkku+Sem/Time+N+Der/huhtti+V+TV+Cond+Prs+Pl3	Ánnávahkko»huhtá>še	ˈɑːn.nɑː#vˌɑhː.ko>deh
Ánnávahkku+Sem/Time+N+Der/viđá+Adv	Ánnávahkko»viđá	ˈɑːn.nɑː#vˌɑhː.ko»huhː.tɑː>ʃe
Ánnávahkku+Sem/Time+N+Ess	Ánnávahkku>n	ˈɑːn.nɑː#vˌɑhː.ko»vi.ðɑː
Ánnávahkku+Sem/Time+N+Ess+PxPl2	Ánnávahkku>n>eattet	ˈɑːn.nɑː#vˌɑhː.ku>n
Ánnávahkku+Sem/Time+N+Pl+Com+PxDu3	Ánnávahkku>id>easkkaguin	ˈɑːn.nɑː#vˌɑhː.ku>n>ĕæt.teh
Ánnávahkku+Sem/Time+N+Sg+Loc	Ánnávahkku>s	ˈɑːn.nɑː#vˌɑhː.ku>id>eæs.kɑ.gujn
áviisavalljivuohta+N+Sg+Ill	aviisavalljivuhti>i	ˈɑːn.nɑː#vˌɑhː.ku>s
áviisavalljivuohta+N+Pl+Acc+PxDu1	aviisavalljivuođa>id>eame	ˈɑ.vij.sˌɑ#vˌɑʎː.ʎi.vuh.ti>i
áviisavalljivuohta+N+Pl+Acc+PxPl2	aviisavalljivuođa>id>eattet	ˈɑ.vij.sˌɑ#vˌɑʎː.ʎi.vuo.ðɑ>id>ĕæ.me
áviisavalljivuohta+N+Pl+Com	aviisavalljivuođa>iguin	ˈɑ.vij.sˌɑ#vˌɑʎː.ʎi.vuo.ðɑ>id>ĕæt.teh
áviisavalljivuohta+N+Pl+Nom+PxSg1	aviisavalljivuođa>id>an	ˈɑ.vij.sˌɑ#vˌɑʎː.ʎi.vuo.ðɑ>i.gujn
áviisavalljivuohta+N+Pl+Nom	aviisavalljivuođa>t	ˈɑ.vij.sˌɑ#vˌɑʎː.ʎi.vuo.ðɑ>id>ɑn
áviisavalljivuohta+N+Sg+Gen+PxSg3	aviisavalljivuođa>s	ˈɑ.vij.sˌɑ#vˌɑʎː.ʎi.vuo.ðɑ>h
áviisavalljivuohta+N+Sg+Gen	aviisavalljivuođa>	ˈɑ.vij.sˌɑ#vˌɑʎː.ʎi.vuo.ðɑ>s
áviisavalljivuohta+N+Sg+Loc	aviisavalljivuođa>s	ˈɑ.vij.sˌɑ#vˌɑʎː.ʎi.vuo.ðɑ>
áviisavalljivuohta+N+Ess	aviisavalljivuohta>n	ˈɑ.vij.sˌɑ#vˌɑʎː.ʎi.vuo.ðɑ>s
áviisavalljivuohta+N+Ess+PxPl1	aviisavalljivuohta>n>eamet	ˈɑ.vij.sˌɑ#vˌɑʎː.ʎi.vuoh.tɑ>n
áviisavalljivuohta+N+Ess+PxSg2	aviisavalljivuohta>n>at	ˈɑ.vij.sˌɑ#vˌɑʎː.ʎi.vuoh.tɑ>n>ĕæ.meh
áviisavalljivuohta+N+Sg+Ill+PxDu3	aviisavalljivuohta>s>easkka	ˈɑ.vij.sˌɑ#vˌɑʎː.ʎi.vuoh.tɑ>n>ɑh
áviisavalljivuohta+N+Sg+Ill+PxSg3	aviisavalljivuohta>s>is	ˈɑ.vij.sˌɑ#vˌɑʎː.ʎi.vuoh.tɑ>s>eæs.kɑ
ábit+N+Der/Dimin+N+Pl+Nom	ábá»žat	ˈɑ.vij.sˌɑ#vˌɑʎː.ʎi.vuoh.tɑ>s>is
ábbasit+V+IV+Ind+Prt+ConNeg	ábbas>an	ˈɑː.bɑː»žɑh
ábas+A+Sg+Acc	áhpas>a	ˈɑːbː.pɑs>ɑn
ábas+A+Superl+Ess	áhpas>amos>in	ˈɑːh.pɑs>ɑ
ábbut+V+IV+Der/h+V+Der/adda+V+Ind+Prs+Sg3	áppu»haddá>	ˈɑːh.pɑs>ɑ.mos>in
ádreassa+G3+Sem/Clth+N+Sg+Ill	ádressi>i	ˈɑːp.pu»hɑdː.tɑː>
ádreassa+G3+Sem/Clth+N+Der/huvva+V+IV+Imprt+Pl2	ádreassa»huvvi>t	ˈɑː.dres.sˌi>i
ádjinmearrádus+N+Sg+Nom	ádjinmearrádus>	ˈɑː.dreæs.sˌɑ»huv.vi>h
áfi+N+Der/viđá+Adv	áfe»viđá	ˈɑːc.cin#mˌeær.rɑː.dus>
ágga+N+Sg+Ill	ággi>i	ˈɑː.fe»vi.ðɑː
ágga+N+Der/huhtti+V+TV+Ger	ákka»huhti>din	ˈɑːgː.ki>i
ággi+N+Sg+Gen+Allegro	ákke>	ˈɑːk.kɑ»huh.ti>din
áhcut+V+TV+Der/NomAg+N+Der/viđá+Adv	áhccu>»»viđá	ˈɑːk.ke>
áibba+Adv	áibba	ˈɑhː.tsu>»»vi.ðɑː
áimmahuššat+V+TV+Pot+Prs+Pl2	áimmahuša>žehpe>t	ˈɑːjp.pɑ
áirolieđbmá+N+Ess+PxDu3	áirolieđbmá>n>easkka	ˈɑːjm.mɑ.hu.ʃɑ>žeh.pe>h
ája+Sem/Plc+N+Der/viđá+Adv	ája>»viđá	ˈɑːjː.ro#lˌĭeðə.pmɑː>n>eæs.kɑ
ájihit+V+TV+Der/adda+V+VAbess	ájáh»atta>haga	ˈɑː.jɑ>»vi.ðɑː
ákkis+N+Sg+Gen	ággás>a	ˈɑː.jɑːh»ɑt.tɑ>hɑ.gɑ
áksi+N+Der/viđá+Adv	ákse»viđá	ˈɑːgː.kɑːs>ɑ
áktet+V+TV+Ind+Prt+Sg3	ákti>i	ˈɑːkː.se»vi.ðɑː
áksi+N+Sg+Gen+Allegro	ávsse>	ˈɑːkː.hti>i
álus+N+Der/heapmi+A+Attr+Der/vuohta+N+Sg+Gen+PxSg1	álus>»his>»»»vuohta>n	ˈɑːβs.se>
ánjis+N+Sg+Nom	ánjis>	ˈɑː.lus>»#hˌis>»»»#vˌuoh.tɑ>n
ánsu+N+Sg+Ill	ánsu>i	ˈɑːnː.jis>
ánjis+N+Sg+Gen+PxPl3	átnjás>easet	ˈɑːnː.su>i
ánjis+N+Sg+Acc	átnjás>a	ˈɑːt.ɲɑːs>ĕæ.seh
ánjis+N+Sg+Gen	átnjás>a	ˈɑːt.ɲɑːs>ɑ
ánjis+N+Der/Dimin+N+Sg+Ill	átnjás>»ažži>i	ˈɑːt.ɲɑːs>ɑ
ápmil+N+Der/geahtes+A+Attr	ápmel>»geahtes	ˈɑːt.ɲɑːs>»ɑdː.tʃi>i
ápril+Sem/Time+N+Der/Dimin+N+Ess+PxPl1	ápril»ažža>n>eamet	ˈɑːp.mel>»#kˌĕæh.tes
ássat+V+IV+Der/st+V+Der/alla+V+Ger+PxPl3	ása»stala>dettiin>easet	ˈɑːp.ril»ɑdː.tʃɑ>n>ĕæ.meh
ávvu+N+Sg+Gen+PxSg2	ávo>t	ˈɑː.sɑ»stɑ.lɑ>det.tijn>ĕæ.seh
áđga+N+Sg+Ill	áđgi>i	ˈɑː.vo>h
áđga+N+Pl+Com+PxPl2	áđgga>id>eattetguin	ˈɑːðə.ki>i
áđđet+V+TV+Ind+Prt+Du3	áđđi>iga	ˈɑːðk.kɑ>id>ĕæt.tet.gujn
áŧesmielalaš+A+Sg+Gen	áŧismielalačča>	ˈɑːð.ði>i.gɑ
ødema+N+Sg+Gen	ødema>	ˈɑː.θis#mˌie.lɑ.lˌɑt.tʃɑ>
ødema+N+Der/Dimin+N+Sg+Acc+PxSg3	ødema»žis	ˈø.de.mˌɑ>
ødema+N+Der/Dimin+N+Sg+Gen	ødema»ža	ˈø.de.mˌɑ»žis
ødema+N+Der/huhtti+V+TV+Ger	ødema»huhte>din	ˈø.de.mˌɑ»žɑ
ødema+N+Der/viđá+Adv	ødema»viđá	ˈø.de.mˌɑ»huh.te>din
ødema+N+Sg+Ill	ødemi>i	ˈø.de.mˌɑ»vi.ðɑː
økonomiseret+V+TV+Cond+Prs+Sg2	økonomisere>ledje>t	ˈø.de.mˌi>i
økonomiseret+V+TV+Der/d+V+Ind+Prt+ConNeg	økonomisere»dan	ˈø.ko.nˌo.mi.sˌe.re>lec.ce>h
økonomiseret+V+TV+Der/st+V+Ind+Prs+ConNeg	økonomisere»s	ˈø.ko.nˌo.mi.sˌe.re»dɑn
økonomiseret+V+TV+Der/PassL+V+IV+Actio+Ess	økonomisere»juvvo>min	ˈø.ko.nˌo.mi.sˌe.re»s
økonomiseret+V+TV+Der/PassL+V+IV+Actio+Loc	økonomisere»juvvo>mis	ˈø.ko.nˌo.mi.sˌe.re»juv.vo>min
økonomiseret+V+TV+Der/PassL+V+IV+Der/upmi+N+Ess	økonomisere»j»upmi>n	ˈø.ko.nˌo.mi.sˌe.re»juv.vo>mis
økonomiseret+V+TV+Ind+Prt+Du1	økonomiseri>ime	ˈø.ko.nˌo.mi.sˌe.re»j»up.mi>n
økonomiseret+V+TV+Ind+Prt+Du2	økonomiseri>ide	ˈø.ko.nˌo.mi.sˌe.ri>i.me
økonomiseret+V+TV+Ind+Prt+Du3	økonomiseri>iga	ˈø.ko.nˌo.mi.sˌe.ri>i.de
økonomiseret+V+TV+Ind+Prt+Pl1	økonomiseri>imet	ˈø.ko.nˌo.mi.sˌe.ri>i.gɑ
østrogena+N+Der/huhtti+V+TV+Ind+Prs+Pl3	østrogena»huhtte>t	ˈø.ko.nˌo.mi.sˌe.ri>i.meh
østrogena+N+Der/laš+A+Der/vuohta+N+Pl+Nom	østrogena»laš»»»vuođa>t	ˈøst.ro.ge.nɑ»huhː.te>h
østrogena+N+Sg+Ill	østrogeni>i	ˈøst.ro.ge.nɑ»lɑʃ»»»#vˌuo.ðɑ>h
čalmmustahttit+V+TV+Imprt+ConNeg	calmmustahte>	ˈøst.ro.ge.ni>i
čalmmustahttit+V+TV+Imprt+Sg2	calmmustahte>	tsˈɑlmː.mus.tɑh.te>
čalmmustahttit+V+TV+Ind+Prs+ConNeg	calmmustahte>	tsˈɑlmː.mus.tɑh.te>
čalmmustahttit+V+TV+Pot+Prs+ConNeg	calmmustahte>š	tsˈɑlmː.mus.tɑh.te>
čalmmustahttit+V+TV+Pot+Prs+Sg3	calmmustahte>š	tsˈɑlmː.mus.tɑh.te>ʃ
čalmmustahttit+V+TV+VAbess	calmmustahte>haga	tsˈɑlmː.mus.tɑh.te>ʃ
čalmmustahttit+V+TV+VAbess+A+Attr	calmmustahte>keahtes	tsˈɑlmː.mus.tɑh.te>hɑ.gɑ
čalmmustahttit+V+TV+Ger	calmmustahti>din	tsˈɑlmː.mus.tɑh.te>kĕæh.tes
čalmmustahttit+V+TV+Ind+Prt+Du2	calmmustahti>ide	tsˈɑlmː.mus.tɑh.ti>din
čalmmustahttit+V+TV+Ind+Prt+Pl1	calmmustahti>imet	tsˈɑlmː.mus.tɑh.ti>i.de
čalmmustahttit+V+TV+VAbess	calmmustahti>haga	tsˈɑlmː.mus.tɑh.ti>i.meh
čalmmustahttit+V+TV+VAbess	calmmustahti>keahttájin	tsˈɑlmː.mus.tɑh.ti>hɑ.gɑ
čalmmustahttit+V+TV+VGen	calmmustahti>	tsˈɑlmː.mus.tɑh.ti>kĕæhː.tɑː.jin
čalmmustahttit+V+TV+Ind+Prs+Sg1	calmmustahtá>n	tsˈɑlmː.mus.tɑh.ti>
čalmmustahttit+V+TV+Sup	calmmustahtá>žit	tsˈɑlmː.mus.tɑhː.tɑː>n
čalmmustahttit+V+TV+Imprt+Pl2	calmmustahtte>t	tsˈɑlmː.mus.tɑhː.tɑː>žih
čalmmustahttit+V+TV+Ind+Prt+Pl3	calmmustahtte>	tsˈɑlmː.mus.tɑhː.te>h
čalmmustahttit+V+TV+Actio+Nom	calmmustahtti>n	tsˈɑlmː.mus.tɑhː.te>
čalmmustahttit+V+TV+Imprt+Pl2	calmmustahtti>t	tsˈɑlmː.mus.tɑhː.ti>n
čalmmustahttit+V+TV+Ind+Prs+Du2	calmmustahtti>beahtti>	tsˈɑlmː.mus.tɑhː.ti>h
čalmmustahttit+V+TV+ConNegII	calmmustahtto>	tsˈɑlmː.mus.tɑhː.ti>bĕæhː.ti>
čalmmustahttit+V+TV+Der/PassS+V+IV+Der/muš+N+Der/viđá+Adv	calmmustahtto>»mošš»viđá	tsˈɑlmː.mus.tɑhː.to>
čalmmustahttit+V+TV+Der/PassL+V+IV+Der/supmi+N+Sg+Ill	calmmustahtto>»supmái	tsˈɑlmː.mus.tɑhː.to>»moʃː»#vˌi.ðɑː
čalmmustahttit+V+TV+Imprt+Du1	calmmustahttu>	tsˈɑlmː.mus.tɑhː.to>»supː.mɑːj
čalmmustahttit+V+TV+Der/NomAg+N+Sg+Acc+PxDu2	calmmustahttá>»de	tsˈɑlmː.mus.tɑhː.tu>
čalmmustahttit+V+TV+Der/NomAg+N+Sg+Ill	calmmustahttá>»i	tsˈɑlmː.mus.tɑhː.tɑː>»de
čaločoarvi+Sem/Ani+N+Pl+Com+PxPl1	čaločorvvi>id>eametguin	tsˈɑlmː.mus.tɑhː.tɑː>»i
čatnat+V+TV+Der/NomAg+N+Der/viđá+Adv	čadna>»»viđá	tʃˈɑ.lo#tʃˌorv.vi>id>ĕæ.met.gujn
čađa+Adv	čađa	tʃˈɑd.nɑː>»»vi.ðɑː
čalbmeáhkku+Sem/Hum+N+Sg+Acc+PxSg2	čálbmeáhko>t	tʃˈɑ.ðɑː
čalbmeáhkku+Sem/Hum+N+Sg+Gen+PxSg2	čálbmeáhko>t	tʃˈɑːlə.pme#ˌɑːh.ko>h
čalbmeáhkku+Sem/Hum+N+Der/viđá+Adv	čálbmeáhkko»viđá	tʃˈɑːlə.pme#ˌɑːh.ko>h
čalbmeáhkku+Sem/Hum+N+Ess+PxDu2	čálbmeáhkku>n>eatte	tʃˈɑːlə.pme#ˌɑhː.ko»vi.ðɑː
čalbmeáhkku+Sem/Hum+N+Sg+Nom	čálbmeáhkku>	tʃˈɑːlə.pme#ˌɑhː.ku>n>ĕæt.te
čalbmeáhkku+Sem/Hum+N+Sg+Ill	čálbmeáhkku>i	tʃˈɑːlə.pme#ˌɑhː.ku>
čeahkut+V+TV+Der/NomAg+N+Sg+Ill	čehkku>»i	tʃˈɑːlə.pme#ˌɑhː.ku>i
čekŋohallat+V+TV+Cond+Prs+Pl3	čekŋohala>ledje>	tʃˈehː.ku>»i
čellestat+N+Der/Dimin+N+Pl+Nom	čellestaga»žat	tʃˈek.ŋo.hɑ.lɑ>lec.ce>
čendisparty+N+Sg+Loc	čendisparty>s	tʃˈel.les.tɑ.gɑ»žɑh
čeret+V+TV+Ind+Prs+Pl2	čere>behte>t	tʃˈenː.tis#phˌɑrə.hty>s
čerset+V+IV+Ind+Prt+Du2	čersi>ide	tʃˈe.re>beh.te>h
českkodit+V+IV+VGen	českkot>	tʃˈerə.si>i.de
čevllohallat+V+IV+Pot+Prs+Sg3	čevllohala>ža	tʃˈes.kot>
čezeš+Adv	čezeš	tʃˈeβl.lo.hɑ.lɑ>žɑ
čiežačiegat+A+Attr	čiežačiegat>	tʃˈe.dseʃ
čikŋa+Sem/Hum+N+Pl+Nom	čiŋa>t	tʃˈie.dʃɑ#tʃˌie.gɑt>
čilla+N+Pl+Nom	čila>t	tʃˈi.ŋɑː>h
čišká+N+Sg+Loc+PxDu2	čiškká>st>eatte	tʃˈi.lɑː>h
čižžái+A+Comp+Sg+Com	čižžá>buin	tʃˈiʃ.kɑː>st>ĕæt.te
čoaŋkut+V+IV+Der/l+V+Cond+Prs+Pl1	čoaŋku»livčči>imet	tʃˈidː.tʃɑː>bujn
čobmát+V+IV+Der/PassL+V+IV+Ind+Prt+ConNeg	čobmá»j»uvvo>>n	tʃˈŏɑŋŋ.ŋ̊ku»livhː.tʃi>i.meh
čoddavehkui+Adv	čoddavehkui	tʃˈob.mɑː»j»uv.vo>>n
čomas+A+Sg+Nom	čomas>	tʃˈodː.tɑː#vˌeh.kuj
čomas+A+Comp+Sg+Ill	čopmas>abbu>i	tʃˈo.mɑːs>
čomas+A+Sg+Gen	čopmas>a	tʃˈopː.mɑːs>ɑbː.pu>i
čomas+A+Superl+Sg+Nom	čopmas>eamos>	tʃˈopː.mɑːs>ɑ
čortnas+A+Der/vuohta+N+Sg+Gen+PxSg3	čortnas>»»»vuođa>s	tʃˈopː.mɑːs>ĕæ.mos>
čukča+Sem/Ani+N+Der/laš+A+Attr	čuvčča»laš>	tʃˈortː.nɑːs>»»»#vˌuo.ðɑ>s
čuntut+V+TV+Ind+Prt+Du1	čuntu>ime	tʃˈuβɸː.tʃɑː»lɑʃ>
čuođi+Num+Pl+Gen	čuđi>id	tʃˈunː.n̥tu>i.me
čuska+Sem/Ani+N+Sg+Ill	čuski>i	tʃˈu.ði>id
čávgŋi+N+Der/huvva+V+IV+Ind+Prs+Sg3	čávŋŋe»huvvá>	tʃˈusː.ki>i
šaddat+V+IV+Der/d+V+Pot+Prs+ConNeg	šatta»deš	tʃˈɑːvŋ.ŋe»huvː.vɑː>
šaddat+V+IV+Der/st+V+VGen	šatta»s	ʃˈɑtː.tɑː»deʃ
šaddu+Sem/Plant+N+Sg+Acc+PxPl2	šatto>det	ʃˈɑtː.tɑː»s
šamanisttalaš+A+Ess	šamanisttalažža>n	ʃˈɑt.to>deh
šarmantiseret+V+TV+Der/d+V+Imprt+Sg2	šarmantisere»t	ʃˈɑ.mɑː.nˌis.tɑ.lɑdː.tʃɑ>n
šattus+N+Pl+Com	šaddos>iiguin	ʃˈɑr.mɑːnː.n̥ti.se.re»h
šat+Adv	šat	ʃˈɑdː.tos>ij.gujn
šekket+V+TV+Ind+Prt+Pl1	šekki>imet	ʃˈɑh
šelget+V+TV+Ind+Prt+Du3	šelgi>iga	ʃˈek.ki>i.meh
šelggodit+V+IV+Der/meahttun+A+Comp+Attr	šelggot>»meahttus>it>	ʃˈelə.ki>i.gɑ
šelljet+V+IV+Ind+Prt+Pl2	šellji>idet	ʃˈelk.kot>»#mˌĕæhː.tus>it>
šerosmuvvat+v3+V+IV+Der/ahtti+V+VAbess	šerosm»ahte>keahttá	ʃˈeʎː.ʎi>i.deh
šet+Adv	šet	ʃˈeː.rosm»ɑh.te>kĕæhː.tɑː
šiehttat+V+TV+Ind+Prs+Du1	šihtte>	ʃˈeh
šiervut+V+IV+Der/NomAg+N+Pl+Ill+PxSg3	šiervu>»idasa>s	ʃˈihː.te>
šimir+N+Der/viđá+Adv	šimir>»viđá	ʃˈĭerə.vu>»i.dɑ.sɑ>s
šiššat+V+TV+Ger	šiša>diin	ʃˈiː.mir>»#vˌi.ðɑː
šnjagget+V+IV+Inf	šnjagge>t	ʃˈi.ʃɑː>dijn
šnjalžut+V+IV+Der/h+V+Der/adda+V+Pot+Prs+Du3	šnjalžžu»hatta>žeaba>	ʃɲˈɑgː.ke>h
šnjeahcat+V+IV+Der/l+V+Pot+Prs+Du1	šnjeahca»ležže	ʃɲˈɑlt.tʃu»hɑt.tɑ>žeæ.bɑ>
šnjoargguhit+V+TV+Der/adda+V+Pot+Prs+ConNeg	šnjorggoh»atta>š	ʃɲˈeæh.tsɑ»ledː.tʃe
šnjuoggut+V+IV+Der/NomAg+N+Sg+Ill+PxDu2	šnjuoggo>»s>eatte	ʃɲˈork.koh»ɑt.tɑ>ʃ
šoambbistit+V+IV+Der/meahttun+A+Sg+Acc	šoambbis>»meahttum>a	ʃɲˈŭogː.ko>»s>ĕæt.te
šohkka+N+Ess	šohkka>n	ʃˈoɑmp.pis>»#mˌĕæhː.tum>ɑ
šokčá+Sem/Hum+N+Sg+Ill+PxDu3	šokčá>s>easkka	ʃˈohː.kɑː>n
šombbistit+V+IV+Der/adda+V+Imprt+Pl2	šombbást»addi>t	ʃˈokː.htʃɑː>s>eæs.kɑ
šođbačurolasta+Sem/Plant+N+Sg+Acc+PxDu3	šođbačurolastta>ska	ʃˈompː.pɑːst»ɑdː.ti>h
šuvihit+V+IV+VAbess	šuvit>haga	ʃˈoðə.pɑ#tʃˌu.ro#lˌɑs.tɑ>skɑ
šuđđat+V+IV+Der/h+V+Der/ahtti+V+TV+Ind+Prs+Du2	šuđa»hahtti>beahtti>	ʃˈuː.vit>#hˌɑ.gɑ
šuđihit+V+IV+Sup	šuđih>eažžat	ʃˈu.ðɑː»hɑhː.ti>bĕæhː.ti>
šušmi+Sem/Body+N+Der/viđá+Adv	šušme»viđá	ʃˈuː.ðih>eædː.tʃɑh
šveicalaš+A+Der/vuohta+N+Sg+Ill	šveicalaš»»»vuhti>i	ʃˈuʃː.me»vi.ðɑː
šveicalaš+A+Sg+Ill	šveicalažži>i	ʃvˈejː.çtsɑ.lɑʃ»»»#vˌuh.ti>i
šákša+Sem/Ani+N+Sg+Acc	šávšša>	ʃvˈejː.çtsɑ.lɑdː.tʃi>i
šákša+Sem/Ani+N+Der/laš+A+Der/vuohta+N+Sg+Ill	šávšša»laš»»»vuhti>i	ʃˈɑːβʃ.ʃɑ>
šámpu+N+Der/viđá+Adv	šámpo»viđá	ʃˈɑːβʃ.ʃɑ»lɑʃ»»»#vˌuh.ti>i
šámpu+N+Der/huvva+V+IV+Pot+Prs+Pl3	šámpu»huva>žit	ʃˈɑːmː.m̥po»vi.ðɑː
šámpu+N+Der/huvva+V+IV+Der/muš+N+Pl+Com	šámpu»huvva>»muša>iguin	ʃˈɑːmː.m̥pu»hu.vɑ>žih
šáŋrabuhtisvuohta+N+Sg+Ill	šáŋrabuhtisvuhti>i	ʃˈɑːmː.m̥pu»huv.vɑ>»mu.ʃɑ>i.gujn
		ʃˈɑːŋ.rɑ#pˌuhː.tis.vuh.ti>i
