Agnes+N+Prop+Sem/Fem+Attr	Atnes	ˈɑh#nes>
Aigina+N+Prop+Sg+Com	Aiginain	ˈɑjː.gi.nɑ>in
Ajja+N+Prop+Sem/Fem+Der/Dimin+Sg+Nom	Ajjaš	ˈɑj.jɑː>ʃ
Ammerud+N+Prop+Der/laš+A+Sg+Acc+PxDu2	Ammerudalaččade	ˈɑm.me#rud>ɑ.lɑč.čɑ.de
Aosta+N+Prop+Sg+Loc	Aostas	ˈɑosː.tɑ>s
Arbeidslyst+N+Prop+Sg+Ill	Arbeidslystii	ˈɑrː.bejds.lyst>ij
Brænde+N+Prop+Ess	Brænden	brˈænː.de>n
Båsmoen+N+Prop+Sem/Sur+Attr	Båsmoens	bˈoːs#mˌo.en>s
Bælum+N+Prop+Sem/Sur+Attr	Bælums	bˈæ.lum>s
Bøstad+N+Prop+Sem/Sur+Sg+Loc	Bøstadas	bˈø#stɑd>ɑs
Celina+N+Prop+Sem/Fem+Pl+Nom	Celinat	sˈe.li.nɑ>h
Clydefjorden+N+Prop+Der/laš+A+AttrCmp+Der/dáhtot+A+Sg+Nom	Clydefjordenlašdáhtot	klˈy.de#fjˌorː.den>lɑʃ»dˌáh.toh
Cypriansen+N+Prop+Sem/Sur+Ess	Cypriansenin	sˈyp.ri.ˌɑnː.sen>in
Cîmpina+N+Prop+Der/laš+A+Sg+Acc+PxDu3	Cîmpinalaččaska	khˈîmː.pi.nɑ>lɑč.čɑs.kɑ
Djupedal+N+Prop+Der/laš+A+Sg+Gen+PxSg1	Djupedalalažžan	djˈu.pe#dɑl>ɑ.lɑž.žɑn
Djønne+N+Prop+Sem/Sur+Pl+Loc	Djønniin	djˈøn.ni>in
Djønno+N+Prop+Ess	Djønnon	djˈøn.no>n
Efjorden+N+Prop+Der/laš+A+Ess+PxDu3	Efjordenlažžaneaskka	ˈe#fjˌorː.den>lɑž.žɑ.neɑs.kɑ
Efjorden+N+Prop+Der/laš+A+Sg+Ill	Efjordenlažžii	ˈe#fjˌorː.den>lɑž.žij
Eibydal+N+Prop+Sg+Nom	Eibydal	ˈejː.by#dɑl>
Eldåa+N+Prop+Der/laš+A+Ess+PxSg2	Elåalažžanat	ˈel#oːɑ>lɑž.žɑ.nɑh
Emborg+N+Prop+Sg+Acc	Enborga	ˈen#borg>ɑ
Emåsværet+N+Prop+Der/laš+A+Sg+Ill	Enåsværetlažžii	ˈen#oːs#vˌæ.ret>lɑž.žij
Eskedal+N+Prop+Der/laš+A+Sg+Com+PxSg1	Eskedalalaččainan	ˈesː.ke#dɑl>ɑ.lɑč.čɑj.nɑn
Estensen+N+Prop+Sem/Sur+Attr	Estensens	ˈesː.ten.sen>s
Flekka+N+Prop+Der/laš+A+Sg+Nom	Flekkalaš	flˈek.kɑː>lɑʃ
Fræna+N+Prop+Ess	Frænan	frˈæ.nɑ>n
Fylling+N+Prop+Sem/Sur+Sg+Nom	Fylling	fˈylː.ling>
Fyresvatn+N+Prop+Der/laš+A+Sg+Ill	Fyresvatnalažžii	fˈy.res#vɑtn>ɑ.lɑž.žij
Fåberg+N+Prop+Sem/Sur+Sg+Ill	Fåbergii	fˈoː#berg>ij
Gdynia+N+Prop+Sg+Gen	Gdynia	gdˈy.ni.ɑ>
Gnesta+N+Prop+Sg+Ill	Gnestai	gnˈesː.tɑː>i
Godfjordbotn+N+Prop+Ess	Godfjorbotnan	gˈod.fjor#botn>ɑn
Gæiraelva+N+Prop+Sg+Nom	Gæiraelva	gˈæjː.rɑ#ˌelː.vɑ>
Güberg+N+Prop+Sem/Sur+Sg+Gen	Güberga	gˈy#berg>ɑ
Hsining+N+Prop+Der/laš+A+Sg+Ill	Hsininglažžii	hsˈiː.ning>lɑž.žij
Idavollen+N+Prop+Der/laš+A+Ess	Idavollenlažžan	ˈi.dɑː.vˌol.len>lɑž.žɑn
Ionia+N+Prop+Ess	Ionian	ˈio.ni.ɑ>n
Ionia+N+Prop+Sg+Loc	Ionias	ˈio.ni.ɑ>s
Iversen+N+Prop+Sem/Sur+Pl+Nom	Iversenat	ˈiː.ver.sen>ɑh
Jehova+N+Prop+Sem/Mal+Sg+Loc	Jehovas	jˈe.ho.vɑ>s
Jönköping+N+Prop+Der/laš+A+Ess+PxPl3	Jönköpinglažžaneaset	jˈøn#khˌø.ping>lɑž.žɑ.nĕɑ.seh
Keyhinge+N+Prop+Sg+Ill	Keyhingii	khˈe.y.hˌiŋ.ŋi>i
Kjeksevåg+N+Prop+Sg+Acc	Kjeksevåg	kjˈekː.se#voːg>
Kufjord+N+Prop+Der/laš+A+Sg+Gen+PxSg2	Kufjordalaččat	khˈu#fjord>ɑ.lɑč.čɑh
Liseth+N+Prop+Sem/Sur+Ess	Lisethan	lˈiː.seth>ɑn
Lovraeid+N+Prop+Sem/Sur+Sg+Gen	Lovraeid	lˈovː.rɑː#ejd>
Låsby+N+Prop+Ess	Låsbyn	lˈoːs.by>n
Lælius+N+Prop+Sem/Sur+Sg+Gen	Læliusa	lˈæ.li.us>ɑ
Lø+N+Prop+Sg+Acc	Lø	lˈø>
Maia+N+Prop+Sem/Fem+Sg+Com	Maiain	mˈɑ.iɑ>in
McDonald+N+Prop+Sem/Mal+Attr	McDonald	mkdˈo.nɑːld>
Mysia+N+Prop+Der/laš+A+AttrCmp+Der/vigat+A+Sg+Acc	Mysialašvigaga	mˈy.si.ɑ>lɑʃ»vˌi.gɑ.gɑ
Mærsk+N+Prop+Der/laš+A+AttrCmp+Der/pláhtat+A+Sg+Gen	Mærskalašpláhtaga	mˈærsk>ɑ.lɑʃ»plˌáh.tɑ.gɑ
Njåstad+N+Prop+Sem/Sur+Sg+Com	Njåstadain	ɲˈoː#stɑd>ɑjn
Nossebro+N+Prop+Der/laš+A+Sg+Ill	Nossebrolažžii	nˈos.se#bro>lɑž.žij
Næss+N+Prop+Sem/Sur+Pl+Acc	Næssaid	nˈæsː>ɑjh
Nördlingen+N+Prop+Sg+Acc	Nördlingena	nˈørd.lin.gen>ɑ
Nørgaard+N+Prop+Sem/Sur+Sg+Loc	Nørgaardas	nˈør#gˌɑ.ɑrd>ɑs
Ohad+N+Prop+Sg+Ill	Ohadii	ˈo.hɑːd>ij
Ommundsen+N+Prop+Sem/Sur+Attr	Ommundsens	ˈomː.mund.sen>s
Opstad+N+Prop+Sem/Sur+Sg+Ill	Otstadii	ˈoh#stɑd>ij
Ottosen+N+Prop+Sem/Sur+Sg+Loc	Ottosenis	ˈot.to.sen>is
Oujda+N+Prop+Sem/Fem+Sg+Com	Oujdain	ˈoujː.dɑ>in
Poona+N+Prop+Sg+Loc	Poonas	phˈo.o.nɑ>s
Pæska+N+Prop+Sg+Nom	Pæska	phˈæsː.kɑ>
Qing+N+Prop+Sem/Sur+Pl+Gen	Qingaid	kˈing>ɑjh
Qing+N+Prop+Sem/Sur+Sg+Acc	Qinga	kˈing>ɑ
Qing+N+Prop+Sem/Sur+Sg+Gen	Qinga	kˈing>ɑ
Quebrada+N+Prop+Sg+Ill	Quebradai	kˈu.eb.rˌɑ.dɑ>i
Quisling+N+Prop+Sem/Sur+Sg+Gen+Allegro	Quisling	kˈuj.sling>
Rhondda+N+Prop+Sg+Loc	Rhonddas	rhˈont.tɑː>s
Rivadavia+N+Prop+Ess	Rivadavian	rˈi.vɑː.ðˌɑ.vi.ɑ>n
Rjånes+N+Prop+Sg+Ill	Rjånesii	rjˈoː#nes>ij
Rättvik+N+Prop+Sem/Sur+Sg+Ill	Rättvikii	rˈæth#vik>ij
Rædergård+N+Prop+Sg+Acc	Rædergård	rˈæ.der#goːrd>
Skøynafylke+N+Prop+Sg+Nom	Skøynafylke	skˈøy.nɑ#fˌylː.ke>
Slangsvoll+N+Prop+Sg+Ill	Slangsvollii	ʃlˈɑngs#volː>ij
SÁMIacademica+N+Prop+Pl+Acc	SÁMIacademicaid	sˈá.mi.ˌɑ.kɑ.dˌe.mi.kɑ>id
Sálmo+N+Prop+Sem/Sur+Sg+Com	Sálmoin	sˈál.mo>in
Södermanland+N+Prop+Sg+Nom	Södermanland	sˈø.der.mɑn#lɑnd>
Søberg+N+Prop+Sem/Sur+Sg+Acc	Søberg	sˈø#berg>
Ubergsmoen+N+Prop+Sg+Acc	Ubergsmoena	ˈuː.bergs#mˌo.en>ɑ
Uria+N+Prop+Sem/Mal+Sg+Loc	Urias	ˈu.ri.ɑ>s
Vrangfoss+N+Prop+Sg+Gen	Vrangfossa	vrˈɑng#fosː>ɑ
Vågård+N+Prop+Sg+Gen	Vågårda	vˈoː#goːrd>ɑ
Vårdal+N+Prop+Der/laš+A+Sg+Acc+PxSg2	Vårdalalaččat	vˈoːr#dɑl>ɑ.lɑč.čɑh
Worthing+N+Prop+Sg+Com	Worthingiin	vˈort.hing>ijn
Woxholt+N+Prop+Sem/Sur+Sg+Ill	Woxholtii	vˈoks.holt>ij
Württemberg+N+Prop+Sem/Sur+Sg+Acc	Württenberg	vˈyrt.ten#berg>
Xia+N+Prop+Sg+Loc	Xias	ksˈi.ɑ>s
Xia+N+Prop+Der/laš+A+Sg+Nom+PxDu3	Xialažžaska	ksˈi.ɑ>lɑž.žɑs.kɑ
Xining+N+Prop+Der/laš+A+Sg+Acc+PxPl2	Xininglaččadet	ksˈiː.ning>lɑč.čɑ.deh
Yarkand+N+Prop+Ess	Yarkandan	ˈyɑrː.kɑnd>ɑn
Yding+N+Prop+Der/laš+A+Ess+PxDu3	Ydinglažžaneaskka	ˈy.ding>lɑž.žɑ.neɑs.kɑ
Ylvingen+N+Prop+Ess	Ylvingenin	ˈylː.vin.gen>in
Yngvild+N+Prop+Sem/Fem+Attr	Yngvild	ˈyng.vild>
Yttervik+N+Prop+Ess	Yttervikan	ˈyt.ter#vik>ɑn
Zachariasen+N+Prop+Sem/Sur+Attr	Zachariasens	zˈɑk.hɑː.rˌi.ɑ.sen>s
Zaria+N+Prop+Ess	Zarian	zˈɑ.ri.ɑ>n
Zaria+N+Prop+Sg+Acc	Zaria	zˈɑ.ri.ɑ>
Zululand+N+Prop+Sg+Nom	Zululand	zˈu.lu#lɑnd>
høgskole+N+Prop+Sg+Loc	høgskoles	hˈøg.sko.le>s
høgskole+N+Prop+Sg+Com	høgskoliin	hˈøg.sko.li>in
høgskole+N+Prop+Sg+Ill	høgskolii	hˈøg.sko.li>i
iTromsø+N+Prop+Ess	iTromsøn	ˈi.trom.sø>n
iTromsø+N+Prop+Sg+Gen	iTromsø	ˈi.trom.sø>
iTromsø+N+Prop+Sg+Nom	iTromsø	ˈi.trom.sø>
iTromsø+N+Prop+Sg+Ill	iTromsøi	ˈi.trom.sø>i
iTromsø+N+Prop+Sg+Loc	iTromsøs	ˈi.trom.sø>s
Älmhult+N+Prop+Sem/Sur+Sg+Ill	Älmhultii	ˈælm#hult>ij
Ängelholm+N+Prop+Ess	Ängelholman	ˈæŋ.ŋel#holm>ɑn
Ådal+N+Prop+Sg+Ill	Ådalii	ˈoː#dɑl>ij
Åhnberg+N+Prop+Sem/Sur+Pl+Ill	Åhnbergaide	ˈoːhn#berg>ɑj.de
Ålesund+N+Prop+Der/laš+A+Sg+Gen	Ålesundlačča	ˈoː.le#sund>»lˌɑč.čɑ
Ånensen+N+Prop+Sem/Sur+Sg+Gen+Allegro	Ånensen	ˈoː.nen.sen>
Æneas+N+Prop+Sem/Mal+Attr	Æneas	ˈæ.ne.ɑs>
Ærø+N+Prop+Sg+Gen	Ærø	ˈær#ø>
Æskulap+N+Prop+Sg+Ill	Æskulapii	ˈæsː.ku.lɑp>ij
Æsop+N+Prop+Sem/Mal+Sg+Com	Æsopiin	ˈæ.sop>ijn
Öland+N+Prop+Sg+Nom	Öland	ˈø#lɑnd>
Ölmbro+N+Prop+Sem/Sur+Sg+Gen	Ölmbro	ˈølm#bro>
Öyvoll+N+Prop+Der/laš+A+Sg+Ill	Öyvollalažžii	ˈøy#volː>ɑ.lɑž.žij
Øivind+N+Prop+Sem/Mal+Sg+Loc	Øivindis	ˈøjː.vind>is
Øvrum+N+Prop+Sem/Sur+Attr	Øvrums	ˈøvː.rum>s
Þingvallavatn+N+Prop+Der/laš+A+Sg+Acc+PxSg2	Þingvallavatnalaččat	θˈing.vɑːl.lɑ#vɑtn>ɑ.lɑč.čɑh
Þórisvatn+N+Prop+Ess	Þórisvatnan	θˈuː.ris#vɑtn>ɑn
Þórisvatn+N+Prop+Der/laš+A+Pl+Loc	Þórisvatnalaččain	θˈuː.ris#vɑtn>ɑ.lɑč.čɑjn
Þórisvatn+N+Prop+Der/laš+A+Sg+Com	Þórisvatnalaččain	θˈuː.ris#vɑtn>ɑ.lɑč.čɑjn
Aftenposten+N+Prop+Ess	Aftenpostenin	ˈɑf.ten.pˌosː.ten>in
Amiga+N+Prop+Pl+Nom	Amigat	ˈɑ.mi.gɑ>h
Asserøy+N+Prop+Der/laš+A+Sg+Nom	Asserøyalaš	ˈɑs.ser#øy>ɑ.lɑʃ
Bitynia+N+Prop+Der/laš+A+Sg+Ill	Bitynialažžii	bˈi.ty.nˌi.ɑ>lɑž.žij
Bjännberg+N+Prop+Sem/Sur+Pl+Com	Bjännbergaiguin	bjˈænː#berg>ɑj.gujn
Bygderett+N+Prop+Sg+Ill	Bygderettii	bˈyg.de#retː>ij
Bøen+N+Prop+Sem/Sur+Ess	Bøenin	bˈø.en>in
Bøggild+N+Prop+Sem/Sur+Sg+Ill	Bøggildii	bˈøg.gild>ij
Bøstad+N+Prop+Sem/Sur+Pl+Acc	Bøstadaid	bˈø#stɑd>ɑjh
Bøyum+N+Prop+Sem/Sur+Sg+Nom	Bøyum	bˈø.yum>
Centralia+N+Prop+Der/laš+A+Sg+Ill	Centralialažžii	sˈent.rɑː.lˌi.ɑ>lɑž.žij
Circa+N+Prop+Der/laš+A+Ess	Circalažžan	sˈirː.kɑː>lɑž.žɑn
Drangedal+N+Prop+Sg+Ill	Drangedalii	drˈɑŋ.ŋe#dɑl>ij
Dyrdal+N+Prop+Der/laš+A+Ess+PxPl1	Dyrdalalažžaneamet	dˈyr#dɑl>ɑ.lɑž.žɑ.nĕɑ.meh
Dørum+N+Prop+Sem/Sur+Sg+Acc	Dørum	dˈø.rum>
Ewald+N+Prop+Sem/Mal+Pl+Acc	Ewaldiid	ˈe.vɑːld>ijh
Ewald+N+Prop+Sem/Mal+Attr	Ewald	ˈe.vɑːld>
Fladsrud+N+Prop+Sem/Sur+Ess	Fladsrudan	flˈɑds#rud>ɑn
Flesberg+N+Prop+Sem/Sur+Ess	Flesbergan	flˈes#berg>ɑn
Flugsrud+N+Prop+Sem/Sur+Ess	Flugsrudan	flˈugs#rud>ɑn
Fuad+N+Prop+Sem/Mal+Sg+Ill	Fuadii	fˈu.ɑd>ij
Fyresdal+N+Prop+Sg+Ill	Fyresdalii	fˈy.res#dɑl>ij
Färgelanda+N+Prop+Der/laš+A+Pl+Gen+PxPl2	Färgelandalaččaideattet	fˈærː.ge#lˌɑnː.dɑ>lɑč.čɑj.dĕɑt.teh
Gelderland+N+Prop+Der/laš+A+Sg+Loc+PxSg2	Gelderlandalaččastat	gˈelː.der#lɑnd>ɑ.lɑč.čɑs.tɑh
Gjæsingen+N+Prop+Der/laš+A+Attr+Der/vuohta+N+Sg+Ill	Gjæsingenlašvuhtii	gjˈæ.sin.gen>lɑʃ»vˌuh.tij
Gjørdis+N+Prop+Sem/Fem+Sg+Ill	Gjørdisii	gjˈørː.dis>ij
Grænsekomiteen+N+Prop+Sg+Gen	Grænsekomiteena	grˈænː.se#khˌo.mi.tˌe.en>ɑ
Hvalstad+N+Prop+Sem/Sur+Pl+Loc	Hvalstadain	hvˈɑl#stɑd>ɑjn
Håløygjafylke+N+Prop+Sg+Nom	Håløygjafylke	hˈoːl.øyg.jɑ#fˌylː.ke>
Hækkerup+N+Prop+Der/laš+A+Ess+PxSg1	Hækkerupalažžanan	hˈæk.ke.rup>ɑ.lɑž.žɑ.nɑn
Hörby+N+Prop+Ess	Hörbyn	hˈør#by>n
Høvik+N+Prop+Sem/Sur+Pl+Gen	Høvikaid	hˈø#vik>ɑjh
Igerøy+N+Prop+Der/laš+A+AttrCmp+Der/asat+A+Pl+Nom	Igerøyalašasagat	ˈiː.ger#øy>ɑ.lɑʃ»ˌɑ.sɑ.gɑh
Iidda+N+Prop+Sem/Fem+Sg+Com	Iiddain	ˈijt.tɑː>in
Imøy+N+Prop+Der/laš+A+Sg+Loc	Inøyalaččas	ˈin#øy>ɑ.lɑč.čɑs
Jefsen+N+Prop+Sem/Sur+Sg+Nom	Jefsen	jˈef.sen>
Jugoslavia+N+Prop+Der/laš+A+Sg+Ill	Jugoslavialažžii	jˈu.go.slˌɑ.vi.ɑ>lɑž.žij
Jæder+N+Prop+Sg+Gen	Jædera	jˈæ.der>ɑ
Jönköping+N+Prop+Sg+Loc	Jönköpingis	jˈøn#khˌø.ping>is
Karsten+N+Prop+Sem/Mal+Sg+Gen+Allegro	Karsten	khˈɑr#sten>
Klåstad+N+Prop+Sem/Sur+Sg+Ill	Klåstadii	klˈoː#stɑd>ij
Knutshø+N+Prop+Sg+Loc	Knutshøs	knˈut.shø>s
Lampeland+N+Prop+Sg+Nom	Lampeland	lˈɑmː.pe#lɑnd>
Lidal+N+Prop+Sg+Acc	Lidala	lˈi#dɑl>ɑ
Ljøsne+N+Prop+Sg+Loc	Ljøsnes	ljˈøs.ne>s
Ljøsne+N+Prop+Sg+Ill	Ljøsnii	ljˈøs.ni>i
Loddefjord+N+Prop+Der/laš+A+Sg+Nom+PxDu2	Loddefjordalažžade	lˈod.de#fjord>ɑ.lɑž.žɑ.de
Luleälv+N+Prop+Sg+Nom	Luleälv	lˈu.le#ælv>
Mbing+N+Prop+Sem/Sur+Pl+Com	Mbingaiguin	mbˈing>ɑj.gujn
Mbing+N+Prop+Sem/Sur+Sg+Acc	Mbing	mbˈing>
Mbing+N+Prop+Sem/Sur+Sg+Nom	Mbing	mbˈing>
Mostad+N+Prop+Sem/Sur+Pl+Gen	Mostadaid	mˈo#stɑd>ɑjh
Muonioälv+N+Prop+Sg+Nom	Muonioälv	mˈuo.nio#ælv>
Oceania+N+Prop+Sg+Nom	Oceania	ˈo.se.ˌɑ.ni.ɑ>
Odelstinget+N+Prop+Sg+Nom	Odelstinget	ˈoː.dels#thˌiŋ.ŋet>
Opsvik+N+Prop+Sem/Sur+Pl+Nom	Opsvikat	ˈop.svik>ɑh
Oviken+N+Prop+Der/laš+A+Sg+Loc	Ovikenlaččas	ˈo#vˌi.ken>lɑč.čɑs
Persia+N+Prop+Ess	Persian	phˈerː.si.ɑ>n
Pistoia+N+Prop+Der/laš+A+AttrCmp+Der/olat+A+Ess	Pistoialašolagin	phˈisː.to.iɑ>lɑʃ»ˌo.lɑ.gin
Puglia+N+Prop+Sg+Acc	Puglia	phˈug.li.ɑ>
Puoliväli+N+Prop+Der/laš+A+AttrCmp+Der/njunat+A+Sg+Gen	Puolivälilašnjunaga	phˈuo.li#vˌæ.li>lɑʃ»ɲˌu.nɑ.gɑ
Qing+N+Prop+Sem/Sur+Pl+Loc	Qingain	kˈing>ɑjn
Qing+N+Prop+Sem/Sur+Sg+Acc	Qing	kˈing>
Qvænsk+N+Prop+Sem/Sur+Pl+Nom	Qvænskat	kvˈænsk>ɑh
Qvænsk+N+Prop+Sem/Sur+Sg+Acc	Qvænska	kvˈænsk>ɑ
Ripia+N+Prop+Sg+Loc	Ripias	rˈi.pi.ɑ>s
Rjånes+N+Prop+Der/laš+A+Pl+Com	Rjånesalaččaiguin	rjˈoː#nes>ɑ.lɑč.čɑj.gujn
Rustad+N+Prop+Sem/Sur+Sg+Acc	Rustada	rˈu#stɑd>ɑ
Rättvik+N+Prop+Sem/Sur+Sg+Nom	Rättvik	rˈæth#vik>
Smiugard+N+Prop+Sg+Loc	Smiugardas	smˈi.u#gɑrd>ɑs
Spezia+N+Prop+Sg+Com	Speziain	spˈe.zi.ɑ>in
Tophøj+N+Prop+Sg+Acc	Tothøja	thˈoh#høj>ɑ
Tveøy+N+Prop+Sem/Sur+Sg+Ill	Tveøyii	tvˈe#øy>ij
Tælavåg+N+Prop+Der/laš+A+Attr+Der/vuohta+N+Der/viđá+Adv	Tælavågalašvuohtaviđá	thˈæ.lɑ#voːg>ɑ.lɑʃ»vˌuoh.tɑ»vˌi.ðá
Udsen+N+Prop+Sem/Sur+Sg+Gen	Udsena	ˈud.sen>ɑ
Uganda+N+Prop+Ess	Ugandan	ˈu.gɑːn.dɑ>n
UiTø+N+Prop+Sg+Nom	UiTø	ˈujː.tø>
Ukraina+N+Prop+Der/laš+A+Sg+Nom	Ukrainalaš	ˈuk.rɑːj.nɑ>lɑʃ
Valand+N+Prop+Sem/Sur+Sg+Ill	Valandii	vˈɑ#lɑnd>ij
Vytsjegda+N+Prop+Der/laš+A+Attr	Vytsjegdalaš	vˈyt.sjeg.dɑ>lɑʃ
Vælidalo+N+Prop+Sem/Sur+Sg+Ill	Vælidaloi	vˈæ.li.ðˌɑ.lo>i
Worthing+N+Prop+Der/laš+A+AttrCmp+Der/ávjjot+A+Pl+Nom	Worthinglašávjjogat	vˈort.hing>lɑʃ»ˌávj.jo.gɑh
Wroldsen+N+Prop+Sem/Sur+Sg+Acc	Wroldsena	vrˈold.sen>ɑ
Wærner+N+Prop+Sem/Sur+Attr	Wærners	vˈær.ner>s
Xining+N+Prop+Sg+Gen+Allegro	Xining	ksˈiː.ning>
Xining+N+Prop+Sg+Loc	Xiningis	ksˈiː.ning>is
Xining+N+Prop+Der/laš+A+Sg+Ill	Xininglažžii	ksˈiː.ning>lɑž.žij
Ylvingen+N+Prop+Ess	Ylvingenin	ˈylː.vin.gen>in
Zululand+N+Prop+Sg+Nom	Zululand	zˈu.lu#lɑnd>
høgskole+N+Prop+Ess	høgskolen	hˈøg.sko.le>n
høgskole+N+Prop+Sg+Gen	høgskole	hˈøg.sko.le>
iTromsø+N+Prop+Ess	iTromsøn	ˈi.trom.sø>n
Älvmötet+N+Prop+Sg+Gen	Älvmöteta	ˈælv.mø.tet>ɑ
Ängelholm+N+Prop+Sg+Gen	Ängelholm	ˈæŋ.ŋel#holm>
Ängelholm+N+Prop+Sg+Ill	Ängelholmii	ˈæŋ.ŋel#holm>ij
Åhnberg+N+Prop+Sem/Sur+Sg+Acc	Åhnberga	ˈoːhn#berg>ɑ
Ænes+N+Prop+Sem/Sur+Ess	Ænesan	ˈæ#nes>ɑn
Ænes+N+Prop+Sem/Sur+Sg+Ill	Ænesii	ˈæ#nes>ij
Æneiden+N+Prop+Ess	Æneidenin	ˈæ.nej.den>in
Ærøskøbing+N+Prop+Ess	Ærøskøbingin	ˈæ.røs#khˌø.bing>in
Æskulap+N+Prop+Der/laš+A+Ess+PxDu2	Æskulapalažžaneatte	ˈæsː.ku.lɑp>ɑ.lɑž.žɑ.nĕɑt.te
Öræfi+N+Prop+Der/laš+A+Attr	Öræfilaš	ˈø.ræ.fi>lɑʃ
Öyvoll+N+Prop+Ess	Öyvollan	ˈøy#volː>ɑn
Økern+N+Prop+Sg+Gen+Allegro	Økern	ˈø.kern>
Økokrim+N+Prop+Ess	Økokriman	ˈø.ko.krim>ɑn
Østgaard+N+Prop+Sem/Sur+Ess	Øsgaardan	ˈøs#gˌɑ.ɑrd>ɑn
Øvstedal+N+Prop+Der/laš+A+Sg+Ill	Øvstedalalažžii	ˈøvː.ste#dɑl>ɑ.lɑž.žij
akšuvdna+N+Sg+Nom+PxDu3	akšuvdnaska	ˈɑkː.ʃuv.tnɑ>skɑ
akšuvdna+N+Sg+Nom+PxPl3	akšuvdnaset	ˈɑkː.ʃuv.tnɑ>seh
akšuvdna+N+Sg+Nom+PxSg3	akšuvdnas	ˈɑkː.ʃuv.tnɑ>s
akšuvdna+N+Sg+Nom	akšuvdna	ˈɑkː.ʃuv.tnɑ>
akšuvdna+N+Ess+PxDu1	akšuvdnaneame	ˈɑkː.ʃuv.tnɑ>nĕɑ.me
akšuvdna+N+Ess+PxPl1	akšuvdnaneamet	ˈɑkː.ʃuv.tnɑ>nĕɑ.meh
akšuvdna+N+Ess+PxPl2	akšuvdnaneattet	ˈɑkː.ʃuv.tnɑ>nĕɑt.teh
akšuvdna+N+Ess+PxPl3	akšuvdnaneaset	ˈɑkː.ʃuv.tnɑ>nĕɑ.seh
akšuvdna+N+Ess+PxSg3	akšuvdnanis	ˈɑkː.ʃuv.tnɑ>nis
akšuvdna+N+Ess	akšuvdnan	ˈɑkː.ʃuv.tnɑ>n
akšuvdna+N+Sg+Acc+PxDu1	akšuvdname	ˈɑkː.ʃuv.tnɑ>me
akšuvdna+N+Sg+Gen+PxDu1	akšuvdname	ˈɑkː.ʃuv.tnɑ>me
akšuvdna+N+Sg+Gen+PxSg1	akšuvdnan	ˈɑkː.ʃuv.tnɑ>n
akšuvdna+N+Sg+Ill+PxSg2	akšuvdnasat	ˈɑkː.ʃuv.tnɑ>sɑh
akšuvdna+N+Sg+Ill	akšuvdnii	ˈɑkː.ʃuv.tni>i
akšuvdna+N+Pl+Com+PxSg2	akšuvnnaidatguin	ˈɑkː.ʃuvn.nɑ>i.dɑt.gujn
akšuvdna+N+Pl+Ill+PxSg2	akšuvnnaidasat	ˈɑkː.ʃuvn.nɑ>i.dɑ.sɑh
akšuvdna+N+Sg+Acc+PxPl2	akšuvnnadet	ˈɑkː.ʃuvn.nɑ>deh
akšuvdna+N+Sg+Acc+PxSg2	akšuvnnat	ˈɑkː.ʃuvn.nɑ>h
akšuvdna+N+Sg+Gen+PxDu3	akšuvnnaska	ˈɑkː.ʃuvn.nɑ>skɑ
akšuvdna+N+Sg+Gen+PxSg3	akšuvnnas	ˈɑkː.ʃuvn.nɑ>s
akšuvdna+N+Sg+Com+PxPl2	akšuvnnaineattet	ˈɑkː.ʃuvn.nɑ>i.nĕɑt.teh
akšuvdna+N+Sg+Loc	akšuvnnas	ˈɑkː.ʃuvn.nɑ>s
akšuvdna+N+Sg+Loc+PxDu2	akšuvnnasteatte	ˈɑkː.ʃuvn.nɑ>stĕɑt.te
akšuvdna+N+Der/Dimin+N+Sg+Nom	akšuvnnaš	ˈɑkː.ʃuvn.nɑ»ʃ
akšuvdna+N+Der/heapmi+A+Comp+Pl+Nom	akšuvnnahabbot	ˈɑkː.ʃuvn.nɑ»hˌɑb.bo>h
akšuvdna+N+Der/heapmi+A+Attr	akšuvnnahis	ˈɑkː.ʃuvn.nɑ»his>
akšuvdna+N+Der/huhtti+V+TV+Ind+Prs+Sg1	akšuvnnahuhtán	ˈɑkː.ʃuvn.nɑ»hˌuhː.tá>n
akšuvdna+N+Der/huvva+V+IV+Ger	akšuvnnahuvadin	ˈɑkː.ʃuvn.nɑ»hˌu.vɑ>din
akšuvdna+N+Der/huvva+V+IV+Ind+Prs+Pl1	akšuvnnahuvvat	ˈɑkː.ʃuvn.nɑ»hˌuv.vɑ>h
akšuvdna+N+Der/huvva+V+IV+Imprt+Pl1	akšuvnnahuvvut	ˈɑkː.ʃuvn.nɑ»hˌuv.vu>h
abbediija+N+Ess+PxDu2	abbediijaneatte	ˈɑb.be.ðˌij.jɑ>nĕɑt.te
abbediija+N+Sg+Ill	abbediijii	ˈɑb.be.ðˌij.ji>i
abessiiva+N+Der/viđá+Adv	abessiivaviđá	ˈɑ.bes.sˌijː.vɑ»vˌi.ðá
abessiiva+N+Sg+Ill	abessiivii	ˈɑ.bes.sˌijː.vi>i
ablatiiva+N+Der/huhtti+V+TV+VAbess	ablatiivvahuhtikeahttá	ˈɑb.lɑː.tˌijv.vɑ»hˌuh.ti>kĕɑhː.tá
aboriginála+N+Pl+Gen+PxDu2	aboriginálaideatte	ˈɑb.o.rˌi.gi.nˌá.lɑ>i.dĕɑt.te
aborta+N+Sg+Ill	abortii	ˈɑ.bor.ti>i
absolutiiva+N+Der/huvva+V+IV+Imprt+Du2	absolutiivvahuvvi	ˈɑb.so.lˌu.tijv.vɑ»hˌuv.vi>
acetylena+N+Sg+Com+PxPl3	acetylenaineaset	ˈɑ.se.tˌy.le.nɑ>i.nĕɑ.seh
acetylena+N+Sg+Ill	acetylenii	ˈɑ.se.tˌy.le.ni>i
adreassa+G3+N+Der/Dimin+N+Pl+Nom	adreassažat	ˈɑ.dreɑs.sɑ»žɑh
adreassa+G3+N+Der/huvva+V+IV+VAbess	adreassahuvahaga	ˈɑ.dreɑs.sɑ»hˌu.vɑ>hɑ.gɑ
adreassa+G3+N+Der/viđá+Adv	adreassaviđá	ˈɑ.dreɑs.sɑ»vˌi.ðá
adreassagoarta+N+Sg+Ill	adreassagortii	ˈɑ.dreɑs.sɑ#gˌorː.ti>i
adresserenbábir+N+Sg+Nom	adresserenbábir	ˈɑ.dres.sˌe.ren#bˌá.bir>
adresserenbábur+N+Der/geahtes+A+Attr	adresserenbáborgeahtes	ˈɑ.dres.sˌe.ren#bˌá.bor>»gˌĕɑh.tes
adullamlaš+N+Ess+PxSg2	adullamlažžanat	ˈɑ.dul.lˌɑm.lɑž.žɑ>nɑh
agnostisisma+N+Ess+PxDu3	agnostisismaneaskka	ˈɑ.gnos.tˌi.sis.mɑ>neɑs.kɑ
agnostisisma+N+Der/viđá+Adv	agnostisismaviđá	ˈɑ.gnos.tˌi.sis.mɑ»vˌi.ðá
agnostisisma+N+Der/heapmi+A+Comp+Pl+Gen	agnostisismmahabbuid	ˈɑ.gnos.tˌi.sis.mɑ»hˌɑb.bu>id
agnostisisma+N+Der/huhtti+V+TV+Imprt+Pl2	agnostisismmahuhttet	ˈɑ.gnos.tˌi.sis.mɑ»hˌuhː.te>h
agnostisisma+N+Der/huhtti+V+TV+Der/PassL+V+IV+Der/supmi+N+Sg+Ill	agnostisismmahuhttosupmái	ˈɑ.gnos.tˌi.sis.mɑ»hˌuhː.to>»sˌup.máj
aggrešuvdna+N+Der/huvva+V+IV+VAbess+A+Attr	aggrešuvnnahuvakeahtes	ˈɑg.gre.ʃˌuβn.nɑ»hˌu.vɑ>kĕɑh.tes
agglutinašuvdna+N+Sg+Ill	agglutinašuvdnii	ˈɑgː.lu.tˌi.nɑ.ʃˌuv.tni>i
agitáhtor+N+Der/viđá+Adv	agitáhtorviđá	ˈɑ.gi.tˌáh.tor»vˌi.ðá
agoarta+N+Ess+PxSg3	agoartanis	ˈɑ.goɑr.tɑ>nis
agronoma+N+Der/viđá+Adv	agronomaviđá	ˈɑg.ro.nˌo.mɑ»vˌi.ðá
agrárapartiija+N+Sg+Ill	agrárapartiijii	ˈɑg.rá.rɑ#phˌɑrː.tij.ji>i
akleija+N+Pl+Nom	akleijat	ˈɑ.klej.jɑ>h
akleija+N+Der/Dimin+N+Sg+Nom	akleijaš	ˈɑ.klej.jɑ»ʃ
akleija+N+Der/viđá+Adv	akleijaviđá	ˈɑ.klej.jɑ»vˌi.ðá
akademalašvuohta+N+Sg+Nom+PxSg1	akademalašvuohtan	ˈɑ.kɑː.ðˌe.mɑ.lˌɑʃ.vuoh.tɑ>n
akkulturašuvdna+N+Pl+Nom	akkulturašuvnnat	ˈɑk.kul.tˌu.rɑ.ʃˌuvn.nɑ>h
akustihkka+N+Sg+Ill	akustihkkii	ˈɑ.kus.tˌihː.ki>i
akšuvdnabeaivi+N+Sg+Gen+Allegro	akšuvdnabeaivve	ˈɑkː.ʃuv.tnɑ#bˌĕɑjv.ve>
aleksandrialaš+N+Sg+Ill	aleksandrialažžii	ˈɑ.lekː.sˌɑnd.ri.ˌɑ.lɑž.ži>i
allakapasitehta+N+Sg+Ill	allakapasitehtii	ˈɑlː.lɑː#khˌɑ.pɑ.sˌi.teh.ti>i
alolastavuovdi+N+Pl+Nom+PxSg3	alolastavuvddiidis	ˈɑ.lo.lˌɑsː.tɑ#vˌuβt.ti>i.dis
altruisma+N+Der/heapmi+A+Attr	altruismmahis	ˈɑl.trujsm.mɑ»his>
alumingásterola+N+Sg+Ill	alumingásterolii	ˈɑ.lu.min#gˌásː.te.rˌo.li>i
amaleklaš+N+Sg+Nom	amaleklaš	ˈɑ.mɑː.lˌek.lɑʃ>
amaryllis+N+Der/viđá+Adv	amaryllisviđá	ˈɑ.mɑː.rˌylː.lis»vˌi.ðá
ambivaleansa+N+Pl+Loc+PxPl2	ambivaleanssaineattet	ˈɑmː.bi.vˌɑ.leɑns.sɑ>i.nĕɑt.teh
amfetamiidna+N+Der/laš+A+Sg+Nom	amfetamiinnalaš	ˈɑm.fe.tˌɑ.mijn.nɑ»lɑʃ>
amnestiija+N+Sg+Ill	amnestiijii	ˈɑm.nes.tˌij.ji>i
androgena+N+Sg+Ill	androgenii	ˈɑnd.ro.gˌe.ni>i
aniliidna+N+Sg+Ill	aniliidnii	ˈɑ.ni.lˌij.tni>i
anisrássi+N+Der/viđá+Adv	anisrásseviđá	ˈɑ.nis#rˌás.se»vˌi.ðá
anisrássi+N+Ess+PxPl1	anisrássineamet	ˈɑ.nis#rˌás.si>nĕɑ.meh
anteannadárkkástus+N+Sg+Ill+PxSg1	anteannadárkkástussasan	ˈɑnː.teɑn.nɑ#dˌárk.kás.tˌus.sɑ>sɑn
antioksidánta+N+Der/viđá+Adv	antioksidántaviđá	ˈɑnː.ti#ˌokː.si.dˌánː.tɑ»vˌi.ðá
anárkosyndikalista+N+Ess+PxSg1	anárkosyndikalistanan	ˈɑn.ár.ko#sˌynː.di.kˌɑ.lis.tɑ>nɑn
aortauvssot+N+Sg+Nom	aortauvssot	ˈɑorː.tɑ#ˌuβs.sot>
aortauvssot+N+Der/heapmi+A+Sg+Com	aortauvssothemiin	ˈɑorː.tɑ#ˌuβs.soh»hˌe.mi>in
aortauvssot+N+Der/laš+A+Superl+Pl+Gen	aortauvssotlaččamusaid	ˈɑorː.tɑ#ˌuβs.soh»lˌɑč.čɑ.mˌu.sɑ>id
aprikosa+N+Der/viđá+Adv	aprikosaviđá	ˈɑ.pri.kˌo.sɑ»vˌi.ðá
aprikosa+N+Sg+Ill	aprikosii	ˈɑ.pri.kˌo.si>i
apartheid+N+Sg+Ill	apartheidii	ˈɑ.pɑːrt.hˌejː.di>i
apartheida+N+Sg+Ill	apartheidii	ˈɑ.pɑːrt.hˌejː.di>i
apoteahkka+N+Sg+Ill	apotehkkii	ˈɑ.po.tˌehː.ki>i
appealladuopmostuollu+N+Sg+Nom	appealladuopmostuollu	ˈɑp.peɑl.lɑ#dˌŭop.mo#stˌuol.lu>
apteaika+N+Sg+Ill	apteikii	ˈɑp.tej.ki>i
argumeanta+N+Der/viđá+Adv	argumeantaviđá	ˈɑrː.gu.mˌĕɑnː.tɑ»vˌi.ðá
arologa+N+Der/huvva+V+IV+Ind+Prs+Sg3	arologahuvvá	ˈɑ.ro.lˌo.gɑ»hˌuvː.vá>
arreasta+N+Der/heapmi+A+Sg+Acc	arreasttaheami	ˈɑr.reɑs.tɑ»hˌeɑ.mi>
artotehka+N+Der/viđá+Adv	artotehkaviđá	ˈɑrː.to.tˌeh.kɑ>»vˌi.ðá
aspirašuvdna+N+Sg+Ill	aspirašuvdnii	ˈɑ.spi.rˌɑ.ʃuv.tni>i
aspiránta+N+Der/laš+A+AttrCmp+Der/kultuvrrat+A+Sg+Ill	aspiránttalaškultuvrragii	ˈɑ.spi.rˌánt.tɑ»lɑʃ>»kˌul.tuvr.rˌɑ.gij
asynkrovdnamohtor+N+Ess	asynkrovdnamohtorin	ˈɑ.syn.krˌovː.tnɑ#mˌoh.tor>in
asynkrovdnamuhtor+N+Pl+Nom	asynkrovdnamuhtorat	ˈɑ.syn.krˌovː.tnɑ#mˌuh.tor>ɑh
asynkrovdnamuhtor+N+Sg+Nom+PxSg2	asynkrovdnamuhtorat	ˈɑ.syn.krˌovː.tnɑ#mˌuh.tor>ɑh
asynkrovdnamuhtor+N+Der/geahtes+A+Attr	asynkrovdnamuhtorkeahtes	ˈɑ.syn.krˌovː.tnɑ#mˌuh.tor>»kˌĕɑh.tes
asynkrovdnamuhtor+N+Der/viđá+Adv	asynkrovdnamuhtorviđá	ˈɑ.syn.krˌovː.tnɑ#mˌuh.tor»vˌi.ðá
asynkrovdnamutuvra+N+Der/viđá+Adv	asynkrovdnamutuvraviđá	ˈɑ.syn.krˌovː.tnɑ#mˌu.tuv.rɑ»vˌi.ðá
asynkrovdnamutuvra+N+Sg+Ill	asynkrovdnamutuvrii	ˈɑ.syn.krˌovː.tnɑ#mˌu.tuv.ri>i
asbeasta+N+Sg+Ill	asbestii	ˈɑs.bes.ti>i
asbeasta+N+Der/huvva+V+IV+Imprt+Pl1	asbeasttahuvvut	ˈɑs.beɑs.tɑ»hˌuv.vu>h
asiáhta+N+Sg+Ill	asiáhtii	ˈɑ.si.ˌáh.ti>i
aspirántakursa+N+Der/huvva+V+IV+Imprt+Sg2	aspirántakurssahuva	ˈɑsː.pi.rˌánː.tɑ#khˌurs.sɑ»hˌu.vɑ>
assimilerenpolitihkka+N+Der/Dimin+N+Sg+Nom+PxPl3	assimilerenpolitihkažeaset	ˈɑs.si.mˌi.le.ren#phˌo.li.tˌih.kɑ»žˌĕɑ.seh
assonánsa+N+Pl+Nom	assonánssat	ˈɑs.so.nˌáns.sɑ>h
assonánsa+N+Sg+Gen+PxSg2	assonánssat	ˈɑs.so.nˌáns.sɑ>h
assosiašuvdna+N+Sg+Nom+PxSg3	assosiašuvdnas	ˈɑs.so.sˌi.ɑ.ʃˌuv.tnɑ>s
assosiašuvdna+N+Der/Dimin+N+Der/viđá+Adv	assosiašuvnnašviđá	ˈɑs.so.sˌi.ɑ.ʃˌuvn.nɑ»ʃ»vˌi.ðá
astronoma+N+Sg+Ill	astronomii	ˈɑst.ro.nˌo.mi>i
asymptohtta+N+Sg+Ill	asymptohttii	ˈɑ.symp.tˌohː.ti>i
atropiidna+N+Sg+Nom+PxSg3	atropiidnas	ˈɑ.tro.pˌij.tnɑ>s
atropiidna+N+Sg+Ill	atropiidnii	ˈɑ.tro.pˌij.tni>i
atropiidna+N+Der/huvva+V+IV+Ger	atropiinnahuvadiin	ˈɑ.tro.pˌijn.nɑ»hˌu.vɑ>dijn
atropiidna+N+Der/laš+A+Der/vuohta+N+Sg+Ill	atropiinnalašvuhtii	ˈɑ.tro.pˌijn.nɑ»lɑʃ»vˌuh.ti>i
atnuareála+N+Sg+Com+PxDu3	atnuareálaineaskka	ˈɑt.nu#ˌɑ.re.ˌá.lɑ>i.neɑs.kɑ
attribuhtta+N+Sg+Ill	attribuhttii	ˈɑt.tri.bˌuhː.ti>i
attribuhttahápmi+N+Der/viđá+Adv	attribuhttahápmeviđá	ˈɑt.tri.bˌuhː.tɑ#hˌáp.me»vˌi.ðá
atteasta+N+Sg+Ill	attestii	ˈɑt.tes.ti>i
auberšiidna+N+Sg+Nom+PxDu3	auberšiidnaska	ˈɑu.ber.ʃˌij.tnɑ>skɑ
audio+N+Pl+Com	audioiguin	ˈɑu.dio>i.gujn
austromarxisma+N+Sg+Ill	austromarxismii	ˈɑust.ro#mˌɑrks.is.mi>i
austromarxisma+N+Sg+Acc+PxSg2	austromarxismmat	ˈɑust.ro#mˌɑrks.is.mɑ>h
aviisa+N+Sg+Ill	aviisii	ˈɑ.vij.si>i
avistaveksel+N+Pl+Nom	avistavekselat	ˈɑ.vis.tɑ#vˌekː.sel>ɑh
avokádo+N+Ess+PxSg2	avokádonat	ˈɑ.vo.kˌá.do>nɑh
avokádo+N+Pl+Nom	avokádot	ˈɑ.vo.kˌá.do>h
avokádo+N+Sg+Gen+PxPl1	avokádomet	ˈɑ.vo.kˌá.do>meh
avokádo+N+Sg+Ill	avokádoi	ˈɑ.vo.kˌá.do>i
avánsa+N+Der/viđá+Adv	avánsaviđá	ˈɑ.ván.sɑ»vˌi.ðá
avánsa+N+Der/Dimin+N+Sg+Nom	avánssaš	ˈɑ.váns.sɑ»ʃ
avánsa+N+Der/laš+A+Comp+Sg+Nom	avánssalit	ˈɑ.váns.sɑ»lit>
ayoreo+N+Ess+PxDu1	ayoreoneame	ˈɑyo.re.o>nĕɑ.me
ayoreo+N+Pl+Com	ayoreoiguin	ˈɑyo.re.o>i.gujn
ayoreo+N+Pl+Loc+PxPl2	ayoreoineattet	ˈɑyo.re.o>i.nĕɑt.teh
ayoreo+N+Sg+Com+PxDu2	ayoreoineatte	ˈɑyo.re.o>i.nĕɑt.te
ayoreo+N+Sg+Com+PxPl1	ayoreoineamet	ˈɑyo.re.o>i.nĕɑ.meh
ayoreo+N+Sg+Ill+PxSg2	ayoreosat	ˈɑyo.re.o>sɑh
ayoreo+N+Der/huhtti+V+TV+Ger	ayoreohuhtidettiin	ˈɑyo.re.o>»hˌuh.ti.dˌet.tijn
aššurlaš+N+Sg+Nom	aššurlaš	ˈɑʃː.ʃur.lɑʃ>
akšuvdnabeaivi+N+Pl+Acc+PxDu3	ákšunbeivviideaskka	ˈákː.ʃun#bˌejv.vi>i.deɑs.kɑ
akšuvdnabeaivi+N+Pl+Acc+PxPl1	ákšunbeivviideamet	ˈákː.ʃun#bˌejv.vi>i.dĕɑ.meh
akšuvdnabeaivi+N+Pl+Acc+PxSg3	ákšunbeivviidis	ˈákː.ʃun#bˌejv.vi>i.dis
akšuvdnabeaivi+N+Pl+Com+PxDu1	ákšunbeivviideameguin	ˈákː.ʃun#bˌejv.vi>i.dĕɑ.me.gujn
akšuvdnabeaivi+N+Pl+Com+PxDu2	ákšunbeivviideatteguin	ˈákː.ʃun#bˌejv.vi>i.dĕɑt.te.gujn
akšuvdnabeaivi+N+Pl+Com+PxPl1	ákšunbeivviideametguin	ˈákː.ʃun#bˌejv.vi>i.dĕɑ.met.gujn
akšuvdnabeaivi+N+Pl+Com+PxSg2	ákšunbeivviidatguin	ˈákː.ʃun#bˌejv.vi>i.dɑt.gujn
akšuvdnabeaivi+N+Pl+Com+PxSg3	ákšunbeivviidisguin	ˈákː.ʃun#bˌejv.vi>i.dis.gujn
akšuvdnabeaivi+N+Pl+Com	ákšunbeivviiguin	ˈákː.ʃun#bˌejv.vi>i.gujn
akšuvdnabeaivi+N+Pl+Gen+PxPl1	ákšunbeivviideamet	ˈákː.ʃun#bˌejv.vi>i.dĕɑ.meh
akšuvdnabeaivi+N+Pl+Gen+PxSg3	ákšunbeivviidis	ˈákː.ʃun#bˌejv.vi>i.dis
akšuvdnabeaivi+N+Pl+Ill+PxPl1	ákšunbeivviidasamet	ˈákː.ʃun#bˌejv.vi>i.dɑ.sɑ.meh
akšuvdnabeaivi+N+Pl+Ill	ákšunbeivviide	ˈákː.ʃun#bˌejv.vi>i.de
akšuvdnabeaivi+N+Pl+Loc+PxDu3	ákšunbeivviineaskka	ˈákː.ʃun#bˌejv.vi>i.neɑs.kɑ
akšuvdnabeaivi+N+Pl+Loc+PxSg2	ákšunbeivviinat	ˈákː.ʃun#bˌejv.vi>i.nɑh
akšuvdnabeaivi+N+Pl+Nom+PxDu1	ákšunbeivviideame	ˈákː.ʃun#bˌejv.vi>i.dĕɑ.me
akšuvdnabeaivi+N+Pl+Nom+PxDu2	ákšunbeivviideatte	ˈákː.ʃun#bˌejv.vi>i.dĕɑt.te
akšuvdnabeaivi+N+Pl+Nom+PxDu3	ákšunbeivviideaskka	ˈákː.ʃun#bˌejv.vi>i.deɑs.kɑ
akšuvdnabeaivi+N+Pl+Nom+PxPl3	ákšunbeivviideaset	ˈákː.ʃun#bˌejv.vi>i.dĕɑ.seh
akšuvdnabeaivi+N+Pl+Nom+PxSg2	ákšunbeivviidat	ˈákː.ʃun#bˌejv.vi>i.dɑh
akšuvdnabeaivi+N+Pl+Nom+PxSg3	ákšunbeivviidis	ˈákː.ʃun#bˌejv.vi>i.dis
akšuvdnabeaivi+N+Sg+Com+PxDu1	ákšunbeivviineame	ˈákː.ʃun#bˌejv.vi>i.nĕɑ.me
akšuvdnabeaivi+N+Sg+Com+PxDu3	ákšunbeivviineaskka	ˈákː.ʃun#bˌejv.vi>i.neɑs.kɑ
akšuvdnabeaivi+N+Sg+Com+PxPl2	ákšunbeivviineattet	ˈákː.ʃun#bˌejv.vi>i.nĕɑt.teh
akšuvdnabeaivi+N+Sg+Com+PxPl3	ákšunbeivviineaset	ˈákː.ʃun#bˌejv.vi>i.nĕɑ.seh
akšuvdnabeaivi+N+Sg+Com+PxSg1	ákšunbeivviinan	ˈákː.ʃun#bˌejv.vi>i.nɑn
akšuvdnabeaivi+N+Sg+Com+PxSg2	ákšunbeivviinat	ˈákː.ʃun#bˌejv.vi>i.nɑh
akšuvdnabeaivi+N+Sg+Com+PxSg3	ákšunbeivviinis	ˈákː.ʃun#bˌejv.vi>i.nis
akšuvdnabeaivi+N+Sg+Com	ákšunbeivviin	ˈákː.ʃun#bˌejv.vi>in
akšuvdnabeaivi+N+Der/viđá+Adv	ákšunbeaiveviđá	ˈákː.ʃun#bˌĕɑjː.ve»vˌi.ðá
akšuvdnabeaivi+N+Ess+PxDu3	ákšunbeaivineaskka	ˈákː.ʃun#bˌĕɑjː.vi>neɑs.kɑ
akšuvdnabeaivi+N+Ess+PxPl3	ákšunbeaivineaset	ˈákː.ʃun#bˌĕɑjː.vi>nĕɑ.seh
akšuvdnabeaivi+N+Ess+PxSg2	ákšunbeaivinat	ˈákː.ʃun#bˌĕɑjː.vi>nɑh
akšuvdnabeaivi+N+Sg+Nom	ákšunbeaivi	ˈákː.ʃun#bˌĕɑjː.vi>
akšuvdnabeaivi+N+Sg+Gen+PxDu1	ákšunbeaiváme	ˈákː.ʃun#bˌĕɑjː.vá>me
akšuvdnabeaivi+N+Sg+Ill+PxDu3	ákšunbeaiváseaskka	ˈákː.ʃun#bˌĕɑjː.vá>seɑs.kɑ
akšuvdnabeaivi+N+Sg+Nom+PxPl1	ákšunbeaivámet	ˈákː.ʃun#bˌĕɑjː.vá>meh
akšuvdnabeaivi+N+Sg+Ill	ákšunbeaivái	ˈákː.ʃun#bˌĕɑjː.vá>i
akšuvdnabeaivi+N+Sg+Gen+Allegro	ákšunbeaivve	ˈákː.ʃun#bˌĕɑjv.ve>
akšuvdnabeaivi+N+Der/heapmi+A+Attr+Der/vuohta+N+Pl+Nom	ákšunbeaivvehisvuođat	ˈákː.ʃun#bˌĕɑjv.ve»his>»vˌuo.ðɑh
akšuvdnabeaivi+N+Der/huvva+V+IV+Imprt+Du2	ákšunbeaivvehuvvi	ˈákː.ʃun#bˌĕɑjv.ve»hˌuv.vi>
akšuvdnabeaivi+N+Der/huvva+V+IV+Imprt+ConNegII	ákšunbeaivvehuvvo	ˈákː.ʃun#bˌĕɑjv.ve»hˌuv.vo>
akšuvdnabeaivi+N+Sg+Acc+PxDu3	ákšunbeaivviska	ˈákː.ʃun#bˌeɑjv.vi>skɑ
akšuvdnabeaivi+N+Sg+Acc+PxPl3	ákšunbeaivviset	ˈákː.ʃun#bˌeɑjv.vi>seh
akšuvdnabeaivi+N+Sg+Loc	ákšunbeaivvis	ˈákː.ʃun#bˌeɑjv.vi>s
akšuvdnabeaivi+N+Der/heapmi+A+Comp+Ess	ákšunbeaivviheabbon	ˈákː.ʃun#bˌeɑjv.vi»hˌĕɑb.bo>n
akšuvdnabeaivi+N+Der/heapmi+A+Ess	ákšunbeaivviheapmin	ˈákː.ʃun#bˌeɑjv.vi»hˌeɑp.mi>n
akšuvdnabeaivi+N+Der/heapmi+A+Attr	ákšunbeaivvihis	ˈákː.ʃun#bˌeɑjv.vi»his>
akšuvdnabeaivi+N+Der/huhtti+V+TV+Ger+PxSg2	ákšunbeaivvihuhtedettiinat	ˈákː.ʃun#bˌeɑjv.vi»hˌuh.te>det.tij.nɑh
akšuvdnabeaivi+N+Der/huhtti+V+TV+VAbess	ákšunbeaivvihuhtihaga	ˈákː.ʃun#bˌeɑjv.vi»hˌuh.ti>hɑ.gɑ
akšuvdnabeaivi+N+Der/huvva+V+IV+Der/muš+N+Pl+Nom+PxDu1	ákšunbeaivvihuvvamušaideame	ˈákː.ʃun#bˌeɑjv.vi»hˌuv.vɑ>»mˌu.ʃɑj.dˌĕɑ.me
akšuvdnabeaivi+N+Sg+Gen+PxDu2	ákšunbeaivváde	ˈákː.ʃun#bˌeɑjv.vá>de
akšuvdnabeaivi+N+Der/Dimin+N+Sg+Nom	ákšunbeaivváš	ˈákː.ʃun#bˌeɑjv.vá»ʃ
akšuvdnabeaivi+N+Der/Dimin+N+Der/viđá+Adv	ákšunbeaivvášviđá	ˈákː.ʃun#bˌeɑjv.vá»ʃ»vˌi.ðá
akšuvdnabeaivi+N+Der/Dimin+N+Ess	ákšunbeaivvážin	ˈákː.ʃun#bˌeɑjv.vá»žin
akšuvdnabeaivi+N+Der/Dimin+N+Der/Dimin+N+Sg+Ill+PxDu1	ákšunbeaivvážažžaseame	ˈákː.ʃun#bˌeɑjv.vá»žˌɑž.žɑ>sĕɑ.me
akšuvdnabeaivi+N+Der/laš+A+Comp+Pl+Loc	ákšunbeaivválabbuin	ˈákː.ʃun#bˌeɑjv.vá»lˌɑb.bu>in
akšuvdnabeaivi+N+Der/laš+A+Comp+Sg+Nom	ákšunbeaivválut	ˈákː.ʃun#bˌeɑjv.vá»lut>
akšuvdnabeaivi+N+Der/laš+A+Superl+Ess	ákšunbeaivválamosin	ˈákː.ʃun#bˌeɑjv.vá»lˌɑ.mos>in
akšuvdnabeaivi+N+Der/laš+A+Pl+Com	ákšunbeaivválaččaiguin	ˈákː.ʃun#bˌeɑjv.vá»lˌɑč.čɑ>i.gujn
akšuvdnabeaivi+N+Der/laš+A+AttrCmp+Der/ivnnat+A+Pl+Gen	ákšunbeaivválašivnnagiid	ˈákː.ʃun#bˌeɑjv.vá»lɑʃ>»ˌivn.nɑ.gijh
bakteriija+N+Pl+Nom	bakteriijat	bˈɑkː.hte.rˌij.jɑ>h
bakteriija+N+Der/viđá+Adv	bakteriijaviđá	bˈɑkː.hte.rˌij.jɑ>»vˌi.ðá
bakteriija+N+Sg+Ill	bakteriijii	bˈɑkː.hte.rˌij.ji>i
bakteriologiija+N+Sg+Ill	bakteriologiijii	bˈɑkː.hte.rˌio.lo.gˌij.ji>i
barbariija+N+Der/huhtti+V+TV+Imprt+Pl2	barbariijahuhttet	bˈɑrː.bɑː.rˌij.jɑ»hˌuhː.te>h
barbariija+N+Sg+Ill	barbariijii	bˈɑrː.bɑː.rˌij.ji>i
bargoaddistrategiija+N+Ess+PxPl2	bargoaddistrategiijaneattet	bˈɑrː.go#ˌɑd.di#strˌɑ.te.gˌij.jɑ>nĕɑt.teh
baroniija+N+Der/heapmi+A+Sg+Loc	baroniijaheamis	bˈɑ.ro.nˌij.jɑ»hˌeɑ.mi>s
baroniija+N+Sg+Ill	baroniijii	bˈɑ.ro.nˌij.ji>i
batiija+N+Der/heapmi+A+Ess	batiijaheapmin	bˈɑ.tij.jɑ»hˌeɑp.mi>n
batiija+N+Der/huhtti+V+TV+VAbess	batiijahuhtihaga	bˈɑ.tij.jɑ»hˌuh.ti>hɑ.gɑ
batiija+N+Sg+Ill	batiijii	bˈɑ.tij.ji>i
batteriija+N+Sg+Acc+PxSg3	batteriijas	bˈɑt.te.rˌij.jɑ>s
batteriija+N+Der/viđá+Adv	batteriijaviđá	bˈɑt.te.rˌij.jɑ>»vˌi.ðá
batteriija+N+Der/Dimin+N+Sg+Ill+PxDu1	batteriijažasame	bˈɑt.te.rˌij.jɑ»žˌɑ.sɑ>me
batteriija+N+Der/huhtti+V+TV+Pot+Prs+Du3	batteriijahuhtežeaba	bˈɑt.te.rˌij.jɑ»hˌuh.te>žeɑ.bɑ
batteriija+N+Der/huvva+V+IV+Ger	batteriijahuvadin	bˈɑt.te.rˌij.jɑ»hˌu.vɑ>din
batteriija+N+Sg+Ill	batteriijii	bˈɑt.te.rˌij.ji>i
bearašterapiija+N+Sg+Loc	bearašterapiijas	bˈeɑ.rɑʃ#thˌe.rɑ.pˌij.jɑ>s
bearašterapiija+N+Der/Dimin+N+Der/viđá+Adv	bearašterapiijašviđá	bˈeɑ.rɑʃ#thˌe.rɑ.pˌij.jɑ»ʃ»vˌi.ðá
bearašterapiija+N+Der/heapmi+A+Attr	bearašterapiijahis	bˈeɑ.rɑʃ#thˌe.rɑ.pˌij.jɑ»his>
bearašterapiija+N+Der/huvva+V+IV+ConNegII	bearašterapiijahuvvo	bˈeɑ.rɑʃ#thˌe.rɑ.pˌij.jɑ»hˌuv.vo>
bearašterapiija+N+Sg+Ill	bearašterapiijii	bˈeɑ.rɑʃ#thˌe.rɑ.pˌij.ji>i
bearaštragediija+N+Ess+PxDu1	bearaštragediijaneame	bˈeɑ.rɑʃ#trˌɑ.ge.dˌij.jɑ>nĕɑ.me
bearaštragediija+N+Sg+Com+PxDu3	bearaštragediijaineaskka	bˈeɑ.rɑʃ#trˌɑ.ge.dˌij.jɑ>i.neɑs.kɑ
bearaštragediija+N+Sg+Ill	bearaštragediijai	bˈeɑ.rɑʃ#trˌɑ.ge.dˌij.jɑ>i
bearaštragediija+N+Der/viđá+Adv	bearaštragediijaviđá	bˈeɑ.rɑʃ#trˌɑ.ge.dˌij.jɑ>»vˌi.ðá
bearaštragediija+N+Der/heapmi+A+Attr	bearaštragediijahis	bˈeɑ.rɑʃ#trˌɑ.ge.dˌij.jɑ»his>
bearaštragediija+N+Der/heapmi+A+Attr+Der/vuohta+N+Ess+PxSg1	bearaštragediijahisvuohtanan	bˈeɑ.rɑʃ#trˌɑ.ge.dˌij.jɑ»his>»vˌuoh.tɑ.nɑn
bearaštragediija+N+Sg+Ill	bearaštragediijii	bˈeɑ.rɑʃ#trˌɑ.ge.dˌij.ji>i
bibliografiija+N+Der/viđá+Adv	bibliografiijaviđá	bˈib.lio.grˌɑ.fij.jɑ>»vˌi.ðá
bibliografiija+N+Der/huvva+V+IV+Imprt+Pl2	bibliografiijahuvvit	bˈib.lio.grˌɑ.fij.jɑ»hˌuv.vi>h
bibliografiija+N+Der/huvva+V+IV+Imprt+Sg3	bibliografiijahuvvos	bˈib.lio.grˌɑ.fij.jɑ»hˌuv.vo>s
bibliografiija+N+Sg+Ill	bibliografiijii	bˈib.lio.grˌɑ.fij.ji>i
bigamiija+N+Der/Dimin+N+Ess	bigamiijažin	bˈi.gɑː.mˌij.jɑ»žin
bigamiija+N+Der/heapmi+A+Comp+Sg+Nom	bigamiijahut	bˈi.gɑː.mˌij.jɑ»hut>
bigamiija+N+Der/heapmi+A+Attr+Der/vuohta+N+Sg+Ill	bigamiijahisvuhtii	bˈi.gɑː.mˌij.jɑ»his>»vˌuh.tij
bigamiija+N+Der/huvva+V+IV+Ind+Prt+Pl2	bigamiijahuvaidet	bˈi.gɑː.mˌij.jɑ»hˌu.vɑ>i.deh
bigamiija+N+Sg+Ill	bigamiijii	bˈi.gɑː.mˌij.ji>i
bijouteriija+N+Sg+Acc+PxSg2	bijouteriijat	bˈi.jou.tˌe.rij.jɑ>h
bijouteriija+N+Sg+Ill	bijouteriijii	bˈi.jou.tˌe.rij.ji>i
birasgáhttenstrategiija+N+Der/huhtti+V+TV+Imprt+ConNeg	birasgáhttenstrategiijahuhte	bˈi.rɑːs#gˌɑhː.ten#strˌɑ.te.gˌij.jɑ»hˌuh.te>
birasgáhttenstrategiija+N+Der/laš+A+Der/vuohta+N+Sg+Ill	birasgáhttenstrategiijalašvuhtii	bˈi.rɑːs#gˌɑhː.ten#strˌɑ.te.gˌij.jɑ»lɑʃ»vˌuh.ti>i
birasgáhttenstrategiija+N+Sg+Ill	birasgáhttenstrategiijii	bˈi.rɑːs#gˌɑhː.ten#strˌɑ.te.gˌij.ji>i
birgehallanstrategiija+N+Sg+Ill	birgehallanstrategiijii	bˈirː.ge.hˌɑl.lɑn#strˌɑ.te.gˌij.ji>i
boazotragediija+N+Ess+PxPl2	boazotragediijaneattet	bˈŏɑ.zo#trˌɑ.ge.dˌij.jɑ>nĕɑt.teh
boazotragediija+N+Ess	boazotragediijan	bˈŏɑ.zo#trˌɑ.ge.dˌij.jɑ>n
boazotragediija+N+Pl+Nom	boazotragediijat	bˈŏɑ.zo#trˌɑ.ge.dˌij.jɑ>h
boazotragediija+N+Sg+Acc+PxDu3	boazotragediijaska	bˈŏɑ.zo#trˌɑ.ge.dˌij.jɑ>skɑ
boazotragediija+N+Sg+Loc+PxSg3	boazotragediijastis	bˈŏɑ.zo#trˌɑ.ge.dˌij.jɑ>stis
boazotragediija+N+Der/viđá+Adv	boazotragediijaviđá	bˈŏɑ.zo#trˌɑ.ge.dˌij.jɑ>»vˌi.ðá
boazotragediija+N+Der/Dimin+N+Der/viđá+Adv	boazotragediijašviđá	bˈŏɑ.zo#trˌɑ.ge.dˌij.jɑ»ʃ»vˌi.ðá
boazotragediija+N+Der/heapmi+A+Sg+Com	boazotragediijahemiin	bˈŏɑ.zo#trˌɑ.ge.dˌij.jɑ»hˌe.mi>in
boazotragediija+N+Der/huhtti+V+TV+Cond+Prs+Du1	boazotragediijahuhtášeimme	bˈŏɑ.zo#trˌɑ.ge.dˌij.jɑ»hˌuhː.tá>ʃejm.me
boazotragediija+N+Der/laš+A+Attr+Der/vuohta+N+Sg+Ill	boazotragediijalašvuhtii	bˈŏɑ.zo#trˌɑ.ge.dˌij.jɑ»lɑʃ>»vˌuh.tij
boazotragediija+N+Der/laš+A+Sg+Nom	boazotragediijalaš	bˈŏɑ.zo#trˌɑ.ge.dˌij.jɑ»lɑʃ>
boazotragediija+N+Der/laš+A+Der/vuohta+N+Der/viđá+Adv	boazotragediijalašvuohtaviđá	bˈŏɑ.zo#trˌɑ.ge.dˌij.jɑ»lɑʃ»vˌuoh.tɑ»vˌi.ðá
boazotragediija+N+Sg+Ill	boazotragediijii	bˈŏɑ.zo#trˌɑ.ge.dˌij.ji>i
bramaista+N+Sg+Gen+PxPl1	bramaistamet	brˈɑ.mɑː.ˌisː.tɑ>meh
bramaista+N+Der/viđá+Adv	bramaistaviđá	brˈɑ.mɑː.ˌisː.tɑ»vˌi.ðá
bramaista+N+Sg+Ill	bramaistii	brˈɑ.mɑː.ˌisː.ti>i
bramaista+N+Pl+Nom	bramaisttat	brˈɑ.mɑː.ˌis.tɑ>h
bramaista+N+Der/huvva+V+IV+VAbess	bramaisttahuvahaga	brˈɑ.mɑː.ˌis.tɑ»hˌu.vɑ>hɑ.gɑ
bramaista+N+Der/huvva+V+IV+Imprt+Pl2	bramaisttahuvvet	brˈɑ.mɑː.ˌis.tɑ»hˌuv.ve>h
bramanista+N+Sg+Ill+PxDu1	bramanistaseame	brˈɑ.mɑː.nˌisː.tɑ>sĕɑ.me
bramanista+N+Der/viđá+Adv	bramanistaviđá	brˈɑ.mɑː.nˌisː.tɑ»vˌi.ðá
bramanista+N+Sg+Ill	bramanistii	brˈɑ.mɑː.nˌisː.ti>i
bramanista+N+Pl+Gen+PxDu3	bramanisttaideaskka	brˈɑ.mɑː.nˌis.tɑ>i.deɑs.kɑ
bramanista+N+Der/Dimin+N+Sg+Nom	bramanisttaš	brˈɑ.mɑː.nˌis.tɑ»ʃ
bramanista+N+Der/Dimin+N+Sg+Acc+PxDu1	bramanisttažeame	brˈɑ.mɑː.nˌis.tɑ»žˌĕɑ.me
bramanista+N+Der/huhtti+V+TV+VAbess	bramanisttahuhtikeahttá	brˈɑ.mɑː.nˌis.tɑ»hˌuh.ti>kĕɑhː.tá
bramanista+N+Der/huhtti+V+TV+ConNegII	bramanisttahuhtto	brˈɑ.mɑː.nˌis.tɑ»hˌuhː.to>
bramanista+N+Der/laš+A+Der/vuohta+N+Sg+Ill	bramanisttalašvuhtii	brˈɑ.mɑː.nˌis.tɑ»lɑʃ»vˌuh.ti>i
buohcceviessostrategiija+N+Pl+Acc+PxSg2	buohcceviessostrategiijaidat	bˈŭohk.se#vˌĭes.so#strˌɑ.te.gˌij.jɑ>i.dɑh
buohcceviessostrategiija+N+Pl+Nom	buohcceviessostrategiijat	bˈŭohk.se#vˌĭes.so#strˌɑ.te.gˌij.jɑ>h
buohcceviessostrategiija+N+Der/viđá+Adv	buohcceviessostrategiijaviđá	bˈŭohk.se#vˌĭes.so#strˌɑ.te.gˌij.jɑ>»vˌi.ðá
buohcceviessostrategiija+N+Der/huhtti+V+TV+Actio+Com	buohcceviessostrategiijahuhttimiin	bˈŭohk.se#vˌĭes.so#strˌɑ.te.gˌij.jɑ»hˌuhː.ti>mijn
buohcceviessostrategiija+N+Der/huvva+V+IV+Imprt+Sg2	buohcceviessostrategiijahuva	bˈŭohk.se#vˌĭes.so#strˌɑ.te.gˌij.jɑ»hˌu.vɑ>
buohcceviessostrategiija+N+Der/huvva+V+IV+VGen	buohcceviessostrategiijahuva	bˈŭohk.se#vˌĭes.so#strˌɑ.te.gˌij.jɑ»hˌu.vɑ>
buohcceviessostrategiija+N+Der/huvva+V+IV+Imprt+Pl2	buohcceviessostrategiijahuvvit	bˈŭohk.se#vˌĭes.so#strˌɑ.te.gˌij.jɑ»hˌuv.vi>h
buohcceviessostrategiija+N+Der/huvva+V+IV+Imprt+Du1	buohcceviessostrategiijahuvvu	bˈŭohk.se#vˌĭes.so#strˌɑ.te.gˌij.jɑ»hˌuv.vu>
buohcceviessostrategiija+N+Der/laš+A+Comp+Attr	buohcceviessostrategiijalit	bˈŭohk.se#vˌĭes.so#strˌɑ.te.gˌij.jɑ»lit>
buohcceviessostrategiija+N+Der/laš+A+Der/vuohta+N+Sg+Ill	buohcceviessostrategiijalašvuhtii	bˈŭohk.se#vˌĭes.so#strˌɑ.te.gˌij.jɑ»lɑʃ»vˌuh.ti>i
buohcceviessostrategiija+N+Sg+Ill	buohcceviessostrategiijii	bˈŭohk.se#vˌĭes.so#strˌɑ.te.gˌij.ji>i
ceavzinstrategiija+N+Ess+PxSg2	ceavzinstrategiijanat	sˈeɑv.zin#strˌɑ.te.gˌij.jɑ>nɑh
ceavzinstrategiija+N+Pl+Com+PxSg1	ceavzinstrategiijaidanguin	sˈeɑv.zin#strˌɑ.te.gˌij.jɑ>i.dɑn.gujn
ceavzinstrategiija+N+Pl+Gen+PxPl3	ceavzinstrategiijaideaset	sˈeɑv.zin#strˌɑ.te.gˌij.jɑ>i.dĕɑ.seh
ceavzinstrategiija+N+Pl+Gen+PxSg2	ceavzinstrategiijaidat	sˈeɑv.zin#strˌɑ.te.gˌij.jɑ>i.dɑh
ceavzinstrategiija+N+Pl+Gen	ceavzinstrategiijaid	sˈeɑv.zin#strˌɑ.te.gˌij.jɑ>id
ceavzinstrategiija+N+Sg+Gen+PxSg2	ceavzinstrategiijat	sˈeɑv.zin#strˌɑ.te.gˌij.jɑ>h
ceavzinstrategiija+N+Sg+Gen	ceavzinstrategiija	sˈeɑv.zin#strˌɑ.te.gˌij.jɑ>
ceavzinstrategiija+N+Sg+Com+PxDu1	ceavzinstrategiijaineame	sˈeɑv.zin#strˌɑ.te.gˌij.jɑ>i.nĕɑ.me
ceavzinstrategiija+N+Sg+Com+PxSg1	ceavzinstrategiijainan	sˈeɑv.zin#strˌɑ.te.gˌij.jɑ>i.nɑn
ceavzinstrategiija+N+Sg+Ill	ceavzinstrategiijai	sˈeɑv.zin#strˌɑ.te.gˌij.jɑ>i
ceavzinstrategiija+N+Sg+Loc	ceavzinstrategiijas	sˈeɑv.zin#strˌɑ.te.gˌij.jɑ>s
ceavzinstrategiija+N+Der/viđá+Adv	ceavzinstrategiijaviđá	sˈeɑv.zin#strˌɑ.te.gˌij.jɑ>»vˌi.ðá
ceavzinstrategiija+N+Der/Dimin+N+Der/viđá+Adv	ceavzinstrategiijašviđá	sˈeɑv.zin#strˌɑ.te.gˌij.jɑ»ʃ»vˌi.ðá
ceavzinstrategiija+N+Der/heapmi+A+Comp+Sg+Com	ceavzinstrategiijahabbuin	sˈeɑv.zin#strˌɑ.te.gˌij.jɑ»hˌɑb.bu>in
ceavzinstrategiija+N+Der/heapmi+A+Comp+Sg+Com	ceavzinstrategiijaheappuin	sˈeɑv.zin#strˌɑ.te.gˌij.jɑ»hˌeɑp.pu>in
ceavzinstrategiija+N+Der/heapmi+A+Sg+Loc	ceavzinstrategiijaheames	sˈeɑv.zin#strˌɑ.te.gˌij.jɑ»hˌĕɑ.me>s
ceavzinstrategiija+N+Der/huhtti+V+TV+Ind+Prs+Sg1	ceavzinstrategiijahuhtán	sˈeɑv.zin#strˌɑ.te.gˌij.jɑ»hˌuhː.tá>n
ceavzinstrategiija+N+Der/huhtti+V+TV+Sup	ceavzinstrategiijahuhtážit	sˈeɑv.zin#strˌɑ.te.gˌij.jɑ»hˌuhː.tá>žih
ceavzinstrategiija+N+Der/huvva+V+IV+Imprt+Sg2	ceavzinstrategiijahuva	sˈeɑv.zin#strˌɑ.te.gˌij.jɑ»hˌu.vɑ>
ceavzinstrategiija+N+Der/huvva+V+IV+VAbess	ceavzinstrategiijahuvahaga	sˈeɑv.zin#strˌɑ.te.gˌij.jɑ»hˌu.vɑ>hɑ.gɑ
ceavzinstrategiija+N+Der/huvva+V+IV+VAbess	ceavzinstrategiijahuvakeahttá	sˈeɑv.zin#strˌɑ.te.gˌij.jɑ»hˌu.vɑ>kĕɑhː.tá
ceavzinstrategiija+N+Der/huvva+V+IV+Imprt+Du2	ceavzinstrategiijahuvvi	sˈeɑv.zin#strˌɑ.te.gˌij.jɑ»hˌuv.vi>
ceavzinstrategiija+N+Der/huvva+V+IV+Imprt+Pl2	ceavzinstrategiijahuvvit	sˈeɑv.zin#strˌɑ.te.gˌij.jɑ»hˌuv.vi>h
ceavzinstrategiija+N+Der/laš+A+Comp+Sg+Nom	ceavzinstrategiijalat	sˈeɑv.zin#strˌɑ.te.gˌij.jɑ»lɑt>
ceavzinstrategiija+N+Der/laš+A+Attr	ceavzinstrategiijalaš	sˈeɑv.zin#strˌɑ.te.gˌij.jɑ»lɑʃ>
ceavzinstrategiija+N+Der/laš+A+Der/vuohta+N+Sg+Ill	ceavzinstrategiijalašvuhtii	sˈeɑv.zin#strˌɑ.te.gˌij.jɑ»lɑʃ»vˌuh.ti>i
ceavzinstrategiija+N+Der/laš+A+Der/vuohta+N+Sg+Nom+PxDu3	ceavzinstrategiijalašvuohtaska	sˈeɑv.zin#strˌɑ.te.gˌij.jɑ»lɑʃ»vˌuoh.tɑ>skɑ
ceavzinstrategiija+N+Sg+Ill	ceavzinstrategiijii	sˈeɑv.zin#strˌɑ.te.gˌij.ji>i
cyberstrategiija+N+Pl+Loc	cyberstrategiijain	sˈy.ber#strˌɑ.te.gˌij.jɑ>in
cyberstrategiija+N+Sg+Acc+PxDu3	cyberstrategiijaska	sˈy.ber#strˌɑ.te.gˌij.jɑ>skɑ
cyberstrategiija+N+Sg+Nom+PxPl1	cyberstrategiijamet	sˈy.ber#strˌɑ.te.gˌij.jɑ>meh
cyberstrategiija+N+Sg+Nom+PxPl3	cyberstrategiijaset	sˈy.ber#strˌɑ.te.gˌij.jɑ>seh
cyberstrategiija+N+Sg+Com+PxSg3	cyberstrategiijainis	sˈy.ber#strˌɑ.te.gˌij.jɑ>i.nis
cyberstrategiija+N+Sg+Ill+PxSg1	cyberstrategiijasan	sˈy.ber#strˌɑ.te.gˌij.jɑ>sɑn
cyberstrategiija+N+Sg+Ill+PxSg2	cyberstrategiijasat	sˈy.ber#strˌɑ.te.gˌij.jɑ>sɑh
cyberstrategiija+N+Sg+Loc+PxPl1	cyberstrategiijasteamet	sˈy.ber#strˌɑ.te.gˌij.jɑ>stĕɑ.meh
cyberstrategiija+N+Der/viđá+Adv	cyberstrategiijaviđá	sˈy.ber#strˌɑ.te.gˌij.jɑ>»vˌi.ðá
cyberstrategiija+N+Der/Dimin+N+Sg+Nom	cyberstrategiijaš	sˈy.ber#strˌɑ.te.gˌij.jɑ»ʃ
cyberstrategiija+N+Der/Dimin+N+Der/viđá+Adv	cyberstrategiijašviđá	sˈy.ber#strˌɑ.te.gˌij.jɑ»ʃ»vˌi.ðá
cyberstrategiija+N+Der/Dimin+N+Pl+Com+PxSg1	cyberstrategiijažiiddánguin	sˈy.ber#strˌɑ.te.gˌij.jɑ»žˌijd.dá>ngujn
cyberstrategiija+N+Der/heapmi+A+Comp+Sg+Ill	cyberstrategiijahebbui	sˈy.ber#strˌɑ.te.gˌij.jɑ»hˌeb.bu>i
cyberstrategiija+N+Der/heapmi+A+Sg+Gen	cyberstrategiijaheame	sˈy.ber#strˌɑ.te.gˌij.jɑ»hˌĕɑ.me>
cyberstrategiija+N+Der/huhtti+V+TV+Ind+Prs+ConNeg	cyberstrategiijahuhte	sˈy.ber#strˌɑ.te.gˌij.jɑ»hˌuh.te>
cyberstrategiija+N+Der/huhtti+V+TV+Imprt+Pl2	cyberstrategiijahuhttet	sˈy.ber#strˌɑ.te.gˌij.jɑ»hˌuhː.te>h
cyberstrategiija+N+Der/huhtti+V+TV+Imprt+Du1	cyberstrategiijahuhttu	sˈy.ber#strˌɑ.te.gˌij.jɑ»hˌuhː.tu>
cyberstrategiija+N+Der/huvva+V+IV+Cond+Prs+Pl1	cyberstrategiijahuvaleimmet	sˈy.ber#strˌɑ.te.gˌij.jɑ»hˌu.vɑ>lejm.meh
cyberstrategiija+N+Der/huvva+V+IV+Cond+Prs+Sg2	cyberstrategiijahuvaledjet	sˈy.ber#strˌɑ.te.gˌij.jɑ»hˌu.vɑ>lec.ceh
cyberstrategiija+N+Der/huvva+V+IV+Pot+Prs+Sg3	cyberstrategiijahuvaš	sˈy.ber#strˌɑ.te.gˌij.jɑ»hˌu.vɑ>ʃ
cyberstrategiija+N+Der/huvva+V+IV+Imprt+Du2	cyberstrategiijahuvvi	sˈy.ber#strˌɑ.te.gˌij.jɑ»hˌuv.vi>
cyberstrategiija+N+Der/huvva+V+IV+Imprt+Du1	cyberstrategiijahuvvu	sˈy.ber#strˌɑ.te.gˌij.jɑ»hˌuv.vu>
cyberstrategiija+N+Der/laš+A+Comp+Attr	cyberstrategiijalat	sˈy.ber#strˌɑ.te.gˌij.jɑ»lɑt>
cyberstrategiija+N+Der/laš+A+Der/vuohta+N+Sg+Nom+PxDu3	cyberstrategiijalašvuohtaska	sˈy.ber#strˌɑ.te.gˌij.jɑ»lɑʃ»vˌuoh.tɑ>skɑ
cyberstrategiija+N+Der/laš+A+Der/vuohta+N+Der/viđá+Adv	cyberstrategiijalašvuohtaviđá	sˈy.ber#strˌɑ.te.gˌij.jɑ»lɑʃ»vˌuoh.tɑ»vˌi.ðá
cyberstrategiija+N+Sg+Ill	cyberstrategiijii	sˈy.ber#strˌɑ.te.gˌij.ji>i
darwinista+N+Ess+PxSg1	darwinistanan	dˈɑrː.vi.nˌisː.tɑ>nɑn
darwinista+N+Ess+PxSg2	darwinistanat	dˈɑrː.vi.nˌisː.tɑ>nɑh
darwinista+N+Sg+Acc+PxSg1	darwinistan	dˈɑrː.vi.nˌisː.tɑ>n
darwinista+N+Sg+Gen+PxDu1	darwinistame	dˈɑrː.vi.nˌisː.tɑ>me
darwinista+N+Sg+Gen+PxPl1	darwinistamet	dˈɑrː.vi.nˌisː.tɑ>meh
darwinista+N+Sg+Gen+PxSg1	darwinistan	dˈɑrː.vi.nˌisː.tɑ>n
darwinista+N+Sg+Nom+PxDu2	darwinistade	dˈɑrː.vi.nˌisː.tɑ>de
darwinista+N+Der/viđá+Adv	darwinistaviđá	dˈɑrː.vi.nˌisː.tɑ»vˌi.ðá
darwinista+N+Sg+Ill	darwinistii	dˈɑrː.vi.nˌisː.ti>i
darwinista+N+Pl+Com+PxSg2	darwinisttaidatguin	dˈɑrː.vi.nˌis.tɑ>i.dɑt.gujn
darwinista+N+Pl+Com	darwinisttaiguin	dˈɑrː.vi.nˌis.tɑ>i.gujn
darwinista+N+Pl+Gen+PxDu3	darwinisttaideaskka	dˈɑrː.vi.nˌis.tɑ>i.deɑs.kɑ
darwinista+N+Pl+Loc+PxSg2	darwinisttainat	dˈɑrː.vi.nˌis.tɑ>i.nɑh
darwinista+N+Pl+Nom+PxSg1	darwinisttaidan	dˈɑrː.vi.nˌis.tɑ>i.dɑn
darwinista+N+Pl+Nom	darwinisttat	dˈɑrː.vi.nˌis.tɑ>h
darwinista+N+Sg+Acc+PxDu2	darwinisttade	dˈɑrː.vi.nˌis.tɑ>de
darwinista+N+Sg+Com+PxPl2	darwinisttaineattet	dˈɑrː.vi.nˌis.tɑ>i.nĕɑt.teh
darwinista+N+Sg+Com+PxPl3	darwinisttaineaset	dˈɑrː.vi.nˌis.tɑ>i.nĕɑ.seh
darwinista+N+Sg+Com+PxSg2	darwinisttainat	dˈɑrː.vi.nˌis.tɑ>i.nɑh
darwinista+N+Sg+Com+PxSg3	darwinisttainis	dˈɑrː.vi.nˌis.tɑ>i.nis
darwinista+N+Sg+Loc	darwinisttas	dˈɑrː.vi.nˌis.tɑ>s
darwinista+N+Der/Dimin+N+Ess	darwinisttažin	dˈɑrː.vi.nˌis.tɑ»žin
darwinista+N+Der/Dimin+N+Pl+Nom	darwinisttažat	dˈɑrː.vi.nˌis.tɑ»žɑh
darwinista+N+Der/Dimin+N+Sg+Ill+PxSg1	darwinisttažasan	dˈɑrː.vi.nˌis.tɑ»žˌɑ.sɑ>n
darwinista+N+Der/heapmi+A+Comp+Sg+Loc	darwinisttahabbos	dˈɑrː.vi.nˌis.tɑ»hˌɑb.bo>s
darwinista+N+Der/heapmi+A+Attr+Der/vuohta+N+Sg+Loc+PxSg3	darwinisttahisvuođastis	dˈɑrː.vi.nˌis.tɑ»his>»vˌuo.ðɑs.tis
darwinista+N+Der/huhtti+V+TV+Imprt+ConNeg	darwinisttahuhte	dˈɑrː.vi.nˌis.tɑ»hˌuh.te>
darwinista+N+Der/huvva+V+IV+VAbess	darwinisttahuvahaga	dˈɑrː.vi.nˌis.tɑ»hˌu.vɑ>hɑ.gɑ
darwinista+N+Der/huvva+V+IV+Ind+Prs+Sg3	darwinisttahuvvá	dˈɑrː.vi.nˌis.tɑ»hˌuvː.vá>
darwinista+N+Der/laš+A+Comp+Sg+Com	darwinisttaleappuin	dˈɑrː.vi.nˌis.tɑ»lˌeɑp.pu>in
darwinista+N+Der/laš+A+AttrCmp+Der/čuolmmat+A+Der/vuohta+N+Ess+PxSg3	darwinisttalaščuolmmatvuohtanis	dˈɑrː.vi.nˌis.tɑ»lɑʃ>»čˌuolm.mɑh»vˌuoh.tɑ.nis
davviguovllustrategiija+N+Ess+PxDu1	davviguovllustrategiijaneame	dˈɑv.vi#gˌuoβl.lu#strˌɑ.te.gˌij.jɑ>nĕɑ.me
davviguovllustrategiija+N+Pl+Nom	davviguovllustrategiijat	dˈɑv.vi#gˌuoβl.lu#strˌɑ.te.gˌij.jɑ>h
davviguovllustrategiija+N+Sg+Ill	davviguovllustrategiijai	dˈɑv.vi#gˌuoβl.lu#strˌɑ.te.gˌij.jɑ>i
davviguovllustrategiija+N+Sg+Ill+PxPl2	davviguovllustrategiijaseattet	dˈɑv.vi#gˌuoβl.lu#strˌɑ.te.gˌij.jɑ>sĕɑt.teh
davviguovllustrategiija+N+Sg+Loc	davviguovllustrategiijas	dˈɑv.vi#gˌuoβl.lu#strˌɑ.te.gˌij.jɑ>s
davviguovllustrategiija+N+Sg+Loc+PxPl1	davviguovllustrategiijasteamet	dˈɑv.vi#gˌuoβl.lu#strˌɑ.te.gˌij.jɑ>stĕɑ.meh
davviguovllustrategiija+N+Der/viđá+Adv	davviguovllustrategiijaviđá	dˈɑv.vi#gˌuoβl.lu#strˌɑ.te.gˌij.jɑ>»vˌi.ðá
davviguovllustrategiija+N+Der/Dimin+N+Sg+Nom	davviguovllustrategiijaš	dˈɑv.vi#gˌuoβl.lu#strˌɑ.te.gˌij.jɑ»ʃ
davviguovllustrategiija+N+Der/Dimin+N+Pl+Nom	davviguovllustrategiijažat	dˈɑv.vi#gˌuoβl.lu#strˌɑ.te.gˌij.jɑ»žɑh
davviguovllustrategiija+N+Der/Dimin+N+Sg+Gen+PxPl2	davviguovllustrategiijažeattet	dˈɑv.vi#gˌuoβl.lu#strˌɑ.te.gˌij.jɑ»žˌĕɑt.teh
davviguovllustrategiija+N+Der/Dimin+N+Sg+Acc	davviguovllustrategiijaža	dˈɑv.vi#gˌuoβl.lu#strˌɑ.te.gˌij.jɑ»žɑ
davviguovllustrategiija+N+Der/heapmi+A+Comp+Attr	davviguovllustrategiijahit	dˈɑv.vi#gˌuoβl.lu#strˌɑ.te.gˌij.jɑ»hit>
davviguovllustrategiija+N+Der/huhtti+V+TV+Ind+Prs+ConNeg	davviguovllustrategiijahuhte	dˈɑv.vi#gˌuoβl.lu#strˌɑ.te.gˌij.jɑ»hˌuh.te>
davviguovllustrategiija+N+Der/huhtti+V+TV+Ind+Prt+Pl1	davviguovllustrategiijahuhtiimet	dˈɑv.vi#gˌuoβl.lu#strˌɑ.te.gˌij.jɑ»hˌuh.ti>i.meh
davviguovllustrategiija+N+Der/huvva+V+IV+VGen	davviguovllustrategiijahuva	dˈɑv.vi#gˌuoβl.lu#strˌɑ.te.gˌij.jɑ»hˌu.vɑ>
davviguovllustrategiija+N+Der/laš+A+Comp+Sg+Nom	davviguovllustrategiijalet	dˈɑv.vi#gˌuoβl.lu#strˌɑ.te.gˌij.jɑ»let>
davviguovllustrategiija+N+Der/laš+A+Superl+Sg+Acc	davviguovllustrategiijalamosa	dˈɑv.vi#gˌuoβl.lu#strˌɑ.te.gˌij.jɑ»lˌɑ.mos>ɑ
davviguovllustrategiija+N+Der/laš+A+AttrCmp+Der/stábat+A+Pl+Loc	davviguovllustrategiijalašstábagiin	dˈɑv.vi#gˌuoβl.lu#strˌɑ.te.gˌij.jɑ»lɑʃ>»stˌá.bɑ.gijn
davviguovllustrategiija+N+Sg+Ill	davviguovllustrategiijii	dˈɑv.vi#gˌuoβl.lu#strˌɑ.te.gˌij.ji>i
eahpeasymmetriija+N+Pl+Nom+PxPl3	eahpeasymmetriijaideaset	ˈĕɑh.pe#ˌɑ.sym.mˌet.rij.jɑ>i.dĕɑ.seh
eahpeasymmetriija+N+Pl+Nom	eahpeasymmetriijat	ˈĕɑh.pe#ˌɑ.sym.mˌet.rij.jɑ>h
eahpeasymmetriija+N+Sg+Nom+PxSg1	eahpeasymmetriijan	ˈĕɑh.pe#ˌɑ.sym.mˌet.rij.jɑ>n
eahpeasymmetriija+N+Der/heapmi+A+Comp+Attr	eahpeasymmetriijahit	ˈĕɑh.pe#ˌɑ.sym.mˌet.rij.jɑ»hit>
eahpeasymmetriija+N+Der/heapmi+A+Ess	eahpeasymmetriijaheapmin	ˈĕɑh.pe#ˌɑ.sym.mˌet.rij.jɑ»hˌeɑp.mi>n
eahpeasymmetriija+N+Der/huvva+V+IV+Cond+Prs+Du2	eahpeasymmetriijahuvaleidde	ˈĕɑh.pe#ˌɑ.sym.mˌet.rij.jɑ»hˌu.vɑ>lejd.de
eahpeasymmetriija+N+Der/laš+A+Sg+Ill	eahpeasymmetriijalažžii	ˈĕɑh.pe#ˌɑ.sym.mˌet.rij.jɑ»lˌɑž.ži>i
eahpeasymmetriija+N+Sg+Ill	eahpeasymmetriijii	ˈĕɑh.pe#ˌɑ.sym.mˌet.rij.ji>i
ealáhusovddidanstrategiija+N+Sg+Com+PxDu2	ealáhusovddidanstrategiijaineatte	ˈeɑ.lá.hus#ˌoβt.ti.dɑn#strˌɑ.te.gˌij.jɑ>i.nĕɑt.te
ealáhusovddidanstrategiija+N+Der/Dimin+N+Sg+Acc	ealáhusovddidanstrategiijaža	ˈeɑ.lá.hus#ˌoβt.ti.dɑn#strˌɑ.te.gˌij.jɑ»žɑ
ealáhusovddidanstrategiija+N+Der/laš+A+Sg+Nom	ealáhusovddidanstrategiijalaš	ˈeɑ.lá.hus#ˌoβt.ti.dɑn#strˌɑ.te.gˌij.jɑ»lɑʃ>
ealáhusovddidanstrategiija+N+Sg+Ill	ealáhusovddidanstrategiijii	ˈeɑ.lá.hus#ˌoβt.ti.dɑn#strˌɑ.te.gˌij.ji>i
ealáhusstrategiija+N+Sg+Ill	ealáhusstrategiijai	ˈeɑ.lá.hus#strˌɑ.te.gˌij.jɑ>i
ealáhusstrategiija+N+Sg+Loc	ealáhusstrategiijas	ˈeɑ.lá.hus#strˌɑ.te.gˌij.jɑ>s
ealáhusstrategiija+N+Sg+Ill	ealáhusstrategiijii	ˈeɑ.lá.hus#strˌɑ.te.gˌij.ji>i
ekshibisjonista+N+Ess+PxDu2	ekshibisjonistaneatte	ˈek.shi.bˌis.jo.nˌis.tɑ>nĕɑt.te
ekshibisjonista+N+Sg+Ill+PxSg1	ekshibisjonistasan	ˈek.shi.bˌis.jo.nˌis.tɑ>sɑn
ekshibisjonista+N+Der/viđá+Adv	ekshibisjonistaviđá	ˈek.shi.bˌis.jo.nˌis.tɑ»vˌi.ðá
ekshibisjonista+N+Sg+Ill	ekshibisjonistii	ˈek.shi.bˌis.jo.nˌis.ti>i
ekshibisjonista+N+Sg+Com+PxDu1	ekshibisjonisttaineame	ˈek.shi.bˌis.jo.nˌis.tɑ>i.nĕɑ.me
ekshibisjonista+N+Sg+Loc+PxPl2	ekshibisjonisttasteattet	ˈek.shi.bˌis.jo.nˌis.tɑ>stĕɑt.teh
ekshibisjonista+N+Sg+Loc+PxPl3	ekshibisjonisttasteaset	ˈek.shi.bˌis.jo.nˌis.tɑ>stĕɑ.seh
ekshibisjonista+N+Der/heapmi+A+Superl+Sg+Nom	ekshibisjonisttaheamos	ˈek.shi.bˌis.jo.nˌis.tɑ»hˌĕɑ.mos>
ekshibisjonista+N+Der/heapmi+A+Sg+Gen	ekshibisjonisttaheame	ˈek.shi.bˌis.jo.nˌis.tɑ»hˌĕɑ.me>
ekspresjonista+N+Ess+PxDu3	ekspresjonistaneaskka	ˈeks.pres.jˌo.nis.tɑ>neɑs.kɑ
ekspresjonista+N+Sg+Ill	ekspresjonistii	ˈeks.pres.jˌo.nis.ti>i
ekspresjonista+N+Pl+Com	ekspresjonisttaiguin	ˈeks.pres.jˌo.nis.tɑ>i.gujn
ekspresjonista+N+Sg+Acc+PxDu2	ekspresjonisttade	ˈeks.pres.jˌo.nis.tɑ>de
ekspresjonista+N+Sg+Loc+PxPl2	ekspresjonisttasteattet	ˈeks.pres.jˌo.nis.tɑ>stĕɑt.teh
ekspresjonista+N+Der/huvva+V+IV+Imprt+Pl2	ekspresjonisttahuvvit	ˈeks.pres.jˌo.nis.tɑ»hˌuv.vi>h
ekspresjonista+N+Der/huvva+V+IV+Imprt+Du1	ekspresjonisttahuvvu	ˈeks.pres.jˌo.nis.tɑ»hˌuv.vu>
ekspresjonista+N+Der/laš+A+Comp+Attr	ekspresjonisttalit	ˈeks.pres.jˌo.nis.tɑ»lit>
ekspressionista+N+Sg+Ill	ekspressionistii	ˈeks.pres.sˌio.nis.ti>i
ekspressionista+N+Sg+Gen+PxDu2	ekspressionisttade	ˈeks.pres.sˌio.nis.tɑ>de
ekspressionista+N+Der/Dimin+N+Sg+Ill	ekspressionisttažii	ˈeks.pres.sˌio.nis.tɑ»žij
ekspressionista+N+Der/huvva+V+IV+Ger	ekspressionisttahuvadin	ˈeks.pres.sˌio.nis.tɑ»hˌu.vɑ>din
energiijastrategiija+N+Ess+PxPl1	energiijastrategiijaneamet	ˈeː.ner.gˌij.jɑ#strˌɑ.te.gˌij.jɑ>nĕɑ.meh
energiijastrategiija+N+Pl+Ill	energiijastrategiijaide	ˈeː.ner.gˌij.jɑ#strˌɑ.te.gˌij.jɑ>i.de
energiijastrategiija+N+Pl+Nom	energiijastrategiijat	ˈeː.ner.gˌij.jɑ#strˌɑ.te.gˌij.jɑ>h
energiijastrategiija+N+Sg+Ill	energiijastrategiijai	ˈeː.ner.gˌij.jɑ#strˌɑ.te.gˌij.jɑ>i
energiijastrategiija+N+Sg+Ill+PxSg3	energiijastrategiijasis	ˈeː.ner.gˌij.jɑ#strˌɑ.te.gˌij.jɑ>sis
energiijastrategiija+N+Sg+Loc+PxSg3	energiijastrategiijastis	ˈeː.ner.gˌij.jɑ#strˌɑ.te.gˌij.jɑ>stis
energiijastrategiija+N+Der/viđá+Adv	energiijastrategiijaviđá	ˈeː.ner.gˌij.jɑ#strˌɑ.te.gˌij.jɑ>»vˌi.ðá
energiijastrategiija+N+Der/Dimin+N+Der/viđá+Adv	energiijastrategiijašviđá	ˈeː.ner.gˌij.jɑ#strˌɑ.te.gˌij.jɑ»ʃ»vˌi.ðá
energiijastrategiija+N+Der/Dimin+N+Der/Dimin+N+Pl+Nom	energiijastrategiijažaččat	ˈeː.ner.gˌij.jɑ#strˌɑ.te.gˌij.jɑ»žˌɑč.čɑ>h
energiijastrategiija+N+Der/huhtti+V+TV+VAbess+A+Attr	energiijastrategiijahuhtekeahtes	ˈeː.ner.gˌij.jɑ#strˌɑ.te.gˌij.jɑ»hˌuh.te>kĕɑh.tes
energiijastrategiija+N+Der/huhtti+V+TV+VGen	energiijastrategiijahuhti	ˈeː.ner.gˌij.jɑ#strˌɑ.te.gˌij.jɑ»hˌuh.ti>
energiijastrategiija+N+Der/huvva+V+IV+Cond+Prs+Sg2	energiijastrategiijahuvašedjet	ˈeː.ner.gˌij.jɑ#strˌɑ.te.gˌij.jɑ»hˌu.vɑ>ʃec.ceh
energiijastrategiija+N+Der/laš+A+Comp+Attr	energiijastrategiijalit	ˈeː.ner.gˌij.jɑ#strˌɑ.te.gˌij.jɑ»lit>
energiijastrategiija+N+Der/laš+A+Superl+Der/at+Adv	energiijastrategiijalamosit	ˈeː.ner.gˌij.jɑ#strˌɑ.te.gˌij.jɑ»lˌɑ.mos>ih
energiijastrategiija+N+Der/laš+A+Der/vuohta+N+Sg+Com+PxPl3	energiijastrategiijalašvuođaineaset	ˈeː.ner.gˌij.jɑ#strˌɑ.te.gˌij.jɑ»lɑʃ»vˌuo.ðɑ>i.nĕɑ.seh
energiijastrategiija+N+Sg+Ill	energiijastrategiijii	ˈeː.ner.gˌij.jɑ#strˌɑ.te.gˌij.ji>i
evolusjonista+N+Ess+PxPl2	evolusjonistaneattet	ˈe.vo.lˌus.jo.nˌis.tɑ>nĕɑt.teh
evolusjonista+N+Sg+Gen+PxDu1	evolusjonistame	ˈe.vo.lˌus.jo.nˌis.tɑ>me
evolusjonista+N+Sg+Ill	evolusjonistii	ˈe.vo.lˌus.jo.nˌis.ti>i
evolusjonista+N+Pl+Ill+PxDu2	evolusjonisttaidasade	ˈe.vo.lˌus.jo.nˌis.tɑ>i.dɑ.sɑ.de
evolusjonista+N+Sg+Acc+PxSg3	evolusjonisttas	ˈe.vo.lˌus.jo.nˌis.tɑ>s
evolusjonista+N+Sg+Com+PxDu3	evolusjonisttaineaskka	ˈe.vo.lˌus.jo.nˌis.tɑ>i.neɑs.kɑ
evolusjonista+N+Sg+Com	evolusjonisttain	ˈe.vo.lˌus.jo.nˌis.tɑ>in
evolusjonista+N+Der/Dimin+N+Sg+Acc+PxDu2	evolusjonisttažeatte	ˈe.vo.lˌus.jo.nˌis.tɑ»žˌĕɑt.te
evolusjonista+N+Der/heapmi+A+Attr+Der/vuohta+N+Sg+Ill	evolusjonisttahisvuhtii	ˈe.vo.lˌus.jo.nˌis.tɑ»his>»vˌuh.tij
evolusjonista+N+Der/huhtti+V+TV+Pot+Prs+Sg3	evolusjonisttahuhteš	ˈe.vo.lˌus.jo.nˌis.tɑ»hˌuh.te>ʃ
evolusjonista+N+Der/huhtti+V+TV+VAbess	evolusjonisttahuhtihaga	ˈe.vo.lˌus.jo.nˌis.tɑ»hˌuh.ti>hɑ.gɑ
evolusjonista+N+Der/laš+A+Comp+Attr	evolusjonisttalat	ˈe.vo.lˌus.jo.nˌis.tɑ»lɑt>
evolusjonista+N+Der/laš+A+Superl+Pl+Ill	evolusjonisttalamosiidda	ˈe.vo.lˌus.jo.nˌis.tɑ»lˌɑ.mos>ijd.dɑ
evolusjonista+N+Der/laš+A+Pl+Gen	evolusjonisttalaččaid	ˈe.vo.lˌus.jo.nˌis.tɑ»lˌɑč.čɑ>id
fascista+N+Ess+PxDu1	fascistaneame	fˈɑsː.sis.tɑ>nĕɑ.me
fascista+N+Ess+PxPl1	fascistaneamet	fˈɑsː.sis.tɑ>nĕɑ.meh
fascista+N+Ess+PxPl3	fascistaneaset	fˈɑsː.sis.tɑ>nĕɑ.seh
fascista+N+Sg+Acc+PxSg1	fascistan	fˈɑsː.sis.tɑ>n
fascista+N+Sg+Ill+PxSg1	fascistasan	fˈɑsː.sis.tɑ>sɑn
fascista+N+Sg+Nom+PxPl2	fascistadet	fˈɑsː.sis.tɑ>deh
fascista+N+Der/viđá+Adv	fascistaviđá	fˈɑsː.sis.tɑ»vˌi.ðá
fascista+N+Sg+Ill	fascistii	fˈɑsː.sis.ti>i
fascista+N+Pl+Com	fascisttaiguin	fˈɑsː.sis.tɑ>i.gujn
fascista+N+Pl+Loc+PxSg2	fascisttainat	fˈɑsː.sis.tɑ>i.nɑh
fascista+N+Pl+Nom	fascisttat	fˈɑsː.sis.tɑ>h
fascista+N+Sg+Acc+PxPl2	fascisttadet	fˈɑsː.sis.tɑ>deh
fascista+N+Sg+Com+PxPl2	fascisttaineattet	fˈɑsː.sis.tɑ>i.nĕɑt.teh
fascista+N+Sg+Loc	fascisttas	fˈɑsː.sis.tɑ>s
fascista+N+Sg+Loc+PxDu3	fascisttasteaskka	fˈɑsː.sis.tɑ>steɑs.kɑ
fascista+N+Sg+Loc+PxSg3	fascisttastis	fˈɑsː.sis.tɑ>stis
fascista+N+Der/Dimin+N+Sg+Nom	fascisttaš	fˈɑsː.sis.tɑ»ʃ
fascista+N+Der/Dimin+N+Sg+Acc+PxPl3	fascisttažeaset	fˈɑsː.sis.tɑ»žˌĕɑ.seh
fascista+N+Der/heapmi+A+Ess	fascisttaheapmin	fˈɑsː.sis.tɑ»hˌeɑp.mi>n
fascista+N+Der/huhtti+V+TV+VAbess+A+Attr	fascisttahuhtikeahtes	fˈɑsː.sis.tɑ»hˌuh.ti>kĕɑh.tes
fascista+N+Der/huhtti+V+TV+Sup	fascisttahuhtážit	fˈɑsː.sis.tɑ»hˌuhː.tá>žih
fascista+N+Der/huvva+V+IV+Imprt+Pl2	fascisttahuvvet	fˈɑsː.sis.tɑ»hˌuv.ve>h
fascista+N+Der/huvva+V+IV+Ind+Prs+Du1	fascisttahuvve	fˈɑsː.sis.tɑ»hˌuv.ve>
fascista+N+Der/huvva+V+IV+Imprt+Du1	fascisttahuvvu	fˈɑsː.sis.tɑ»hˌuv.vu>
fascista+N+Der/laš+A+Superl+Attr	fascisttalamos	fˈɑsː.sis.tɑ»lˌɑ.mos>
filbmastudio+N+Ess+PxDu2	filbmastudioneatte	fˈil.pmɑ#stˌu.dio>nĕɑt.te
filbmastudio+N+Ess+PxPl3	filbmastudioneaset	fˈil.pmɑ#stˌu.dio>nĕɑ.seh
filbmastudio+N+Pl+Acc+PxPl3	filbmastudioideaset	fˈil.pmɑ#stˌu.dio>i.dĕɑ.seh
filbmastudio+N+Pl+Acc+PxSg1	filbmastudioidan	fˈil.pmɑ#stˌu.dio>i.dɑn
filbmastudio+N+Pl+Com+PxDu3	filbmastudioideaskkaguin	fˈil.pmɑ#stˌu.dio>i.deɑs.kɑ.gujn
filbmastudio+N+Pl+Com	filbmastudioiguin	fˈil.pmɑ#stˌu.dio>i.gujn
filbmastudio+N+Pl+Nom	filbmastudiot	fˈil.pmɑ#stˌu.dio>h
filbmastudio+N+Sg+Gen+PxSg3	filbmastudios	fˈil.pmɑ#stˌu.dio>s
filbmastudio+N+Sg+Nom+PxPl1	filbmastudiomet	fˈil.pmɑ#stˌu.dio>meh
filbmastudio+N+Sg+Nom+PxSg2	filbmastudiot	fˈil.pmɑ#stˌu.dio>h
filbmastudio+N+Sg+Com+PxDu2	filbmastudioineatte	fˈil.pmɑ#stˌu.dio>i.nĕɑt.te
filbmastudio+N+Sg+Ill	filbmastudioi	fˈil.pmɑ#stˌu.dio>i
filbmastudio+N+Sg+Ill+PxSg1	filbmastudiosan	fˈil.pmɑ#stˌu.dio>sɑn
filbmastudio+N+Sg+Loc	filbmastudios	fˈil.pmɑ#stˌu.dio>s
filbmastudio+N+Sg+Loc+PxDu1	filbmastudiosteame	fˈil.pmɑ#stˌu.dio>stĕɑ.me
filbmastudio+N+Sg+Loc+PxDu3	filbmastudiosteaskka	fˈil.pmɑ#stˌu.dio>steɑs.kɑ
filbmastudio+N+Der/huhtti+V+TV+Ger+PxSg3	filbmastudiohuhtidettiinis	fˈil.pmɑ#stˌu.dio>»hˌuh.ti.dˌet.tij.nis
filbmastudio+N+Der/huhtti+V+TV+Ind+Prs+Pl3	filbmastudiohuhttet	fˈil.pmɑ#stˌu.dio>»hˌuhː.teh
filbmenstudio+N+Ess+PxDu1	filbmenstudioneame	fˈil.pmen#stˌu.dio>nĕɑ.me
filbmenstudio+N+Ess+PxPl2	filbmenstudioneattet	fˈil.pmen#stˌu.dio>nĕɑt.teh
filbmenstudio+N+Pl+Com	filbmenstudioiguin	fˈil.pmen#stˌu.dio>i.gujn
filbmenstudio+N+Pl+Gen+PxSg2	filbmenstudioidat	fˈil.pmen#stˌu.dio>i.dɑh
filbmenstudio+N+Pl+Nom	filbmenstudiot	fˈil.pmen#stˌu.dio>h
filbmenstudio+N+Sg+Acc+PxPl1	filbmenstudiomet	fˈil.pmen#stˌu.dio>meh
filbmenstudio+N+Sg+Gen+PxDu1	filbmenstudiome	fˈil.pmen#stˌu.dio>me
filbmenstudio+N+Sg+Nom+PxDu1	filbmenstudiome	fˈil.pmen#stˌu.dio>me
filbmenstudio+N+Sg+Nom+PxSg2	filbmenstudiot	fˈil.pmen#stˌu.dio>h
filbmenstudio+N+Sg+Com+PxDu2	filbmenstudioineatte	fˈil.pmen#stˌu.dio>i.nĕɑt.te
filbmenstudio+N+Sg+Ill	filbmenstudioi	fˈil.pmen#stˌu.dio>i
filbmenstudio+N+Sg+Loc	filbmenstudios	fˈil.pmen#stˌu.dio>s
filbmenstudio+N+Der/huhtti+V+TV+Ger	filbmenstudiohuhtidiin	fˈil.pmen#stˌu.dio>»hˌuh.ti.dijn
filbmenstudio+N+Der/huhtti+V+TV+VGen	filbmenstudiohuhti	fˈil.pmen#stˌu.dio>»hˌuhː.ti
fundamentalista+N+Sg+Ill+PxSg2	fundamentalistasat	fˈunː.dɑː.mˌenː.tɑ.lˌis.tɑ>sɑh
fundamentalista+N+Der/viđá+Adv	fundamentalistaviđá	fˈunː.dɑː.mˌenː.tɑ.lˌis.tɑ»vˌi.ðá
fundamentalista+N+Sg+Ill	fundamentalistii	fˈunː.dɑː.mˌenː.tɑ.lˌis.ti>i
fundamentalista+N+Pl+Com+PxDu2	fundamentalisttaideatteguin	fˈunː.dɑː.mˌenː.tɑ.lˌis.tɑ>i.dĕɑt.te.gujn
fundamentalista+N+Pl+Nom	fundamentalisttat	fˈunː.dɑː.mˌenː.tɑ.lˌis.tɑ>h
fundamentalista+N+Sg+Com+PxDu1	fundamentalisttaineame	fˈunː.dɑː.mˌenː.tɑ.lˌis.tɑ>i.nĕɑ.me
fundamentalista+N+Sg+Com+PxDu2	fundamentalisttaineatte	fˈunː.dɑː.mˌenː.tɑ.lˌis.tɑ>i.nĕɑt.te
fundamentalista+N+Sg+Com+PxSg2	fundamentalisttainat	fˈunː.dɑː.mˌenː.tɑ.lˌis.tɑ>i.nɑh
fundamentalista+N+Sg+Loc	fundamentalisttas	fˈunː.dɑː.mˌenː.tɑ.lˌis.tɑ>s
fundamentalista+N+Der/huhtti+V+TV+ConNegII	fundamentalisttahuhtto	fˈunː.dɑː.mˌenː.tɑ.lˌis.tɑ»hˌuhː.to>
fundamentalista+N+Der/laš+A+Sg+Nom	fundamentalisttalaš	fˈunː.dɑː.mˌenː.tɑ.lˌis.tɑ»lɑʃ>
funksjonalista+N+Sg+Acc+PxSg1	funksjonalistan	fˈunk.sjo.nˌɑ.lis.tɑ>n
funksjonalista+N+Sg+Ill+PxSg1	funksjonalistasan	fˈunk.sjo.nˌɑ.lis.tɑ>sɑn
funksjonalista+N+Der/viđá+Adv	funksjonalistaviđá	fˈunk.sjo.nˌɑ.lis.tɑ»vˌi.ðá
funksjonalista+N+Sg+Ill	funksjonalistii	fˈunk.sjo.nˌɑ.lis.ti>i
funksjonalista+N+Pl+Acc+PxDu2	funksjonalisttaideatte	fˈunk.sjo.nˌɑ.lis.tɑ>i.dĕɑt.te
funksjonalista+N+Pl+Nom	funksjonalisttat	fˈunk.sjo.nˌɑ.lis.tɑ>h
funksjonalista+N+Sg+Acc+PxPl2	funksjonalisttadet	fˈunk.sjo.nˌɑ.lis.tɑ>deh
funksjonalista+N+Sg+Acc+PxPl3	funksjonalisttaset	fˈunk.sjo.nˌɑ.lis.tɑ>seh
funksjonalista+N+Sg+Gen+PxDu2	funksjonalisttade	fˈunk.sjo.nˌɑ.lis.tɑ>de
funksjonalista+N+Sg+Gen	funksjonalistta	fˈunk.sjo.nˌɑ.lis.tɑ>
funksjonalista+N+Sg+Com+PxPl1	funksjonalisttaineamet	fˈunk.sjo.nˌɑ.lis.tɑ>i.nĕɑ.meh
funksjonalista+N+Der/Dimin+N+Pl+Ill	funksjonalisttažiidda	fˈunk.sjo.nˌɑ.lis.tɑ»žˌijd.dɑ
funksjonalista+N+Der/huhtti+V+TV+VAbess	funksjonalisttahuhtekeahttájin	fˈunk.sjo.nˌɑ.lis.tɑ»hˌuh.te>kĕɑhː.tá.jin
funksjonalista+N+Der/huvva+V+IV+Cond+Prs+Sg2	funksjonalisttahuvalit	fˈunk.sjo.nˌɑ.lis.tɑ»hˌu.vɑ>lih
funksjonalista+N+Der/huvva+V+IV+Sup	funksjonalisttahuvažit	fˈunk.sjo.nˌɑ.lis.tɑ»hˌu.vɑ>žih
funksjonalista+N+Der/huvva+V+IV+Imprt+Pl1	funksjonalisttahuvvut	fˈunk.sjo.nˌɑ.lis.tɑ»hˌuv.vu>h
funksjonalista+N+Der/laš+A+Der/vuohta+N+Sg+Ill	funksjonalisttalašvuhtii	fˈunk.sjo.nˌɑ.lis.tɑ»lɑʃ»vˌuh.ti>i
gealbostrategiija+N+Ess+PxDu2	gealbostrategiijaneatte	gˈĕɑlː.bo#strˌɑ.te.gˌij.jɑ>nĕɑt.te
gealbostrategiija+N+Ess+PxSg1	gealbostrategiijanan	gˈĕɑlː.bo#strˌɑ.te.gˌij.jɑ>nɑn
gealbostrategiija+N+Pl+Gen+PxPl1	gealbostrategiijaideamet	gˈĕɑlː.bo#strˌɑ.te.gˌij.jɑ>i.dĕɑ.meh
gealbostrategiija+N+Pl+Loc+PxSg3	gealbostrategiijainis	gˈĕɑlː.bo#strˌɑ.te.gˌij.jɑ>i.nis
gealbostrategiija+N+Pl+Nom	gealbostrategiijat	gˈĕɑlː.bo#strˌɑ.te.gˌij.jɑ>h
gealbostrategiija+N+Sg+Com+PxPl1	gealbostrategiijaineamet	gˈĕɑlː.bo#strˌɑ.te.gˌij.jɑ>i.nĕɑ.meh
gealbostrategiija+N+Sg+Loc+PxDu3	gealbostrategiijasteaskka	gˈĕɑlː.bo#strˌɑ.te.gˌij.jɑ>steɑs.kɑ
gealbostrategiija+N+Der/heapmi+A+Attr	gealbostrategiijahis	gˈĕɑlː.bo#strˌɑ.te.gˌij.jɑ»his>
gealbostrategiija+N+Der/laš+A+Comp+Sg+Com	gealbostrategiijalaččabuin	gˈĕɑlː.bo#strˌɑ.te.gˌij.jɑ»lˌɑč.čɑ>bujn
gealbostrategiija+N+Der/laš+A+Sg+Ill	gealbostrategiijalažžii	gˈĕɑlː.bo#strˌɑ.te.gˌij.jɑ»lˌɑž.ži>i
gealbostrategiija+N+Der/laš+A+Der/vuohta+N+Sg+Ill	gealbostrategiijalašvuhtii	gˈĕɑlː.bo#strˌɑ.te.gˌij.jɑ»lɑʃ»vˌuh.ti>i
gealbostrategiija+N+Sg+Ill	gealbostrategiijii	gˈĕɑlː.bo#strˌɑ.te.gˌij.ji>i
gelbbolašvuođastrategiija+N+Ess+PxPl3	gelbbolašvuođastrategiijaneaset	gˈelp.po.lˌɑʃ.vuo.ðɑ#strˌɑ.te.gˌij.jɑ>nĕɑ.seh
gelbbolašvuođastrategiija+N+Sg+Nom+PxSg1	gelbbolašvuođastrategiijan	gˈelp.po.lˌɑʃ.vuo.ðɑ#strˌɑ.te.gˌij.jɑ>n
gelbbolašvuođastrategiija+N+Der/huhtti+V+TV+VAbess	gelbbolašvuođastrategiijahuhtehaga	gˈelp.po.lˌɑʃ.vuo.ðɑ#strˌɑ.te.gˌij.jɑ»hˌuh.te>hɑ.gɑ
gelbbolašvuođastrategiija+N+Der/laš+A+Superl+Pl+Acc	gelbbolašvuođastrategiijalepmosiid	gˈelp.po.lˌɑʃ.vuo.ðɑ#strˌɑ.te.gˌij.jɑ»lˌep.mos>ijh
gelbbolašvuođastrategiija+N+Sg+Ill	gelbbolašvuođastrategiijii	gˈelp.po.lˌɑʃ.vuo.ðɑ#strˌɑ.te.gˌij.ji>i
govvastudio+N+Ess+PxDu2	govvastudioneatte	gˈovː.vɑː#stˌu.dio>nĕɑt.te
govvastudio+N+Ess+PxPl1	govvastudioneamet	gˈovː.vɑː#stˌu.dio>nĕɑ.meh
govvastudio+N+Ess+PxSg2	govvastudionat	gˈovː.vɑː#stˌu.dio>nɑh
govvastudio+N+Ess+PxSg3	govvastudionis	gˈovː.vɑː#stˌu.dio>nis
govvastudio+N+Pl+Acc+PxDu1	govvastudioideame	gˈovː.vɑː#stˌu.dio>i.dĕɑ.me
govvastudio+N+Pl+Gen+PxSg2	govvastudioidat	gˈovː.vɑː#stˌu.dio>i.dɑh
govvastudio+N+Pl+Nom+PxPl1	govvastudioideamet	gˈovː.vɑː#stˌu.dio>i.dĕɑ.meh
govvastudio+N+Pl+Nom	govvastudiot	gˈovː.vɑː#stˌu.dio>h
govvastudio+N+Sg+Acc+PxDu1	govvastudiome	gˈovː.vɑː#stˌu.dio>me
govvastudio+N+Sg+Acc+PxDu3	govvastudioskka	gˈovː.vɑː#stˌu.dio>skːɑ
govvastudio+N+Sg+Acc+PxPl1	govvastudiomet	gˈovː.vɑː#stˌu.dio>meh
govvastudio+N+Sg+Gen+PxDu1	govvastudiome	gˈovː.vɑː#stˌu.dio>me
govvastudio+N+Sg+Gen+PxDu3	govvastudioskka	gˈovː.vɑː#stˌu.dio>skːɑ
govvastudio+N+Sg+Gen+PxSg1	govvastudion	gˈovː.vɑː#stˌu.dio>n
govvastudio+N+Sg+Nom+PxSg3	govvastudios	gˈovː.vɑː#stˌu.dio>s
govvastudio+N+Sg+Nom	govvastudio	gˈovː.vɑː#stˌu.dio>
govvastudio+N+Sg+Com+PxPl2	govvastudioineattet	gˈovː.vɑː#stˌu.dio>i.nĕɑt.teh
govvastudio+N+Sg+Ill	govvastudioi	gˈovː.vɑː#stˌu.dio>i
govvastudio+N+Sg+Ill+PxPl2	govvastudiosattet	gˈovː.vɑː#stˌu.dio>sɑt.teh
govvastudio+N+Sg+Ill+PxPl3	govvastudiosaset	gˈovː.vɑː#stˌu.dio>sɑ.seh
govvastudio+N+Sg+Loc	govvastudios	gˈovː.vɑː#stˌu.dio>s
govvastudio+N+Sg+Loc+PxDu2	govvastudiosteatte	gˈovː.vɑː#stˌu.dio>stĕɑt.te
govvastudio+N+Sg+Loc+PxSg1	govvastudiostan	gˈovː.vɑː#stˌu.dio>stɑn
govvastudio+N+Der/heapmi+A+Pl+Nom	govvastudioheamit	gˈovː.vɑː#stˌu.dio>»hˌeɑ.mih
govvastudio+N+Der/heapmi+A+Sg+Nom	govvastudioheapme	gˈovː.vɑː#stˌu.dio>»hˌĕɑp.me
govvastudio+N+Der/heapmi+A+Sg+Com	govvastudiohemiin	gˈovː.vɑː#stˌu.dio>»hˌe.mijn
gulahallanstrategiija+N+Ess+PxSg3	gulahallanstrategiijanis	gˈu.lɑː.hˌɑl.lɑn#strˌɑ.te.gˌij.jɑ>nis
gulahallanstrategiija+N+Der/Dimin+N+Der/viđá+Adv	gulahallanstrategiijašviđá	gˈu.lɑː.hˌɑl.lɑn#strˌɑ.te.gˌij.jɑ»ʃ»vˌi.ðá
gulahallanstrategiija+N+Der/heapmi+A+Comp+Attr	gulahallanstrategiijahat	gˈu.lɑː.hˌɑl.lɑn#strˌɑ.te.gˌij.jɑ»hɑt>
gulahallanstrategiija+N+Der/huhtti+V+TV+Sup	gulahallanstrategiijahuhtážit	gˈu.lɑː.hˌɑl.lɑn#strˌɑ.te.gˌij.jɑ»hˌuhː.tá>žih
gulahallanstrategiija+N+Der/laš+A+Der/vuohta+N+Sg+Ill	gulahallanstrategiijalašvuhtii	gˈu.lɑː.hˌɑl.lɑn#strˌɑ.te.gˌij.jɑ»lɑʃ»vˌuh.ti>i
gulahallanstrategiija+N+Sg+Ill	gulahallanstrategiijii	gˈu.lɑː.hˌɑl.lɑn#strˌɑ.te.gˌij.ji>i
guldalanstrategiija+N+Sg+Ill	guldalanstrategiijai	gˈulː.dɑː.lɑn#strˌɑ.te.gˌij.jɑ>i
guldalanstrategiija+N+Der/heapmi+A+Attr	guldalanstrategiijahis	gˈulː.dɑː.lɑn#strˌɑ.te.gˌij.jɑ»his>
guldalanstrategiija+N+Der/huhtti+V+TV+Sup	guldalanstrategiijahuhtážit	gˈulː.dɑː.lɑn#strˌɑ.te.gˌij.jɑ»hˌuhː.tá>žih
guldalanstrategiija+N+Sg+Ill	guldalanstrategiijii	gˈulː.dɑː.lɑn#strˌɑ.te.gˌij.ji>i
guovddášguovllustrategiija+N+Pl+Nom	guovddášguovllustrategiijat	gˈuoβt.táʃ#gˌuoβl.lu#strˌɑ.te.gˌij.jɑ>h
guovddášguovllustrategiija+N+Sg+Loc+PxSg3	guovddášguovllustrategiijastis	gˈuoβt.táʃ#gˌuoβl.lu#strˌɑ.te.gˌij.jɑ>stis
guovddášguovllustrategiija+N+Der/huvva+V+IV+Cond+Prs+Du3	guovddášguovllustrategiijahuvašeigga	gˈuoβt.táʃ#gˌuoβl.lu#strˌɑ.te.gˌij.jɑ»hˌu.vɑ>ʃejg.gɑ
guovddášguovllustrategiija+N+Sg+Ill	guovddášguovllustrategiijii	gˈuoβt.táʃ#gˌuoβl.lu#strˌɑ.te.gˌij.ji>i
guovddášstrategiija+N+Der/heapmi+A+Comp+Attr	guovddášstrategiijahit	gˈuoβt.táʃ#strˌɑ.te.gˌij.jɑ»hit>
guovddášstrategiija+N+Sg+Ill	guovddášstrategiijii	gˈuoβt.táʃ#strˌɑ.te.gˌij.ji>i
gádjunakšuvdna+N+Sg+Nom+PxDu3	gádjunakšuvdnaska	gˈác.cun#ˌɑkː.ʃuv.tnɑ>skɑ
gádjunakšuvdna+N+Sg+Nom+PxPl3	gádjunakšuvdnaset	gˈác.cun#ˌɑkː.ʃuv.tnɑ>seh
gádjunakšuvdna+N+Sg+Nom+PxSg3	gádjunakšuvdnas	gˈác.cun#ˌɑkː.ʃuv.tnɑ>s
gádjunakšuvdna+N+Sg+Nom	gádjunakšuvdna	gˈác.cun#ˌɑkː.ʃuv.tnɑ>
gádjunakšuvdna+N+Ess+PxSg1	gádjunakšuvdnanan	gˈác.cun#ˌɑkː.ʃuv.tnɑ>nɑn
gádjunakšuvdna+N+Sg+Ill	gádjunakšuvdnii	gˈác.cun#ˌɑkː.ʃuv.tni>i
gádjunakšuvdna+N+Pl+Acc+PxPl3	gádjunakšuvnnaideaset	gˈác.cun#ˌɑkː.ʃuvn.nɑ>i.dĕɑ.seh
gádjunakšuvdna+N+Pl+Nom	gádjunakšuvnnat	gˈác.cun#ˌɑkː.ʃuvn.nɑ>h
gádjunakšuvdna+N+Sg+Acc+PxDu2	gádjunakšuvnnade	gˈác.cun#ˌɑkː.ʃuvn.nɑ>de
gádjunakšuvdna+N+Sg+Acc+PxDu3	gádjunakšuvnnaska	gˈác.cun#ˌɑkː.ʃuvn.nɑ>skɑ
gádjunakšuvdna+N+Sg+Acc+PxSg2	gádjunakšuvnnat	gˈác.cun#ˌɑkː.ʃuvn.nɑ>h
gádjunakšuvdna+N+Sg+Acc	gádjunakšuvnna	gˈác.cun#ˌɑkː.ʃuvn.nɑ>
gádjunakšuvdna+N+Sg+Gen+PxDu2	gádjunakšuvnnade	gˈác.cun#ˌɑkː.ʃuvn.nɑ>de
gádjunakšuvdna+N+Sg+Loc	gádjunakšuvnnas	gˈác.cun#ˌɑkː.ʃuvn.nɑ>s
gádjunakšuvdna+N+Der/Dimin+N+Der/viđá+Adv	gádjunakšuvnnašviđá	gˈác.cun#ˌɑkː.ʃuvn.nɑ»ʃ»vˌi.ðá
gádjunakšuvdna+N+Der/heapmi+A+Ess	gádjunakšuvnnaheapmin	gˈác.cun#ˌɑkː.ʃuvn.nɑ»hˌeɑp.mi>n
gádjunakšuvdna+N+Der/heapmi+A+Sg+Com	gádjunakšuvnnahemiin	gˈác.cun#ˌɑkː.ʃuvn.nɑ»hˌe.mi>in
heivehanstrategiija+N+Pl+Ill+PxDu1	heivehanstrategiijaidasame	hˈejː.ve.hɑn#strˌɑ.te.gˌij.jɑ>i.dɑ.sɑ.me
heivehanstrategiija+N+Pl+Nom	heivehanstrategiijat	hˈejː.ve.hɑn#strˌɑ.te.gˌij.jɑ>h
heivehanstrategiija+N+Sg+Ill	heivehanstrategiijai	hˈejː.ve.hɑn#strˌɑ.te.gˌij.jɑ>i
heivehanstrategiija+N+Der/viđá+Adv	heivehanstrategiijaviđá	hˈejː.ve.hɑn#strˌɑ.te.gˌij.jɑ>»vˌi.ðá
heivehanstrategiija+N+Der/heapmi+A+Comp+Sg+Ill	heivehanstrategiijahebbui	hˈejː.ve.hɑn#strˌɑ.te.gˌij.jɑ»hˌeb.bu>i
heivehanstrategiija+N+Der/heapmi+A+Sg+Com	heivehanstrategiijahemiin	hˈejː.ve.hɑn#strˌɑ.te.gˌij.jɑ»hˌe.mi>in
heivehanstrategiija+N+Der/heapmi+A+Attr+Der/vuohta+N+Der/viđá+Adv	heivehanstrategiijahisvuohtaviđá	hˈejː.ve.hɑn#strˌɑ.te.gˌij.jɑ»his>»vˌuoh.tɑ»vˌi.ðá
heivehanstrategiija+N+Der/huhtti+V+TV+Der/NomAg+N+Pl+Nom	heivehanstrategiijahuhttit	hˈejː.ve.hɑn#strˌɑ.te.gˌij.jɑ»hˌuhː.ti>»h
heivehanstrategiija+N+Der/huhtti+V+TV+Der/PassL+V+IV+Der/supmi+N+Sg+Ill	heivehanstrategiijahuhttosupmái	hˈejː.ve.hɑn#strˌɑ.te.gˌij.jɑ»hˌuhː.to>»sˌup.máj
heivehanstrategiija+N+Sg+Ill	heivehanstrategiijii	hˈejː.ve.hɑn#strˌɑ.te.gˌij.ji>i
hinduista+N+Ess	hinduistan	hˈinː.duj.stɑ>n
hinduista+N+Sg+Gen+PxDu1	hinduistame	hˈinː.duj.stɑ>me
hinduista+N+Der/viđá+Adv	hinduistaviđá	hˈinː.duj.stɑ»vˌi.ðá
hinduista+N+Sg+Ill	hinduistii	hˈinː.duj.sti>i
hinduista+N+Pl+Acc+PxSg3	hinduisttaidis	hˈinː.dujst.tɑ>i.dis
hinduista+N+Sg+Com+PxDu1	hinduisttaineame	hˈinː.dujst.tɑ>i.nĕɑ.me
hinduista+N+Sg+Com	hinduisttain	hˈinː.dujst.tɑ>in
hinduista+N+Der/Dimin+N+Sg+Nom	hinduisttaš	hˈinː.dujst.tɑ»ʃ
hinduista+N+Der/Dimin+N+Der/viđá+Adv	hinduisttašviđá	hˈinː.dujst.tɑ»ʃ»vˌi.ðá
hinduista+N+Der/heapmi+A+Superl+Sg+Nom	hinduisttaheamos	hˈinː.dujst.tɑ»hˌĕɑ.mos>
hinduista+N+Der/huhtti+V+TV+VAbess	hinduisttahuhtehaga	hˈinː.dujst.tɑ»hˌuh.te>hɑ.gɑ
hinduista+N+Der/huhtti+V+TV+Ind+Prt+Sg2	hinduisttahuhttet	hˈinː.dujst.tɑ»hˌuhː.te>h
hinduista+N+Der/huvva+V+IV+VAbess	hinduisttahuvakeahttájin	hˈinː.dujst.tɑ»hˌu.vɑ>kĕɑhː.tá.jin
hockey+N+Pl+Nom	hockeyt	hˈok.ke.y>h
hockey+N+Sg+Gen+PxDu2	hockeytte	hˈok.ke.y>tːe
hockey+N+Sg+Gen+PxDu3	hockeyskka	hˈok.ke.y>skːɑ
hockey+N+Sg+Com+PxDu3	hockeyineaskka	hˈok.ke.y>i.neɑs.kɑ
hockey+N+Der/huvva+V+IV+VGen	hockeyhuva	hˈok.ke.y>»hˌu.vɑ
hockeyvuoktahápmi+N+Sg+Gen+Allegro	hockeyvuoktaháme	hˈok.ke.y#vˌuokː.htɑ#hˌá.me>
hockeyvuoktahápmi+N+Der/huhtti+V+TV+Ind+Prs+Sg2	hockeyvuoktahámehuhtát	hˈok.ke.y#vˌuokː.htɑ#hˌá.me»hˌuhː.tá>h
hockeyvuoktahápmi+N+Pl+Nom	hockeyvuoktahámit	hˈok.ke.y#vˌuokː.htɑ#hˌá.mi>h
hockeyvuoktahápmi+N+Sg+Acc+PxPl2	hockeyvuoktahámádet	hˈok.ke.y#vˌuokː.htɑ#hˌá.má>deh
hockeyvuoktahápmi+N+Der/viđá+Adv	hockeyvuoktahápmeviđá	hˈok.ke.y#vˌuokː.htɑ#hˌáp.me»vˌi.ðá
hockeyvuoktahápmi+N+Ess+PxPl3	hockeyvuoktahápmineaset	hˈok.ke.y#vˌuokː.htɑ#hˌáp.mi>nĕɑ.seh
hockeyvuoktahápmi+N+Sg+Ill	hockeyvuoktahápmái	hˈok.ke.y#vˌuokː.htɑ#hˌáp.má>i
homofobiija+N+Der/viđá+Adv	homofobiijaviđá	hˈo.mo#fˌo.bij.jɑ>»vˌi.ðá
homofobiija+N+Der/Dimin+N+Der/viđá+Adv	homofobiijašviđá	hˈo.mo#fˌo.bij.jɑ»ʃ»vˌi.ðá
homofobiija+N+Der/Dimin+N+Sg+Gen	homofobiijaža	hˈo.mo#fˌo.bij.jɑ»žɑ
homofobiija+N+Der/heapmi+A+Comp+Attr	homofobiijahit	hˈo.mo#fˌo.bij.jɑ»hit>
homofobiija+N+Der/huhtti+V+TV+Ind+Prt+Du1	homofobiijahuhtiime	hˈo.mo#fˌo.bij.jɑ»hˌuh.ti>i.me
homofobiija+N+Der/huvva+V+IV+Ind+Prt+Du3	homofobiijahuvaiga	hˈo.mo#fˌo.bij.jɑ»hˌu.vɑ>i.gɑ
homofobiija+N+Sg+Ill	homofobiijii	hˈo.mo#fˌo.bij.ji>i
huksenstrategiija+N+Ess	huksenstrategiijan	hˈukː.sen#strˌɑ.te.gˌij.jɑ>n
huksenstrategiija+N+Der/viđá+Adv	huksenstrategiijaviđá	hˈukː.sen#strˌɑ.te.gˌij.jɑ>»vˌi.ðá
huksenstrategiija+N+Der/Dimin+N+Sg+Nom	huksenstrategiijaš	hˈukː.sen#strˌɑ.te.gˌij.jɑ»ʃ
huksenstrategiija+N+Der/Dimin+N+Der/viđá+Adv	huksenstrategiijašviđá	hˈukː.sen#strˌɑ.te.gˌij.jɑ»ʃ»vˌi.ðá
huksenstrategiija+N+Der/Dimin+N+Der/Dimin+N+Pl+Nom	huksenstrategiijažaččat	hˈukː.sen#strˌɑ.te.gˌij.jɑ»žˌɑč.čɑ>h
huksenstrategiija+N+Der/huhtti+V+TV+Ind+Prs+ConNeg	huksenstrategiijahuhte	hˈukː.sen#strˌɑ.te.gˌij.jɑ»hˌuh.te>
huksenstrategiija+N+Der/huhtti+V+TV+VAbess+A+Attr	huksenstrategiijahuhtikeahtes	hˈukː.sen#strˌɑ.te.gˌij.jɑ»hˌuh.ti>kĕɑh.tes
huksenstrategiija+N+Der/huhtti+V+TV+Sup	huksenstrategiijahuhtážit	hˈukː.sen#strˌɑ.te.gˌij.jɑ»hˌuhː.tá>žih
huksenstrategiija+N+Der/huvva+V+IV+Imprt+ConNeg	huksenstrategiijahuva	hˈukː.sen#strˌɑ.te.gˌij.jɑ»hˌu.vɑ>
huksenstrategiija+N+Der/laš+A+Der/vuohta+N+Sg+Ill	huksenstrategiijalašvuhtii	hˈukː.sen#strˌɑ.te.gˌij.jɑ»lɑʃ»vˌuh.ti>i
huksenstrategiija+N+Der/laš+A+Der/vuohta+N+Sg+Ill+PxSg2	huksenstrategiijalašvuohtasat	hˈukː.sen#strˌɑ.te.gˌij.jɑ»lɑʃ»vˌuoh.tɑ>sɑh
huksenstrategiija+N+Sg+Ill	huksenstrategiijii	hˈukː.sen#strˌɑ.te.gˌij.ji>i
hálddahanstrategiija+N+Der/Dimin+N+Sg+Acc+PxSg1	hálddahanstrategiijažan	hˈált.tɑ.hɑn#strˌɑ.te.gˌij.jɑ»žɑn
hálddahanstrategiija+N+Der/heapmi+A+Attr	hálddahanstrategiijahis	hˈált.tɑ.hɑn#strˌɑ.te.gˌij.jɑ»his>
hálddahanstrategiija+N+Der/huhtti+V+TV+Ind+Prt+Pl1	hálddahanstrategiijahuhtiimet	hˈált.tɑ.hɑn#strˌɑ.te.gˌij.jɑ»hˌuh.ti>i.meh
hálddahanstrategiija+N+Der/huvva+V+IV+Imprt+Pl2	hálddahanstrategiijahuvvet	hˈált.tɑ.hɑn#strˌɑ.te.gˌij.jɑ»hˌuv.ve>h
hálddahanstrategiija+N+Sg+Ill	hálddahanstrategiijii	hˈált.tɑ.hɑn#strˌɑ.te.gˌij.ji>i
hálddašanstrategiija+N+Ess+PxSg1	hálddašanstrategiijanan	hˈált.tɑ.ʃɑn#strˌɑ.te.gˌij.jɑ>nɑn
hálddašanstrategiija+N+Pl+Nom+PxDu2	hálddašanstrategiijaideatte	hˈált.tɑ.ʃɑn#strˌɑ.te.gˌij.jɑ>i.dĕɑt.te
hálddašanstrategiija+N+Sg+Acc+PxDu3	hálddašanstrategiijaska	hˈált.tɑ.ʃɑn#strˌɑ.te.gˌij.jɑ>skɑ
hálddašanstrategiija+N+Der/viđá+Adv	hálddašanstrategiijaviđá	hˈált.tɑ.ʃɑn#strˌɑ.te.gˌij.jɑ>»vˌi.ðá
hálddašanstrategiija+N+Der/Dimin+N+Ess	hálddašanstrategiijažin	hˈált.tɑ.ʃɑn#strˌɑ.te.gˌij.jɑ»žin
hálddašanstrategiija+N+Der/heapmi+A+Pl+Ill	hálddašanstrategiijahemiide	hˈált.tɑ.ʃɑn#strˌɑ.te.gˌij.jɑ»hˌe.mi>i.de
hálddašanstrategiija+N+Der/huvva+V+IV+Imprt+Du1	hálddašanstrategiijahuvvu	hˈált.tɑ.ʃɑn#strˌɑ.te.gˌij.jɑ»hˌuv.vu>
hálddašanstrategiija+N+Sg+Ill	hálddašanstrategiijii	hˈált.tɑ.ʃɑn#strˌɑ.te.gˌij.ji>i
immaterialista+N+Ess	immaterialistan	ˈimː.mɑː.tˌe.ri.ˌɑ.lis.tɑ>n
immaterialista+N+Sg+Acc+PxDu1	immaterialistame	ˈimː.mɑː.tˌe.ri.ˌɑ.lis.tɑ>me
immaterialista+N+Sg+Nom+PxPl2	immaterialistadet	ˈimː.mɑː.tˌe.ri.ˌɑ.lis.tɑ>deh
immaterialista+N+Der/viđá+Adv	immaterialistaviđá	ˈimː.mɑː.tˌe.ri.ˌɑ.lis.tɑ»vˌi.ðá
immaterialista+N+Sg+Ill	immaterialistii	ˈimː.mɑː.tˌe.ri.ˌɑ.lis.ti>i
immaterialista+N+Sg+Gen	immaterialistta	ˈimː.mɑː.tˌe.ri.ˌɑ.lis.tɑ>
immaterialista+N+Sg+Com+PxPl2	immaterialisttaineattet	ˈimː.mɑː.tˌe.ri.ˌɑ.lis.tɑ>i.nĕɑt.teh
immaterialista+N+Sg+Loc	immaterialisttas	ˈimː.mɑː.tˌe.ri.ˌɑ.lis.tɑ>s
immaterialista+N+Sg+Loc+PxPl3	immaterialisttasteaset	ˈimː.mɑː.tˌe.ri.ˌɑ.lis.tɑ>stĕɑ.seh
immaterialista+N+Der/heapmi+A+Comp+Sg+Ill	immaterialisttahebbui	ˈimː.mɑː.tˌe.ri.ˌɑ.lis.tɑ»hˌeb.bu>i
immaterialista+N+Der/heapmi+A+Attr	immaterialisttahis	ˈimː.mɑː.tˌe.ri.ˌɑ.lis.tɑ»his>
immaterialista+N+Der/laš+A+Comp+Sg+Ill	immaterialisttalebbui	ˈimː.mɑː.tˌe.ri.ˌɑ.lis.tɑ»lˌeb.bu>i
immaterialista+N+Der/laš+A+AttrCmp+Der/fárddat+A+Sg+Com	immaterialisttalašfárddagiin	ˈimː.mɑː.tˌe.ri.ˌɑ.lis.tɑ»lɑʃ>»fˌárd.dɑ.gijn
impresjonista+N+Ess+PxPl1	impresjonistaneamet	ˈim.pres.jˌo.nis.tɑ>nĕɑ.meh
impresjonista+N+Der/viđá+Adv	impresjonistaviđá	ˈim.pres.jˌo.nis.tɑ»vˌi.ðá
impresjonista+N+Sg+Ill	impresjonistii	ˈim.pres.jˌo.nis.ti>i
impresjonista+N+Pl+Gen+PxPl3	impresjonisttaideaset	ˈim.pres.jˌo.nis.tɑ>i.dĕɑ.seh
impresjonista+N+Pl+Nom	impresjonisttat	ˈim.pres.jˌo.nis.tɑ>h
impresjonista+N+Sg+Acc+PxSg3	impresjonisttas	ˈim.pres.jˌo.nis.tɑ>s
impresjonista+N+Der/huhtti+V+TV+VGen	impresjonisttahuhti	ˈim.pres.jˌo.nis.tɑ»hˌuh.ti>
impresjonista+N+Der/huhtti+V+TV+Cond+Prs+Du3	impresjonisttahuhtáleigga	ˈim.pres.jˌo.nis.tɑ»hˌuhː.tá>lejg.gɑ
impresjonista+N+Der/huvva+V+IV+Imprt+Pl2	impresjonisttahuvvet	ˈim.pres.jˌo.nis.tɑ»hˌuv.ve>h
impresjonista+N+Der/laš+A+Comp+Attr	impresjonisttalut	ˈim.pres.jˌo.nis.tɑ»lut>
impressionista+N+Sg+Acc+PxPl1	impressionistamet	ˈim.pres.sˌio.nis.tɑ>meh
impressionista+N+Der/viđá+Adv	impressionistaviđá	ˈim.pres.sˌio.nis.tɑ»vˌi.ðá
impressionista+N+Sg+Ill	impressionistii	ˈim.pres.sˌio.nis.ti>i
impressionista+N+Sg+Com+PxPl2	impressionisttaineattet	ˈim.pres.sˌio.nis.tɑ>i.nĕɑt.teh
impressionista+N+Der/huhtti+V+TV+VAbess	impressionisttahuhtehaga	ˈim.pres.sˌio.nis.tɑ»hˌuh.te>hɑ.gɑ
impressionista+N+Der/huhtti+V+TV+Der/muš+N+Sg+Nom+PxPl1	impressionisttahuhttimuššamet	ˈim.pres.sˌio.nis.tɑ»hˌuhː.ti>»mˌuʃ.ʃɑ.meh
individualista+N+Sg+Acc+PxSg1	individualistan	ˈinː.di.vˌi.du.ˌɑ.lis.tɑ>n
individualista+N+Sg+Gen+PxPl1	individualistamet	ˈinː.di.vˌi.du.ˌɑ.lis.tɑ>meh
individualista+N+Sg+Ill	individualistii	ˈinː.di.vˌi.du.ˌɑ.lis.ti>i
individualista+N+Der/huhtti+V+TV+Pot+Prs+ConNeg	individualisttahuhteš	ˈinː.di.vˌi.du.ˌɑ.lis.tɑ»hˌuh.te>ʃ
individualista+N+Der/laš+A+Der/vuohta+N+Sg+Ill	individualisttalašvuhtii	ˈinː.di.vˌi.du.ˌɑ.lis.tɑ»lɑʃ»vˌuh.ti>i
informašunstrategiija+N+Der/Dimin+N+Sg+Nom	informašunstrategiijaš	ˈin.for.mˌɑ.ʃun#strˌɑ.te.gˌij.jɑ»ʃ
informašunstrategiija+N+Der/heapmi+A+Sg+Com	informašunstrategiijahemiin	ˈin.for.mˌɑ.ʃun#strˌɑ.te.gˌij.jɑ»hˌe.mi>in
informašunstrategiija+N+Der/laš+A+AttrCmp+Der/kultuvrrat+A+Sg+Nom	informašunstrategiijalaškultuvrrat	ˈin.for.mˌɑ.ʃun#strˌɑ.te.gˌij.jɑ»lɑʃ>»kˌul.tuvr.rɑh
informašuvdnastrategiija+N+Ess+PxPl3	informašuvdnastrategiijaneaset	ˈin.for.mˌɑ.ʃuv.tnɑ#strˌɑ.te.gˌij.jɑ>nĕɑ.seh
informašuvdnastrategiija+N+Der/huvva+V+IV+Ind+Prs+Sg3	informašuvdnastrategiijahuvvá	ˈin.for.mˌɑ.ʃuv.tnɑ#strˌɑ.te.gˌij.jɑ»hˌuvː.vá>
informašuvdnastrategiija+N+Sg+Ill	informašuvdnastrategiijii	ˈin.for.mˌɑ.ʃuv.tnɑ#strˌɑ.te.gˌij.ji>i
instrumentalista+N+Ess	instrumentalistan	ˈin.stru.mˌenː.tɑ.lˌis.tɑ>n
instrumentalista+N+Sg+Gen+PxSg1	instrumentalistan	ˈin.stru.mˌenː.tɑ.lˌis.tɑ>n
instrumentalista+N+Der/viđá+Adv	instrumentalistaviđá	ˈin.stru.mˌenː.tɑ.lˌis.tɑ»vˌi.ðá
instrumentalista+N+Sg+Ill	instrumentalistii	ˈin.stru.mˌenː.tɑ.lˌis.ti>i
instrumentalista+N+Pl+Nom	instrumentalisttat	ˈin.stru.mˌenː.tɑ.lˌis.tɑ>h
instrumentalista+N+Sg+Gen+PxDu2	instrumentalisttade	ˈin.stru.mˌenː.tɑ.lˌis.tɑ>de
instrumentalista+N+Sg+Loc	instrumentalisttas	ˈin.stru.mˌenː.tɑ.lˌis.tɑ>s
instrumentalista+N+Der/huhtti+V+TV+VAbess	instrumentalisttahuhtikeahttájin	ˈin.stru.mˌenː.tɑ.lˌis.tɑ»hˌuh.ti>kĕɑhː.tá.jin
instrumentalista+N+Der/huhtti+V+TV+Ind+Prs+Sg3	instrumentalisttahuhttá	ˈin.stru.mˌenː.tɑ.lˌis.tɑ»hˌuhː.tá>
instrumentalista+N+Der/laš+A+AttrCmp+Der/mállet+A+Sg+Com	instrumentalisttalašmállegiin	ˈin.stru.mˌenː.tɑ.lˌis.tɑ»lɑʃ>»mˌál.le.gijn
investerenstrategiija+N+Ess+PxDu1	investerenstrategiijaneame	ˈinː.ves.tˌe.ren#strˌɑ.te.gˌij.jɑ>nĕɑ.me
investerenstrategiija+N+Ess+PxPl2	investerenstrategiijaneattet	ˈinː.ves.tˌe.ren#strˌɑ.te.gˌij.jɑ>nĕɑt.teh
investerenstrategiija+N+Pl+Com	investerenstrategiijaiguin	ˈinː.ves.tˌe.ren#strˌɑ.te.gˌij.jɑ>i.gujn
investerenstrategiija+N+Der/Dimin+N+Sg+Nom	investerenstrategiijaš	ˈinː.ves.tˌe.ren#strˌɑ.te.gˌij.jɑ»ʃ
investerenstrategiija+N+Der/huhtti+V+TV+Ind+Prs+ConNeg	investerenstrategiijahuhte	ˈinː.ves.tˌe.ren#strˌɑ.te.gˌij.jɑ»hˌuh.te>
investerenstrategiija+N+Sg+Ill	investerenstrategiijii	ˈinː.ves.tˌe.ren#strˌɑ.te.gˌij.ji>i
isolasjonista+N+Ess+PxDu1	isolasjonistaneame	ˈi.so.lˌɑs.jo.nˌis.tɑ>nĕɑ.me
isolasjonista+N+Ess+PxPl3	isolasjonistaneaset	ˈi.so.lˌɑs.jo.nˌis.tɑ>nĕɑ.seh
isolasjonista+N+Ess	isolasjonistan	ˈi.so.lˌɑs.jo.nˌis.tɑ>n
isolasjonista+N+Sg+Gen+PxSg1	isolasjonistan	ˈi.so.lˌɑs.jo.nˌis.tɑ>n
isolasjonista+N+Der/viđá+Adv	isolasjonistaviđá	ˈi.so.lˌɑs.jo.nˌis.tɑ»vˌi.ðá
isolasjonista+N+Sg+Ill	isolasjonistii	ˈi.so.lˌɑs.jo.nˌis.ti>i
isolasjonista+N+Pl+Loc+PxSg3	isolasjonisttainis	ˈi.so.lˌɑs.jo.nˌis.tɑ>i.nis
isolasjonista+N+Pl+Nom+PxSg3	isolasjonisttaidis	ˈi.so.lˌɑs.jo.nˌis.tɑ>i.dis
isolasjonista+N+Pl+Nom	isolasjonisttat	ˈi.so.lˌɑs.jo.nˌis.tɑ>h
isolasjonista+N+Sg+Acc+PxSg2	isolasjonisttat	ˈi.so.lˌɑs.jo.nˌis.tɑ>h
isolasjonista+N+Sg+Gen+PxDu2	isolasjonisttade	ˈi.so.lˌɑs.jo.nˌis.tɑ>de
isolasjonista+N+Sg+Gen+PxPl2	isolasjonisttadet	ˈi.so.lˌɑs.jo.nˌis.tɑ>deh
isolasjonista+N+Sg+Com+PxDu2	isolasjonisttaineatte	ˈi.so.lˌɑs.jo.nˌis.tɑ>i.nĕɑt.te
isolasjonista+N+Sg+Loc	isolasjonisttas	ˈi.so.lˌɑs.jo.nˌis.tɑ>s
isolasjonista+N+Der/Dimin+N+Sg+Nom	isolasjonisttaš	ˈi.so.lˌɑs.jo.nˌis.tɑ»ʃ
isolasjonista+N+Der/Dimin+N+Der/viđá+Adv	isolasjonisttašviđá	ˈi.so.lˌɑs.jo.nˌis.tɑ»ʃ»vˌi.ðá
isolasjonista+N+Der/Dimin+N+Pl+Gen	isolasjonisttažiid	ˈi.so.lˌɑs.jo.nˌis.tɑ»žijh
isolasjonista+N+Der/heapmi+A+Sg+Loc	isolasjonisttaheames	ˈi.so.lˌɑs.jo.nˌis.tɑ»hˌĕɑ.me>s
isolasjonista+N+Der/heapmi+A+Pl+Loc	isolasjonisttahemiin	ˈi.so.lˌɑs.jo.nˌis.tɑ»hˌe.mi>in
isolasjonista+N+Der/huhtti+V+TV+Cond+Prs+Du3	isolasjonisttahuhtáleigga	ˈi.so.lˌɑs.jo.nˌis.tɑ»hˌuhː.tá>lejg.gɑ
isolasjonista+N+Der/laš+A+Comp+Sg+Nom	isolasjonisttalit	ˈi.so.lˌɑs.jo.nˌis.tɑ»lit>
isolasjonista+N+Der/laš+A+Comp+Attr	isolasjonisttalut	ˈi.so.lˌɑs.jo.nˌis.tɑ»lut>
isolasjonista+N+Der/laš+A+Der/vuohta+N+Sg+Ill	isolasjonisttalašvuhtii	ˈi.so.lˌɑs.jo.nˌis.tɑ»lɑʃ»vˌuh.ti>i
jiekŋahockey+N+Ess+PxDu3	jiekŋahockeyneaskka	jˈiek.ŋɑ#hˌok.ke.y>neɑs.kɑ
jiekŋahockey+N+Ess+PxSg3	jiekŋahockeynis	jˈiek.ŋɑ#hˌok.ke.y>nis
jiekŋahockey+N+Ess	jiekŋahockeyn	jˈiek.ŋɑ#hˌok.ke.y>n
jiekŋahockey+N+Pl+Acc	jiekŋahockeyid	jˈiek.ŋɑ#hˌok.ke.y>id
jiekŋahockey+N+Pl+Com	jiekŋahockeyiguin	jˈiek.ŋɑ#hˌok.ke.y>i.gujn
jiekŋahockey+N+Pl+Ill	jiekŋahockeyide	jˈiek.ŋɑ#hˌok.ke.y>i.de
jiekŋahockey+N+Pl+Nom+PxDu1	jiekŋahockeyideame	jˈiek.ŋɑ#hˌok.ke.y>i.dĕɑ.me
jiekŋahockey+N+Pl+Nom	jiekŋahockeyt	jˈiek.ŋɑ#hˌok.ke.y>h
jiekŋahockey+N+Sg+Gen	jiekŋahockey	jˈiek.ŋɑ#hˌok.ke.y>
jiekŋahockey+N+Sg+Nom+PxPl2	jiekŋahockeyttet	jˈiek.ŋɑ#hˌok.ke.y>tːeh
jiekŋahockey+N+Sg+Com+PxPl1	jiekŋahockeyineamet	jˈiek.ŋɑ#hˌok.ke.y>i.nĕɑ.meh
jiekŋahockey+N+Sg+Com+PxSg1	jiekŋahockeyinan	jˈiek.ŋɑ#hˌok.ke.y>i.nɑn
jiekŋahockey+N+Sg+Com	jiekŋahockeyin	jˈiek.ŋɑ#hˌok.ke.y>in
jiekŋahockey+N+Sg+Ill	jiekŋahockeyi	jˈiek.ŋɑ#hˌok.ke.y>i
jiekŋahockey+N+Sg+Ill+PxDu1	jiekŋahockeysame	jˈiek.ŋɑ#hˌok.ke.y>sɑ.me
jiekŋahockey+N+Sg+Ill+PxSg3	jiekŋahockeysas	jˈiek.ŋɑ#hˌok.ke.y>sɑs
jiekŋahockey+N+Sg+Loc	jiekŋahockeys	jˈiek.ŋɑ#hˌok.ke.y>s
jiekŋahockey+N+Sg+Loc+PxDu2	jiekŋahockeysteatte	jˈiek.ŋɑ#hˌok.ke.y>stĕɑt.te
jiekŋahockey+N+Der/heapmi+A+Superl+Attr	jiekŋahockeyhamos	jˈiek.ŋɑ#hˌok.ke.y>»hˌɑ.mos
jiekŋahockey+N+Der/heapmi+A+Attr	jiekŋahockeyhis	jˈiek.ŋɑ#hˌok.ke.y>»his
jiekŋahockey+N+Der/huvva+V+IV+Pot+Prs+Du2	jiekŋahockeyhuvažeahppi	jˈiek.ŋɑ#hˌok.ke.y>»hˌu.vɑ.žˌĕɑhː.pi
jiekŋahockey+N+Der/huvva+V+IV+Sup	jiekŋahockeyhuvažit	jˈiek.ŋɑ#hˌok.ke.y>»hˌu.vɑ.žih
jiekŋahockey+N+Der/huvva+V+IV+Imprt+ConNegII	jiekŋahockeyhuvvo	jˈiek.ŋɑ#hˌok.ke.y>»hˌuv.vo
jiekŋastudio+N+Ess+PxSg1	jiekŋastudionan	jˈiek.ŋɑ#stˌu.dio>nɑn
jiekŋastudio+N+Ess+PxSg2	jiekŋastudionat	jˈiek.ŋɑ#stˌu.dio>nɑh
jiekŋastudio+N+Pl+Acc+PxPl3	jiekŋastudioideaset	jˈiek.ŋɑ#stˌu.dio>i.dĕɑ.seh
jiekŋastudio+N+Pl+Acc+PxSg1	jiekŋastudioidan	jˈiek.ŋɑ#stˌu.dio>i.dɑn
jiekŋastudio+N+Pl+Gen+PxSg2	jiekŋastudioidat	jˈiek.ŋɑ#stˌu.dio>i.dɑh
jiekŋastudio+N+Pl+Nom	jiekŋastudiot	jˈiek.ŋɑ#stˌu.dio>h
jiekŋastudio+N+Sg+Acc	jiekŋastudio	jˈiek.ŋɑ#stˌu.dio>
jiekŋastudio+N+Sg+Gen+PxPl1	jiekŋastudiomet	jˈiek.ŋɑ#stˌu.dio>meh
jiekŋastudio+N+Sg+Gen+PxPl3	jiekŋastudioset	jˈiek.ŋɑ#stˌu.dio>seh
jiekŋastudio+N+Sg+Nom+PxSg1	jiekŋastudion	jˈiek.ŋɑ#stˌu.dio>n
jiekŋastudio+N+Sg+Nom+PxSg3	jiekŋastudios	jˈiek.ŋɑ#stˌu.dio>s
jiekŋastudio+N+Sg+Com+PxDu1	jiekŋastudioineame	jˈiek.ŋɑ#stˌu.dio>i.nĕɑ.me
jiekŋastudio+N+Sg+Com+PxPl3	jiekŋastudioineaset	jˈiek.ŋɑ#stˌu.dio>i.nĕɑ.seh
jiekŋastudio+N+Sg+Ill	jiekŋastudioi	jˈiek.ŋɑ#stˌu.dio>i
jiekŋastudio+N+Sg+Ill+PxSg2	jiekŋastudiosat	jˈiek.ŋɑ#stˌu.dio>sɑh
jiekŋastudio+N+Sg+Loc	jiekŋastudios	jˈiek.ŋɑ#stˌu.dio>s
jiekŋastudio+N+Sg+Loc+PxPl2	jiekŋastudiosteattet	jˈiek.ŋɑ#stˌu.dio>stĕɑt.teh
jietnastudio+N+Ess+PxDu2	jietnastudioneatte	jˈiet.nɑ#stˌu.dio>nĕɑt.te
jietnastudio+N+Ess+PxPl2	jietnastudioneattet	jˈiet.nɑ#stˌu.dio>nĕɑt.teh
jietnastudio+N+Ess+PxSg1	jietnastudionan	jˈiet.nɑ#stˌu.dio>nɑn
jietnastudio+N+Ess+PxSg2	jietnastudionat	jˈiet.nɑ#stˌu.dio>nɑh
jietnastudio+N+Ess+PxSg3	jietnastudionis	jˈiet.nɑ#stˌu.dio>nis
jietnastudio+N+Pl+Com	jietnastudioiguin	jˈiet.nɑ#stˌu.dio>i.gujn
jietnastudio+N+Pl+Gen+PxDu3	jietnastudioideaskka	jˈiet.nɑ#stˌu.dio>i.deɑs.kɑ
jietnastudio+N+Pl+Gen+PxPl3	jietnastudioideaset	jˈiet.nɑ#stˌu.dio>i.dĕɑ.seh
jietnastudio+N+Pl+Ill+PxDu1	jietnastudioidaseame	jˈiet.nɑ#stˌu.dio>i.dɑ.sĕɑ.me
jietnastudio+N+Pl+Ill+PxDu2	jietnastudioidaseatte	jˈiet.nɑ#stˌu.dio>i.dɑ.sĕɑt.te
jietnastudio+N+Pl+Ill+PxPl3	jietnastudioidaseaset	jˈiet.nɑ#stˌu.dio>i.dɑ.sĕɑ.seh
jietnastudio+N+Pl+Ill	jietnastudioide	jˈiet.nɑ#stˌu.dio>i.de
jietnastudio+N+Pl+Loc+PxPl1	jietnastudioineamet	jˈiet.nɑ#stˌu.dio>i.nĕɑ.meh
jietnastudio+N+Pl+Loc+PxSg1	jietnastudioinan	jˈiet.nɑ#stˌu.dio>i.nɑn
jietnastudio+N+Pl+Nom+PxSg1	jietnastudioidan	jˈiet.nɑ#stˌu.dio>i.dɑn
jietnastudio+N+Pl+Nom	jietnastudiot	jˈiet.nɑ#stˌu.dio>h
jietnastudio+N+Sg+Acc+PxDu2	jietnastudiotte	jˈiet.nɑ#stˌu.dio>tːe
jietnastudio+N+Sg+Acc+PxPl3	jietnastudioset	jˈiet.nɑ#stˌu.dio>seh
jietnastudio+N+Sg+Acc+PxSg2	jietnastudiot	jˈiet.nɑ#stˌu.dio>h
jietnastudio+N+Sg+Gen+PxPl2	jietnastudiottet	jˈiet.nɑ#stˌu.dio>tːeh
jietnastudio+N+Sg+Gen+PxSg1	jietnastudion	jˈiet.nɑ#stˌu.dio>n
jietnastudio+N+Sg+Gen	jietnastudio	jˈiet.nɑ#stˌu.dio>
jietnastudio+N+Sg+Nom+PxPl1	jietnastudiomet	jˈiet.nɑ#stˌu.dio>meh
jietnastudio+N+Sg+Nom+PxPl2	jietnastudiottet	jˈiet.nɑ#stˌu.dio>tːeh
jietnastudio+N+Sg+Nom+PxSg2	jietnastudiot	jˈiet.nɑ#stˌu.dio>h
jietnastudio+N+Sg+Nom+PxSg3	jietnastudios	jˈiet.nɑ#stˌu.dio>s
jietnastudio+N+Sg+Com+PxDu1	jietnastudioineame	jˈiet.nɑ#stˌu.dio>i.nĕɑ.me
jietnastudio+N+Sg+Com+PxDu3	jietnastudioineaskka	jˈiet.nɑ#stˌu.dio>i.neɑs.kɑ
jietnastudio+N+Sg+Com+PxPl1	jietnastudioineamet	jˈiet.nɑ#stˌu.dio>i.nĕɑ.meh
jietnastudio+N+Sg+Com+PxSg1	jietnastudioinan	jˈiet.nɑ#stˌu.dio>i.nɑn
jietnastudio+N+Sg+Com	jietnastudioin	jˈiet.nɑ#stˌu.dio>in
jietnastudio+N+Sg+Ill	jietnastudioi	jˈiet.nɑ#stˌu.dio>i
jietnastudio+N+Sg+Ill+PxDu1	jietnastudiosame	jˈiet.nɑ#stˌu.dio>sɑ.me
jietnastudio+N+Sg+Ill+PxDu2	jietnastudiosatte	jˈiet.nɑ#stˌu.dio>sɑt.te
jietnastudio+N+Sg+Ill+PxPl3	jietnastudiosaset	jˈiet.nɑ#stˌu.dio>sɑ.seh
jietnastudio+N+Sg+Ill+PxSg2	jietnastudiosat	jˈiet.nɑ#stˌu.dio>sɑh
jietnastudio+N+Sg+Loc	jietnastudios	jˈiet.nɑ#stˌu.dio>s
jietnastudio+N+Sg+Loc+PxSg2	jietnastudiostat	jˈiet.nɑ#stˌu.dio>stɑh
jietnastudio+N+Der/heapmi+A+Ess	jietnastudioheapmin	jˈiet.nɑ#stˌu.dio>»hˌeɑp.min
jietnastudio+N+Der/heapmi+A+Pl+Nom	jietnastudioheamit	jˈiet.nɑ#stˌu.dio>»hˌeɑ.mih
jietnastudio+N+Der/heapmi+A+Pl+Gen	jietnastudiohemiid	jˈiet.nɑ#stˌu.dio>»hˌe.mijh
jietnastudio+N+Der/heapmi+A+Pl+Loc	jietnastudiohemiin	jˈiet.nɑ#stˌu.dio>»hˌe.mijn
jietnastudio+N+Der/heapmi+A+Attr	jietnastudiohis	jˈiet.nɑ#stˌu.dio>»his
jietnastudio+N+Der/huhtti+V+TV+Imprt+ConNeg	jietnastudiohuhte	jˈiet.nɑ#stˌu.dio>»hˌuh.te
jietnastudio+N+Der/huhtti+V+TV+VGen	jietnastudiohuhti	jˈiet.nɑ#stˌu.dio>»hˌuhː.ti
jietnastudio+N+Der/huhtti+V+TV+Imprt+Pl2	jietnastudiohuhttet	jˈiet.nɑ#stˌu.dio>»hˌuhː.teh
jietnastudio+N+Der/huhtti+V+TV+Ind+Prs+Sg3	jietnastudiohuhttá	jˈiet.nɑ#stˌu.dio>»hˌuhː.tá
jietnastudio+N+Der/huhtti+V+TV+Cond+Prs+Sg3	jietnastudiohuhtálii	jˈiet.nɑ#stˌu.dio>»hˌuhː.tá.lij
jietnastudio+N+Der/huhtti+V+TV+Ind+Prs+Sg1	jietnastudiohuhtán	jˈiet.nɑ#stˌu.dio>»hˌuhː.tán
jietnastudio+N+Der/huvva+V+IV+Ind+Prt+Pl1	jietnastudiohuvaimet	jˈiet.nɑ#stˌu.dio>»hˌu.vɑj.meh
jietnastudio+N+Der/huvva+V+IV+VAbess	jietnastudiohuvahaga	jˈiet.nɑ#stˌu.dio>»hˌu.vɑ.hˌɑ.gɑ
karaokelávlun+N+Sg+Nom+PxPl3	karaokelávlumeaset	khˈɑ.rɑː.ˌo.ke#lˌávː.lum>ĕɑ.seh
karaokelávlun+N+Sg+Nom+PxSg2	karaokelávlumat	khˈɑ.rɑː.ˌo.ke#lˌávː.lum>ɑh
karaokelávlun+N+Sg+Acc	karaokelávluma	khˈɑ.rɑː.ˌo.ke#lˌávː.lum>ɑ
karaokelávlun+N+Sg+Gen	karaokelávlun	khˈɑ.rɑː.ˌo.ke#lˌávː.lun>
karaokelávlun+N+Sg+Nom	karaokelávlun	khˈɑ.rɑː.ˌo.ke#lˌávː.lun>
karaokelávlun+N+Der/viđá+Adv	karaokelávlunviđá	khˈɑ.rɑː.ˌo.ke#lˌávː.lun»vˌi.ðá
karaokeshow+N+Sg+Nom	karaokeshow	khˈɑ.rɑː.ˌo.ke#shov>
karaokeshow+N+Ess+PxPl1	karaokeshowaneamet	khˈɑ.rɑː.ˌo.ke#shˌo.vɑ>nĕɑ.meh
karaokeshow+N+Pl+Gen+PxPl2	karaokeshowaideattet	khˈɑ.rɑː.ˌo.ke#shˌo.vɑ>i.dĕɑt.teh
karaokeshow+N+Der/huvva+V+IV+Imprt+Sg2	karaokeshowahuva	khˈɑ.rɑː.ˌo.ke#shˌo.vɑ>»hˌu.vɑ
karaokeshow+N+Der/huvva+V+IV+Ind+Prs+Sg3	karaokeshowahuvvá	khˈɑ.rɑː.ˌo.ke#shˌo.vɑ>»hˌuvː.vá
karaokeshow+N+Sg+Ill	karaokeshowii	khˈɑ.rɑː.ˌo.ke#shˌo.vi>i
karaokešovva+N+Der/heapmi+A+Superl+Ess	karaokešovaheamosin	khˈɑ.rɑː.ˌo.ke#ʃˌo.vɑ»hˌĕɑ.mos>in
karaokešovva+N+Der/heapmi+A+Attr	karaokešovahis	khˈɑ.rɑː.ˌo.ke#ʃˌo.vɑ»his>
karaokešovva+N+Der/heapmi+A+Attr+Der/vuohta+N+Sg+Ill	karaokešovahisvuhtii	khˈɑ.rɑː.ˌo.ke#ʃˌo.vɑ»his>»vˌuh.tij
karaokešovva+N+Der/huhtti+V+TV+VAbess	karaokešovahuhtihaga	khˈɑ.rɑː.ˌo.ke#ʃˌo.vɑ»hˌuh.ti>hɑ.gɑ
karaokešovva+N+Der/huhtti+V+TV+VAbess+A+Attr	karaokešovahuhtikeahtes	khˈɑ.rɑː.ˌo.ke#ʃˌo.vɑ»hˌuh.ti>kĕɑh.tes
karaokešovva+N+Der/huvva+V+IV+Imprt+Pl1	karaokešovahuvvut	khˈɑ.rɑː.ˌo.ke#ʃˌo.vɑ»hˌuv.vu>h
karaokešovva+N+Pl+Com+PxDu2	karaokešovvaideatteguin	khˈɑ.rɑː.ˌo.ke#ʃˌov.vɑ>i.dĕɑt.te.gujn
karaokešovva+N+Pl+Nom	karaokešovvat	khˈɑ.rɑː.ˌo.ke#ʃˌov.vɑ>h
karaokešovva+N+Sg+Nom+PxPl1	karaokešovvamet	khˈɑ.rɑː.ˌo.ke#ʃˌov.vɑ>meh
karaokešovva+N+Sg+Com+PxDu2	karaokešovvaineatte	khˈɑ.rɑː.ˌo.ke#ʃˌov.vɑ>i.nĕɑt.te
karaokešovva+N+Sg+Ill	karaokešovvii	khˈɑ.rɑː.ˌo.ke#ʃˌov.vi>i
konseaptastrategiija+N+Ess+PxDu2	konseaptastrategiijaneatte	khˈonː.seɑp.tɑ#strˌɑ.te.gˌij.jɑ>nĕɑt.te
konseaptastrategiija+N+Ess+PxPl3	konseaptastrategiijaneaset	khˈonː.seɑp.tɑ#strˌɑ.te.gˌij.jɑ>nĕɑ.seh
konseaptastrategiija+N+Ess+PxSg2	konseaptastrategiijanat	khˈonː.seɑp.tɑ#strˌɑ.te.gˌij.jɑ>nɑh
konseaptastrategiija+N+Pl+Ill+PxDu1	konseaptastrategiijaidasame	khˈonː.seɑp.tɑ#strˌɑ.te.gˌij.jɑ>i.dɑ.sɑ.me
konseaptastrategiija+N+Pl+Nom+PxSg1	konseaptastrategiijaidan	khˈonː.seɑp.tɑ#strˌɑ.te.gˌij.jɑ>i.dɑn
konseaptastrategiija+N+Pl+Nom	konseaptastrategiijat	khˈonː.seɑp.tɑ#strˌɑ.te.gˌij.jɑ>h
konseaptastrategiija+N+Sg+Ill+PxDu1	konseaptastrategiijaseame	khˈonː.seɑp.tɑ#strˌɑ.te.gˌij.jɑ>sĕɑ.me
konseaptastrategiija+N+Der/Dimin+N+Der/Dimin+N+Sg+Nom	konseaptastrategiijažaš	khˈonː.seɑp.tɑ#strˌɑ.te.gˌij.jɑ»žɑʃ>
konseaptastrategiija+N+Der/Dimin+N+Sg+Ill	konseaptastrategiijažii	khˈonː.seɑp.tɑ#strˌɑ.te.gˌij.jɑ»žij
konseaptastrategiija+N+Der/heapmi+A+Comp+Attr	konseaptastrategiijahet	khˈonː.seɑp.tɑ#strˌɑ.te.gˌij.jɑ»het>
konseaptastrategiija+N+Der/heapmi+A+Comp+Attr	konseaptastrategiijahut	khˈonː.seɑp.tɑ#strˌɑ.te.gˌij.jɑ»hut>
konseaptastrategiija+N+Der/heapmi+A+Comp+Sg+Nom	konseaptastrategiijahut	khˈonː.seɑp.tɑ#strˌɑ.te.gˌij.jɑ»hut>
konseaptastrategiija+N+Der/heapmi+A+Superl+Attr	konseaptastrategiijahamos	khˈonː.seɑp.tɑ#strˌɑ.te.gˌij.jɑ»hˌɑ.mos>
konseaptastrategiija+N+Der/heapmi+A+Pl+Gen	konseaptastrategiijahemiid	khˈonː.seɑp.tɑ#strˌɑ.te.gˌij.jɑ»hˌe.mi>id
konseaptastrategiija+N+Der/heapmi+A+Attr	konseaptastrategiijahis	khˈonː.seɑp.tɑ#strˌɑ.te.gˌij.jɑ»his>
konseaptastrategiija+N+Der/heapmi+A+Attr+Der/vuohta+N+Sg+Ill	konseaptastrategiijahisvuhtii	khˈonː.seɑp.tɑ#strˌɑ.te.gˌij.jɑ»his>»vˌuh.tij
konseaptastrategiija+N+Der/huhtti+V+TV+VAbess	konseaptastrategiijahuhtehaga	khˈonː.seɑp.tɑ#strˌɑ.te.gˌij.jɑ»hˌuh.te>hɑ.gɑ
konseaptastrategiija+N+Der/huhtti+V+TV+VAbess	konseaptastrategiijahuhtikeahttá	khˈonː.seɑp.tɑ#strˌɑ.te.gˌij.jɑ»hˌuh.ti>kĕɑhː.tá
konseaptastrategiija+N+Der/huhtti+V+TV+Ind+Prt+Pl3	konseaptastrategiijahuhtte	khˈonː.seɑp.tɑ#strˌɑ.te.gˌij.jɑ»hˌuhː.te>
konseaptastrategiija+N+Der/huhtti+V+TV+Cond+Prs+Sg1	konseaptastrategiijahuhtáledjen	khˈonː.seɑp.tɑ#strˌɑ.te.gˌij.jɑ»hˌuhː.tá>lec.cen
konseaptastrategiija+N+Der/huvva+V+IV+Sup	konseaptastrategiijahuvažit	khˈonː.seɑp.tɑ#strˌɑ.te.gˌij.jɑ»hˌu.vɑ>žih
konseaptastrategiija+N+Der/huvva+V+IV+ConNegII	konseaptastrategiijahuvvo	khˈonː.seɑp.tɑ#strˌɑ.te.gˌij.jɑ»hˌuv.vo>
konseaptastrategiija+N+Der/huvva+V+IV+Imprt+Pl1	konseaptastrategiijahuvvut	khˈonː.seɑp.tɑ#strˌɑ.te.gˌij.jɑ»hˌuv.vu>h
konseaptastrategiija+N+Der/laš+A+Der/vuohta+N+Sg+Nom	konseaptastrategiijalašvuohta	khˈonː.seɑp.tɑ#strˌɑ.te.gˌij.jɑ»lɑʃ»vˌuoh.tɑ>
konseaptastrategiija+N+Sg+Ill	konseaptastrategiijii	khˈonː.seɑp.tɑ#strˌɑ.te.gˌij.ji>i
kubista+N+Ess+PxPl1	kubistaneamet	khˈuː.bis.tɑ>nĕɑ.meh
kubista+N+Sg+Nom+PxPl2	kubistadet	khˈuː.bis.tɑ>deh
kubista+N+Der/viđá+Adv	kubistaviđá	khˈuː.bis.tɑ»vˌi.ðá
kubista+N+Sg+Ill	kubistii	khˈuː.bis.ti>i
kubista+N+Pl+Com+PxSg1	kubisttaidanguin	khˈuː.bis.tɑ>i.dɑn.gujn
kubista+N+Pl+Nom	kubisttat	khˈuː.bis.tɑ>h
kubista+N+Sg+Acc+PxDu3	kubisttaska	khˈuː.bis.tɑ>skɑ
kubista+N+Sg+Loc+PxDu1	kubisttasteame	khˈuː.bis.tɑ>stĕɑ.me
kubista+N+Der/heapmi+A+Comp+Sg+Nom	kubisttahet	khˈuː.bis.tɑ»het>
kubista+N+Der/heapmi+A+Superl+Pl+Com	kubisttahamosiiguin	khˈuː.bis.tɑ»hˌɑ.mos>ij.gujn
kubista+N+Der/heapmi+A+Sg+Com	kubisttahemiin	khˈuː.bis.tɑ»hˌe.mi>in
kubista+N+Der/huhtti+V+TV+Ger	kubisttahuhtediin	khˈuː.bis.tɑ»hˌuh.te>dijn
kulttorstrategiija+N+Pl+Nom	kulttorstrategiijat	khˈult.tor#strˌɑ.te.gˌij.jɑ>h
kulttorstrategiija+N+Sg+Nom+PxSg1	kulttorstrategiijan	khˈult.tor#strˌɑ.te.gˌij.jɑ>n
kulttorstrategiija+N+Sg+Loc+PxSg2	kulttorstrategiijastat	khˈult.tor#strˌɑ.te.gˌij.jɑ>stɑh
kulttorstrategiija+N+Der/huvva+V+IV+Der/NomAct+N+Der/viđá+Adv	kulttorstrategiijahuvvanviđá	khˈult.tor#strˌɑ.te.gˌij.jɑ»hˌuv.vɑ>»n»vˌi.ðá
kulttorstrategiija+N+Sg+Ill	kulttorstrategiijii	khˈult.tor#strˌɑ.te.gˌij.ji>i
kulturstrategiija+N+Ess+PxDu1	kulturstrategiijaneame	khˈulː.tur#strˌɑ.te.gˌij.jɑ>nĕɑ.me
kulturstrategiija+N+Pl+Acc	kulturstrategiijaid	khˈulː.tur#strˌɑ.te.gˌij.jɑ>id
kulturstrategiija+N+Pl+Com	kulturstrategiijaiguin	khˈulː.tur#strˌɑ.te.gˌij.jɑ>i.gujn
kulturstrategiija+N+Pl+Nom	kulturstrategiijat	khˈulː.tur#strˌɑ.te.gˌij.jɑ>h
kulturstrategiija+N+Sg+Nom+PxSg2	kulturstrategiijat	khˈulː.tur#strˌɑ.te.gˌij.jɑ>h
kulturstrategiija+N+Sg+Ill	kulturstrategiijii	khˈulː.tur#strˌɑ.te.gˌij.ji>i
kunddarbaromehter+N+Ess	kunddarbaromehterin	khˈunt.tɑːr#bˌɑ.ro.mˌeh.ter>in
kunddarbaromehter+N+Pl+Nom	kunddarbaromehterat	khˈunt.tɑːr#bˌɑ.ro.mˌeh.ter>ɑh
kunddarbaromehter+N+Sg+Acc	kunddarbaromehtera	khˈunt.tɑːr#bˌɑ.ro.mˌeh.ter>ɑ
kunddarbaromehter+N+Sg+Ill+PxPl3	kunddarbaromehterasaset	khˈunt.tɑːr#bˌɑ.ro.mˌeh.ter>ɑ.sɑ.seh
kunddarbaromehter+N+Der/Dimin+N+Sg+Nom	kunddarbaromehteraš	khˈunt.tɑːr#bˌɑ.ro.mˌeh.ter»ɑʃ>
kunddarbaromehter+N+Der/viđá+Adv	kunddarbaromehterviđá	khˈunt.tɑːr#bˌɑ.ro.mˌeh.ter»vˌi.ðá
kunddarbaromettar+N+Sg+Nom	kunddarbaromettar	khˈunt.tɑːr#bˌɑ.ro.mˌet.tɑr>
kunddarbaromettar+N+Der/geahtes+A+Attr	kunddarbaromettarkeahtes	khˈunt.tɑːr#bˌɑ.ro.mˌet.tɑr>»kˌĕɑh.tes
kunddarbaromettar+N+Der/heapmi+A+Attr	kunddarbaromettarhis	khˈunt.tɑːr#bˌɑ.ro.mˌet.tɑr»his>
kunddarbaromettar+N+Der/laš+A+Comp+Sg+Loc	kunddarbaromettarlaččabus	khˈunt.tɑːr#bˌɑ.ro.mˌet.tɑr»lˌɑč.čɑ.bus
kunddarbaromettar+N+Der/viđá+Adv	kunddarbaromettarviđá	khˈunt.tɑːr#bˌɑ.ro.mˌet.tɑr»vˌi.ðá
lohkanstrategiija+N+Ess+PxDu3	lohkanstrategiijaneaskka	lˈohː.kɑːn#strˌɑ.te.gˌij.jɑ>neɑs.kɑ
lohkanstrategiija+N+Ess+PxSg3	lohkanstrategiijanis	lˈohː.kɑːn#strˌɑ.te.gˌij.jɑ>nis
lohkanstrategiija+N+Pl+Acc+PxSg2	lohkanstrategiijaidat	lˈohː.kɑːn#strˌɑ.te.gˌij.jɑ>i.dɑh
lohkanstrategiija+N+Pl+Com	lohkanstrategiijaiguin	lˈohː.kɑːn#strˌɑ.te.gˌij.jɑ>i.gujn
lohkanstrategiija+N+Pl+Gen+PxSg1	lohkanstrategiijaidan	lˈohː.kɑːn#strˌɑ.te.gˌij.jɑ>i.dɑn
lohkanstrategiija+N+Pl+Ill+PxSg3	lohkanstrategiijaidasas	lˈohː.kɑːn#strˌɑ.te.gˌij.jɑ>i.dɑ.sɑs
lohkanstrategiija+N+Pl+Ill	lohkanstrategiijaide	lˈohː.kɑːn#strˌɑ.te.gˌij.jɑ>i.de
lohkanstrategiija+N+Pl+Loc+PxPl1	lohkanstrategiijaineamet	lˈohː.kɑːn#strˌɑ.te.gˌij.jɑ>i.nĕɑ.meh
lohkanstrategiija+N+Pl+Nom	lohkanstrategiijat	lˈohː.kɑːn#strˌɑ.te.gˌij.jɑ>h
lohkanstrategiija+N+Sg+Acc+PxSg2	lohkanstrategiijat	lˈohː.kɑːn#strˌɑ.te.gˌij.jɑ>h
lohkanstrategiija+N+Sg+Gen+PxDu1	lohkanstrategiijame	lˈohː.kɑːn#strˌɑ.te.gˌij.jɑ>me
lohkanstrategiija+N+Sg+Gen+PxSg1	lohkanstrategiijan	lˈohː.kɑːn#strˌɑ.te.gˌij.jɑ>n
lohkanstrategiija+N+Sg+Nom+PxDu1	lohkanstrategiijame	lˈohː.kɑːn#strˌɑ.te.gˌij.jɑ>me
lohkanstrategiija+N+Sg+Com+PxPl1	lohkanstrategiijaineamet	lˈohː.kɑːn#strˌɑ.te.gˌij.jɑ>i.nĕɑ.meh
lohkanstrategiija+N+Sg+Com+PxSg2	lohkanstrategiijainat	lˈohː.kɑːn#strˌɑ.te.gˌij.jɑ>i.nɑh
lohkanstrategiija+N+Sg+Ill	lohkanstrategiijai	lˈohː.kɑːn#strˌɑ.te.gˌij.jɑ>i
lohkanstrategiija+N+Sg+Ill+PxPl2	lohkanstrategiijaseattet	lˈohː.kɑːn#strˌɑ.te.gˌij.jɑ>sĕɑt.teh
lohkanstrategiija+N+Sg+Ill+PxPl3	lohkanstrategiijaseaset	lˈohː.kɑːn#strˌɑ.te.gˌij.jɑ>sĕɑ.seh
lohkanstrategiija+N+Sg+Ill+PxSg3	lohkanstrategiijasis	lˈohː.kɑːn#strˌɑ.te.gˌij.jɑ>sis
lohkanstrategiija+N+Sg+Loc	lohkanstrategiijas	lˈohː.kɑːn#strˌɑ.te.gˌij.jɑ>s
lohkanstrategiija+N+Der/viđá+Adv	lohkanstrategiijaviđá	lˈohː.kɑːn#strˌɑ.te.gˌij.jɑ>»vˌi.ðá
lohkanstrategiija+N+Der/Dimin+N+Ess	lohkanstrategiijažin	lˈohː.kɑːn#strˌɑ.te.gˌij.jɑ»žin
lohkanstrategiija+N+Der/Dimin+N+Pl+Nom	lohkanstrategiijažat	lˈohː.kɑːn#strˌɑ.te.gˌij.jɑ»žɑh
lohkanstrategiija+N+Der/Dimin+N+Sg+Acc+PxSg3	lohkanstrategiijažis	lˈohː.kɑːn#strˌɑ.te.gˌij.jɑ»žis
lohkanstrategiija+N+Der/Dimin+N+Sg+Gen	lohkanstrategiijaža	lˈohː.kɑːn#strˌɑ.te.gˌij.jɑ»žɑ
lohkanstrategiija+N+Der/heapmi+A+Comp+Sg+Nom	lohkanstrategiijahat	lˈohː.kɑːn#strˌɑ.te.gˌij.jɑ»hɑt>
lohkanstrategiija+N+Der/heapmi+A+Comp+Sg+Ill	lohkanstrategiijahebbui	lˈohː.kɑːn#strˌɑ.te.gˌij.jɑ»hˌeb.bu>i
lohkanstrategiija+N+Der/heapmi+A+Sg+Loc	lohkanstrategiijaheames	lˈohː.kɑːn#strˌɑ.te.gˌij.jɑ»hˌĕɑ.me>s
lohkanstrategiija+N+Der/huhtti+V+TV+VAbess+A+Attr	lohkanstrategiijahuhtikeahtes	lˈohː.kɑːn#strˌɑ.te.gˌij.jɑ»hˌuh.ti>kĕɑh.tes
lohkanstrategiija+N+Der/huhtti+V+TV+Der/PassS+V+IV+Ind+Prt+Sg3	lohkanstrategiijahuhttui	lˈohː.kɑːn#strˌɑ.te.gˌij.jɑ»hˌuhː.tu>»i
lohkanstrategiija+N+Der/huvva+V+IV+Ger+PxDu3	lohkanstrategiijahuvadettiineaskka	lˈohː.kɑːn#strˌɑ.te.gˌij.jɑ»hˌu.vɑ>det.tij.neɑs.kɑ
lohkanstrategiija+N+Der/huvva+V+IV+Pot+Prs+Sg2	lohkanstrategiijahuvažat	lˈohː.kɑːn#strˌɑ.te.gˌij.jɑ»hˌu.vɑ>žɑh
lohkanstrategiija+N+Der/huvva+V+IV+VAbess	lohkanstrategiijahuvahaga	lˈohː.kɑːn#strˌɑ.te.gˌij.jɑ»hˌu.vɑ>hɑ.gɑ
lohkanstrategiija+N+Der/huvva+V+IV+VAbess	lohkanstrategiijahuvakeahttájin	lˈohː.kɑːn#strˌɑ.te.gˌij.jɑ»hˌu.vɑ>kĕɑhː.tá.jin
lohkanstrategiija+N+Der/huvva+V+IV+VGen	lohkanstrategiijahuva	lˈohː.kɑːn#strˌɑ.te.gˌij.jɑ»hˌu.vɑ>
lohkanstrategiija+N+Der/huvva+V+IV+Imprt+Du2	lohkanstrategiijahuvvi	lˈohː.kɑːn#strˌɑ.te.gˌij.jɑ»hˌuv.vi>
lohkanstrategiija+N+Der/huvva+V+IV+Imprt+Pl2	lohkanstrategiijahuvvit	lˈohː.kɑːn#strˌɑ.te.gˌij.jɑ»hˌuv.vi>h
lohkanstrategiija+N+Der/laš+A+Comp+Pl+Nom	lohkanstrategiijalabbot	lˈohː.kɑːn#strˌɑ.te.gˌij.jɑ»lˌɑb.bo>h
lohkanstrategiija+N+Der/laš+A+Comp+Sg+Ill	lohkanstrategiijalebbui	lˈohː.kɑːn#strˌɑ.te.gˌij.jɑ»lˌeb.bu>i
lohkanstrategiija+N+Der/laš+A+Comp+Attr	lohkanstrategiijalit	lˈohː.kɑːn#strˌɑ.te.gˌij.jɑ»lit>
lohkanstrategiija+N+Der/laš+A+Attr+Der/vuohta+N+Sg+Nom+PxSg1	lohkanstrategiijalašvuohtan	lˈohː.kɑːn#strˌɑ.te.gˌij.jɑ»lɑʃ>»vˌuoh.tɑn
lohkanstrategiija+N+Der/laš+A+Sg+Nom	lohkanstrategiijalaš	lˈohː.kɑːn#strˌɑ.te.gˌij.jɑ»lɑʃ>
lohkanstrategiija+N+Sg+Ill	lohkanstrategiijii	lˈohː.kɑːn#strˌɑ.te.gˌij.ji>i
marebáhkka+N+Pl+Loc+PxPl1	marebáhkaineamet	mˈɑ.re#bˌáh.kɑ>i.nĕɑ.meh
marebáhkka+N+Der/heapmi+A+Comp+Sg+Nom	marebáhkahet	mˈɑ.re#bˌáh.kɑ»het>
marebáhkka+N+Der/heapmi+A+Sg+Com	marebáhkahemiin	mˈɑ.re#bˌáh.kɑ»hˌe.mi>in
marebáhkka+N+Sg+Acc+PxPl1	marebáhkkamet	mˈɑ.re#bˌɑhː.kɑ>meh
marebáhkka+N+Sg+Gen+PxDu1	marebáhkkame	mˈɑ.re#bˌɑhː.kɑ>me
marebáhkka+N+Sg+Nom+PxDu1	marebáhkkame	mˈɑ.re#bˌɑhː.kɑ>me
marebáhkka+N+Der/viđá+Adv	marebáhkkaviđá	mˈɑ.re#bˌɑhː.kɑ»vˌi.ðá
marebáhkka+N+Sg+Ill	marebáhkkii	mˈɑ.re#bˌɑhː.ki>i
masochista+N+Sg+Gen+PxDu1	masochistame	mˈɑ.sok.hˌisː.tɑ>me
masochista+N+Der/viđá+Adv	masochistaviđá	mˈɑ.sok.hˌisː.tɑ»vˌi.ðá
masochista+N+Sg+Ill	masochistii	mˈɑ.sok.hˌisː.ti>i
masochista+N+Sg+Com+PxPl2	masochisttaineattet	mˈɑ.sok.hˌis.tɑ>i.nĕɑt.teh
masochista+N+Der/huvva+V+IV+ConNegII	masochisttahuvvo	mˈɑ.sok.hˌis.tɑ»hˌuv.vo>
masochista+N+Der/laš+A+Comp+Sg+Nom	masochisttalat	mˈɑ.sok.hˌis.tɑ»lɑt>
materialista+N+Sg+Gen+PxSg1	materialistan	mˈɑ.te.rˌi.ɑ.lˌis.tɑ>n
materialista+N+Der/viđá+Adv	materialistaviđá	mˈɑ.te.rˌi.ɑ.lˌis.tɑ»vˌi.ðá
materialista+N+Sg+Ill	materialistii	mˈɑ.te.rˌi.ɑ.lˌis.ti>i
materialista+N+Pl+Ill+PxPl3	materialisttaidasaset	mˈɑ.te.rˌi.ɑ.lˌis.tɑ>i.dɑ.sɑ.seh
materialista+N+Pl+Nom	materialisttat	mˈɑ.te.rˌi.ɑ.lˌis.tɑ>h
materialista+N+Sg+Gen+PxSg3	materialisttas	mˈɑ.te.rˌi.ɑ.lˌis.tɑ>s
materialista+N+Sg+Com+PxSg1	materialisttainan	mˈɑ.te.rˌi.ɑ.lˌis.tɑ>i.nɑn
materialista+N+Sg+Loc+PxSg2	materialisttastat	mˈɑ.te.rˌi.ɑ.lˌis.tɑ>stɑh
materialista+N+Der/heapmi+A+Sg+Com	materialisttahemiin	mˈɑ.te.rˌi.ɑ.lˌis.tɑ»hˌe.mi>in
materialista+N+Der/heapmi+A+Attr+Der/vuohta+N+Sg+Ill	materialisttahisvuhtii	mˈɑ.te.rˌi.ɑ.lˌis.tɑ»his>»vˌuh.tij
materialista+N+Der/laš+A+AttrCmp+Der/bealjat+A+Der/vuohta+N+Sg+Ill	materialisttalašbealjatvuhtii	mˈɑ.te.rˌi.ɑ.lˌis.tɑ»lɑʃ>»bˌeɑl.jɑh»vˌuh.tij
mediastrategiija+N+Ess+PxPl1	mediastrategiijaneamet	mˈe.di.ɑ#strˌɑ.te.gˌij.jɑ>nĕɑ.meh
mediastrategiija+N+Sg+Acc+PxDu1	mediastrategiijame	mˈe.di.ɑ#strˌɑ.te.gˌij.jɑ>me
mediastrategiija+N+Sg+Ill+PxPl1	mediastrategiijaseamet	mˈe.di.ɑ#strˌɑ.te.gˌij.jɑ>sĕɑ.meh
mediastrategiija+N+Der/Dimin+N+Der/viđá+Adv	mediastrategiijašviđá	mˈe.di.ɑ#strˌɑ.te.gˌij.jɑ»ʃ»vˌi.ðá
mediastrategiija+N+Der/Dimin+N+Pl+Nom	mediastrategiijažat	mˈe.di.ɑ#strˌɑ.te.gˌij.jɑ»žɑh
mediastrategiija+N+Der/heapmi+A+Attr+Der/vuohta+N+Sg+Ill	mediastrategiijahisvuhtii	mˈe.di.ɑ#strˌɑ.te.gˌij.jɑ»his>»vˌuh.tij
mediastrategiija+N+Der/huvva+V+IV+Pot+Prs+Pl3	mediastrategiijahuvažit	mˈe.di.ɑ#strˌɑ.te.gˌij.jɑ»hˌu.vɑ>žih
mediastrategiija+N+Der/huvva+V+IV+VGen	mediastrategiijahuva	mˈe.di.ɑ#strˌɑ.te.gˌij.jɑ»hˌu.vɑ>
mediastrategiija+N+Sg+Ill	mediastrategiijii	mˈe.di.ɑ#strˌɑ.te.gˌij.ji>i
minerálastrategiija+N+Pl+Nom	minerálastrategiijat	mˈi.ne.rˌá.lɑ#strˌɑ.te.gˌij.jɑ>h
minerálastrategiija+N+Sg+Com+PxPl2	minerálastrategiijaineattet	mˈi.ne.rˌá.lɑ#strˌɑ.te.gˌij.jɑ>i.nĕɑt.teh
minerálastrategiija+N+Sg+Com+PxSg1	minerálastrategiijainan	mˈi.ne.rˌá.lɑ#strˌɑ.te.gˌij.jɑ>i.nɑn
minerálastrategiija+N+Sg+Ill	minerálastrategiijai	mˈi.ne.rˌá.lɑ#strˌɑ.te.gˌij.jɑ>i
minerálastrategiija+N+Der/viđá+Adv	minerálastrategiijaviđá	mˈi.ne.rˌá.lɑ#strˌɑ.te.gˌij.jɑ>»vˌi.ðá
minerálastrategiija+N+Der/Dimin+N+Ess	minerálastrategiijažin	mˈi.ne.rˌá.lɑ#strˌɑ.te.gˌij.jɑ»žin
minerálastrategiija+N+Der/huvva+V+IV+Ind+Prs+Sg1	minerálastrategiijahuvan	mˈi.ne.rˌá.lɑ#strˌɑ.te.gˌij.jɑ»hˌu.vɑ>n
minerálastrategiija+N+Der/huvva+V+IV+Imprt+Pl1	minerálastrategiijahuvvot	mˈi.ne.rˌá.lɑ#strˌɑ.te.gˌij.jɑ»hˌuv.vo>h
minerálastrategiija+N+Der/laš+A+Attr+Der/vuohta+N+Sg+Ill	minerálastrategiijalašvuhtii	mˈi.ne.rˌá.lɑ#strˌɑ.te.gˌij.jɑ»lɑʃ>»vˌuh.tij
minerálastrategiija+N+Sg+Ill	minerálastrategiijii	mˈi.ne.rˌá.lɑ#strˌɑ.te.gˌij.ji>i
moralista+N+Ess+PxDu3	moralistaneaskka	mˈo.rɑː.lˌisː.tɑ>neɑs.kɑ
moralista+N+Ess+PxPl1	moralistaneamet	mˈo.rɑː.lˌisː.tɑ>nĕɑ.meh
moralista+N+Ess+PxSg2	moralistanat	mˈo.rɑː.lˌisː.tɑ>nɑh
moralista+N+Ess	moralistan	mˈo.rɑː.lˌisː.tɑ>n
moralista+N+Sg+Acc+PxSg1	moralistan	mˈo.rɑː.lˌisː.tɑ>n
moralista+N+Sg+Ill+PxPl2	moralistaseattet	mˈo.rɑː.lˌisː.tɑ>sĕɑt.teh
moralista+N+Der/viđá+Adv	moralistaviđá	mˈo.rɑː.lˌisː.tɑ»vˌi.ðá
moralista+N+Sg+Ill	moralistii	mˈo.rɑː.lˌisː.ti>i
moralista+N+Pl+Loc+PxPl1	moralisttaineamet	mˈo.rɑː.lˌis.tɑ>i.nĕɑ.meh
moralista+N+Pl+Loc+PxPl2	moralisttaineattet	mˈo.rɑː.lˌis.tɑ>i.nĕɑt.teh
moralista+N+Pl+Loc+PxSg2	moralisttainat	mˈo.rɑː.lˌis.tɑ>i.nɑh
moralista+N+Pl+Nom	moralisttat	mˈo.rɑː.lˌis.tɑ>h
moralista+N+Sg+Acc+PxDu3	moralisttaska	mˈo.rɑː.lˌis.tɑ>skɑ
moralista+N+Sg+Acc+PxSg2	moralisttat	mˈo.rɑː.lˌis.tɑ>h
moralista+N+Sg+Loc	moralisttas	mˈo.rɑː.lˌis.tɑ>s
moralista+N+Der/heapmi+A+Superl+Attr	moralisttaheamos	mˈo.rɑː.lˌis.tɑ»hˌĕɑ.mos>
moralista+N+Der/heapmi+A+Attr	moralisttahis	mˈo.rɑː.lˌis.tɑ»his>
moralista+N+Der/heapmi+A+Attr+Der/vuohta+N+Sg+Ill+PxPl1	moralisttahisvuohtaseamet	mˈo.rɑː.lˌis.tɑ»his>»vˌuoh.tɑ.sˌĕɑ.meh
moralista+N+Der/huhtti+V+TV+VAbess	moralisttahuhtehaga	mˈo.rɑː.lˌis.tɑ»hˌuh.te>hɑ.gɑ
moralista+N+Der/huhtti+V+TV+Cond+Prs+Du2	moralisttahuhtáleidde	mˈo.rɑː.lˌis.tɑ»hˌuhː.tá>lejd.de
moralista+N+Der/huhtti+V+TV+Sup	moralisttahuhtážit	mˈo.rɑː.lˌis.tɑ»hˌuhː.tá>žih
moralista+N+Der/huvva+V+IV+Imprt+Du2	moralisttahuvvi	mˈo.rɑː.lˌis.tɑ»hˌuv.vi>
museastrategiija+N+Der/viđá+Adv	museastrategiijaviđá	mˈu.seɑ#strˌɑ.te.gˌij.jɑ>»vˌi.ðá
museastrategiija+N+Der/laš+A+Attr	museastrategiijalaš	mˈu.seɑ#strˌɑ.te.gˌij.jɑ»lɑʃ>
museastrategiija+N+Sg+Ill	museastrategiijii	mˈu.seɑ#strˌɑ.te.gˌij.ji>i
musihkkastudio+N+Ess+PxDu2	musihkkastudioneatte	mˈuː.sihː.kɑ#stˌu.dio>nĕɑt.te
musihkkastudio+N+Ess+PxSg1	musihkkastudionan	mˈuː.sihː.kɑ#stˌu.dio>nɑn
musihkkastudio+N+Ess	musihkkastudion	mˈuː.sihː.kɑ#stˌu.dio>n
musihkkastudio+N+Pl+Com+PxPl2	musihkkastudioideattetguin	mˈuː.sihː.kɑ#stˌu.dio>i.dĕɑt.tet.gujn
musihkkastudio+N+Sg+Acc+PxDu2	musihkkastudiotte	mˈuː.sihː.kɑ#stˌu.dio>tːe
musihkkastudio+N+Sg+Nom+PxDu2	musihkkastudiotte	mˈuː.sihː.kɑ#stˌu.dio>tːe
musihkkastudio+N+Sg+Com+PxDu1	musihkkastudioineame	mˈuː.sihː.kɑ#stˌu.dio>i.nĕɑ.me
muséastrategiija+N+Der/Dimin+N+Der/viđá+Adv	muséastrategiijašviđá	mˈu.seː.ɑ#strˌɑ.te.gˌij.jɑ»ʃ»vˌi.ðá
muséastrategiija+N+Der/heapmi+A+Sg+Com	muséastrategiijahemiin	mˈu.seː.ɑ#strˌɑ.te.gˌij.jɑ»hˌe.mi>in
muséastrategiija+N+Sg+Ill	muséastrategiijii	mˈu.seː.ɑ#strˌɑ.te.gˌij.ji>i
máhttostrategiija+N+Pl+Loc+PxSg1	máhttostrategiijainan	mˈɑhː.to#strˌɑ.te.gˌij.jɑ>i.nɑn
máhttostrategiija+N+Der/heapmi+A+Attr	máhttostrategiijahis	mˈɑhː.to#strˌɑ.te.gˌij.jɑ»his>
máhttostrategiija+N+Sg+Ill	máhttostrategiijii	mˈɑhː.to#strˌɑ.te.gˌij.ji>i
márkanstrategiija+N+Ess+PxSg3	márkanstrategiijanis	mˈárː.kɑn#strˌɑ.te.gˌij.jɑ>nis
márkanstrategiija+N+Sg+Acc+PxDu1	márkanstrategiijame	mˈárː.kɑn#strˌɑ.te.gˌij.jɑ>me
márkanstrategiija+N+Sg+Com+PxSg2	márkanstrategiijainat	mˈárː.kɑn#strˌɑ.te.gˌij.jɑ>i.nɑh
márkanstrategiija+N+Sg+Ill	márkanstrategiijii	mˈárː.kɑn#strˌɑ.te.gˌij.ji>i
mátkeeallinstrategiija+N+Pl+Acc+PxPl1	mátkeeallinstrategiijaideamet	mˈátː.hke#ˌeɑl.lin#strˌɑ.te.gˌij.jɑ>i.dĕɑ.meh
mátkeeallinstrategiija+N+Pl+Nom	mátkeeallinstrategiijat	mˈátː.hke#ˌeɑl.lin#strˌɑ.te.gˌij.jɑ>h
mátkeealáhusstrategiija+N+Der/heapmi+A+Comp+Sg+Ill	mátkeealáhusstrategiijahebbui	mˈátː.hke#ˌeɑ.lá.hus#strˌɑ.te.gˌij.jɑ»hˌeb.bu>i
mátkeealáhusstrategiija+N+Sg+Ill	mátkeealáhusstrategiijii	mˈátː.hke#ˌeɑ.lá.hus#strˌɑ.te.gˌij.ji>i
mátkestudio+N+Ess+PxDu3	mátkestudioneaskka	mˈátː.hke#stˌu.dio>neɑs.kɑ
mátkestudio+N+Sg+Ill+PxDu2	mátkestudiosatte	mˈátː.hke#stˌu.dio>sɑt.te
mátkestudio+N+Sg+Loc	mátkestudios	mˈátː.hke#stˌu.dio>s
naivista+N+Ess+PxDu3	naivistaneaskka	nˈɑ.i.vˌisː.tɑ>neɑs.kɑ
naivista+N+Sg+Gen+PxSg1	naivistan	nˈɑ.i.vˌisː.tɑ>n
naivista+N+Der/viđá+Adv	naivistaviđá	nˈɑ.i.vˌisː.tɑ»vˌi.ðá
naivista+N+Sg+Ill	naivistii	nˈɑ.i.vˌisː.ti>i
naivista+N+Sg+Com+PxSg2	naivisttainat	nˈɑ.i.vˌis.tɑ>i.nɑh
naivista+N+Sg+Loc	naivisttas	nˈɑ.i.vˌis.tɑ>s
naivista+N+Der/Dimin+N+Sg+Nom	naivisttaš	nˈɑ.i.vˌis.tɑ»ʃ
naivista+N+Der/heapmi+A+Sg+Loc	naivisttaheamis	nˈɑ.i.vˌis.tɑ»hˌeɑ.mi>s
naivista+N+Der/laš+A+Sg+Ill	naivisttalažžii	nˈɑ.i.vˌis.tɑ»lˌɑž.ži>i
narsissista+N+Sg+Ill	narsissistii	nˈɑrː.sisː.sˌisː.ti>i
narsissista+N+Sg+Com+PxPl2	narsissisttaineattet	nˈɑrː.sisː.sˌis.tɑ>i.nĕɑt.teh
nasjonalista+N+Der/viđá+Adv	nasjonalistaviđá	nˈɑs.jo.nˌɑ.lis.tɑ»vˌi.ðá
nasjonalista+N+Sg+Ill	nasjonalistii	nˈɑs.jo.nˌɑ.lis.ti>i
nasjonalista+N+Sg+Com+PxDu3	nasjonalisttaineaskka	nˈɑs.jo.nˌɑ.lis.tɑ>i.neɑs.kɑ
nasjonalista+N+Sg+Com+PxSg1	nasjonalisttainan	nˈɑs.jo.nˌɑ.lis.tɑ>i.nɑn
nasjonalista+N+Der/heapmi+A+Ess	nasjonalisttaheapmin	nˈɑs.jo.nˌɑ.lis.tɑ»hˌeɑp.mi>n
nasjonálasosialista+N+Sg+Acc+PxSg1	nasjonálasosialistan	nˈɑs.jo.nˌá.lɑ#sˌo.si.ˌɑ.lis.tɑ>n
nasjonálasosialista+N+Der/viđá+Adv	nasjonálasosialistaviđá	nˈɑs.jo.nˌá.lɑ#sˌo.si.ˌɑ.lis.tɑ»vˌi.ðá
nasjonálasosialista+N+Sg+Com+PxSg1	nasjonálasosialisttainan	nˈɑs.jo.nˌá.lɑ#sˌo.si.ˌɑ.lis.tɑ>i.nɑn
neorealista+N+Sg+Ill+PxSg3	neorealistasis	nˈe.o#rˌe.ɑ.lˌisː.tɑ>sis
neorealista+N+Sg+Nom+PxDu1	neorealistame	nˈe.o#rˌe.ɑ.lˌisː.tɑ>me
neorealista+N+Der/viđá+Adv	neorealistaviđá	nˈe.o#rˌe.ɑ.lˌisː.tɑ»vˌi.ðá
neorealista+N+Sg+Ill	neorealistii	nˈe.o#rˌe.ɑ.lˌisː.ti>i
neorealista+N+Pl+Com+PxSg1	neorealisttaidanguin	nˈe.o#rˌe.ɑ.lˌis.tɑ>i.dɑn.gujn
neorealista+N+Sg+Gen+PxDu3	neorealisttaska	nˈe.o#rˌe.ɑ.lˌis.tɑ>skɑ
neorealista+N+Sg+Loc+PxSg3	neorealisttastis	nˈe.o#rˌe.ɑ.lˌis.tɑ>stis
neorealista+N+Der/Dimin+N+Sg+Nom	neorealisttaš	nˈe.o#rˌe.ɑ.lˌis.tɑ»ʃ
neorealista+N+Der/Dimin+N+Ess	neorealisttažin	nˈe.o#rˌe.ɑ.lˌis.tɑ»žin
neorealista+N+Der/heapmi+A+Comp+Attr	neorealisttahit	nˈe.o#rˌe.ɑ.lˌis.tɑ»hit>
neorealista+N+Der/heapmi+A+Pl+Loc	neorealisttahemiin	nˈe.o#rˌe.ɑ.lˌis.tɑ»hˌe.mi>in
neorealista+N+Der/huvva+V+IV+Sup	neorealisttahuvažit	nˈe.o#rˌe.ɑ.lˌis.tɑ»hˌu.vɑ>žih
neorealista+N+Der/huvva+V+IV+VAbess	neorealisttahuvahaga	nˈe.o#rˌe.ɑ.lˌis.tɑ»hˌu.vɑ>hɑ.gɑ
neorealista+N+Der/huvva+V+IV+Imprt+Pl2	neorealisttahuvvit	nˈe.o#rˌe.ɑ.lˌis.tɑ»hˌuv.vi>h
neorealista+N+Der/laš+A+Comp+Sg+Loc	neorealisttaleappos	nˈe.o#rˌe.ɑ.lˌis.tɑ»lˌĕɑp.po>s
nordista+N+Ess+PxDu3	nordistaneaskka	nˈorː.dis.tɑ>neɑs.kɑ
nordista+N+Ess	nordistan	nˈorː.dis.tɑ>n
nordista+N+Der/viđá+Adv	nordistaviđá	nˈorː.dis.tɑ»vˌi.ðá
nordista+N+Sg+Ill	nordistii	nˈorː.dis.ti>i
nordista+N+Pl+Acc+PxPl1	nordisttaideamet	nˈorː.dis.tɑ>i.dĕɑ.meh
nordista+N+Pl+Com	nordisttaiguin	nˈorː.dis.tɑ>i.gujn
nordista+N+Pl+Nom+PxDu3	nordisttaideaskka	nˈorː.dis.tɑ>i.deɑs.kɑ
nordista+N+Pl+Nom	nordisttat	nˈorː.dis.tɑ>h
nordista+N+Sg+Acc+PxDu2	nordisttade	nˈorː.dis.tɑ>de
nordista+N+Sg+Acc+PxSg3	nordisttas	nˈorː.dis.tɑ>s
nordista+N+Sg+Gen	nordistta	nˈorː.dis.tɑ>
nordista+N+Sg+Com+PxDu3	nordisttaineaskka	nˈorː.dis.tɑ>i.neɑs.kɑ
nordista+N+Sg+Com+PxPl3	nordisttaineaset	nˈorː.dis.tɑ>i.nĕɑ.seh
nordista+N+Der/Dimin+N+Der/Dimin+N+Pl+Nom	nordisttažaččat	nˈorː.dis.tɑ»žˌɑč.čɑ>h
nordista+N+Der/heapmi+A+Superl+Ess	nordisttahamosin	nˈorː.dis.tɑ»hˌɑ.mos>in
nordista+N+Der/heapmi+A+Ess	nordisttaheapmin	nˈorː.dis.tɑ»hˌeɑp.mi>n
nordista+N+Der/heapmi+A+Sg+Ill	nordisttaheapmái	nˈorː.dis.tɑ»hˌeɑp.má>i
nordista+N+Der/heapmi+A+Pl+Com	nordisttahemiiguin	nˈorː.dis.tɑ»hˌe.mi>i.gujn
nordista+N+Der/laš+A+Der/vuohta+N+Sg+Acc	nordisttalašvuođa	nˈorː.dis.tɑ»lɑʃ»vˌuo.ðɑ>
nudista+N+Ess+PxDu3	nudistaneaskka	nˈuː.dis.tɑ>neɑs.kɑ
nudista+N+Ess+PxSg3	nudistanis	nˈuː.dis.tɑ>nis
nudista+N+Der/viđá+Adv	nudistaviđá	nˈuː.dis.tɑ»vˌi.ðá
nudista+N+Sg+Ill	nudistii	nˈuː.dis.ti>i
nudista+N+Pl+Nom	nudisttat	nˈuː.dis.tɑ>h
nudista+N+Sg+Com+PxSg1	nudisttainan	nˈuː.dis.tɑ>i.nɑn
nudista+N+Sg+Loc+PxPl3	nudisttasteaset	nˈuː.dis.tɑ>stĕɑ.seh
nudista+N+Der/Dimin+N+Der/viđá+Adv	nudisttašviđá	nˈuː.dis.tɑ»ʃ»vˌi.ðá
nudista+N+Der/Dimin+N+Ess	nudisttažin	nˈuː.dis.tɑ»žin
nudista+N+Der/heapmi+A+Attr+Der/vuohta+N+Sg+Loc	nudisttahisvuođas	nˈuː.dis.tɑ»his>»vˌuo.ðɑs
nudista+N+Der/huhtti+V+TV+VAbess	nudisttahuhtihaga	nˈuː.dis.tɑ»hˌuh.ti>hɑ.gɑ
nudista+N+Der/huvva+V+IV+VAbess	nudisttahuvakeahttájin	nˈuː.dis.tɑ»hˌu.vɑ>kĕɑhː.tá.jin
nudista+N+Der/laš+A+Der/vuohta+N+Sg+Ill	nudisttalašvuhtii	nˈuː.dis.tɑ»lɑʃ»vˌuh.ti>i
oahppanstrategiija+N+Sg+Nom	oahppanstrategiija	ˈŏɑhː.pɑn#strˌɑ.te.gˌij.jɑ>
oahppanstrategiija+N+Sg+Ill	oahppanstrategiijai	ˈŏɑhː.pɑn#strˌɑ.te.gˌij.jɑ>i
oahppanstrategiija+N+Sg+Ill+PxDu1	oahppanstrategiijaseame	ˈŏɑhː.pɑn#strˌɑ.te.gˌij.jɑ>sĕɑ.me
oahppanstrategiija+N+Sg+Loc	oahppanstrategiijas	ˈŏɑhː.pɑn#strˌɑ.te.gˌij.jɑ>s
oahppanstrategiija+N+Sg+Loc+PxPl2	oahppanstrategiijasteattet	ˈŏɑhː.pɑn#strˌɑ.te.gˌij.jɑ>stĕɑt.teh
oahppanstrategiija+N+Der/Dimin+N+Sg+Gen	oahppanstrategiijaža	ˈŏɑhː.pɑn#strˌɑ.te.gˌij.jɑ»žɑ
oahppanstrategiija+N+Der/huhtti+V+TV+VAbess	oahppanstrategiijahuhtehaga	ˈŏɑhː.pɑn#strˌɑ.te.gˌij.jɑ»hˌuh.te>hɑ.gɑ
oahppanstrategiija+N+Sg+Ill	oahppanstrategiijii	ˈŏɑhː.pɑn#strˌɑ.te.gˌij.ji>i
oahpponeavvostrategiija+N+Ess+PxDu1	oahpponeavvostrategiijaneame	ˈŏɑhː.po#nˌĕɑv.vo#strˌɑ.te.gˌij.jɑ>nĕɑ.me
oahpponeavvostrategiija+N+Pl+Gen+PxSg2	oahpponeavvostrategiijaidat	ˈŏɑhː.po#nˌĕɑv.vo#strˌɑ.te.gˌij.jɑ>i.dɑh
oahpponeavvostrategiija+N+Sg+Gen+PxDu1	oahpponeavvostrategiijame	ˈŏɑhː.po#nˌĕɑv.vo#strˌɑ.te.gˌij.jɑ>me
oahpponeavvostrategiija+N+Sg+Com+PxDu1	oahpponeavvostrategiijaineame	ˈŏɑhː.po#nˌĕɑv.vo#strˌɑ.te.gˌij.jɑ>i.nĕɑ.me
oahpponeavvostrategiija+N+Der/viđá+Adv	oahpponeavvostrategiijaviđá	ˈŏɑhː.po#nˌĕɑv.vo#strˌɑ.te.gˌij.jɑ>»vˌi.ðá
oahpponeavvostrategiija+N+Der/huhtti+V+TV+Ger+PxSg2	oahpponeavvostrategiijahuhtidettiinat	ˈŏɑhː.po#nˌĕɑv.vo#strˌɑ.te.gˌij.jɑ»hˌuh.ti>det.tij.nɑh
oahpponeavvostrategiija+N+Der/huvva+V+IV+Ind+Prs+Sg3	oahpponeavvostrategiijahuvvá	ˈŏɑhː.po#nˌĕɑv.vo#strˌɑ.te.gˌij.jɑ»hˌuvː.vá>
oahpponeavvostrategiija+N+Der/laš+A+AttrCmp+Der/áissat+A+Attr	oahpponeavvostrategiijalašáissat	ˈŏɑhː.po#nˌĕɑv.vo#strˌɑ.te.gˌij.jɑ»lɑʃ>»ˌájs.sɑh
oahpponeavvostrategiija+N+Sg+Ill	oahpponeavvostrategiijii	ˈŏɑhː.po#nˌĕɑv.vo#strˌɑ.te.gˌij.ji>i
oassestrategiija+N+Ess+PxPl3	oassestrategiijaneaset	ˈŏɑs.se#strˌɑ.te.gˌij.jɑ>nĕɑ.seh
oassestrategiija+N+Pl+Com+PxPl3	oassestrategiijaideasetguin	ˈŏɑs.se#strˌɑ.te.gˌij.jɑ>i.dĕɑ.set.gujn
oassestrategiija+N+Pl+Nom	oassestrategiijat	ˈŏɑs.se#strˌɑ.te.gˌij.jɑ>h
oassestrategiija+N+Sg+Acc+PxDu2	oassestrategiijade	ˈŏɑs.se#strˌɑ.te.gˌij.jɑ>de
oassestrategiija+N+Sg+Gen+PxSg1	oassestrategiijan	ˈŏɑs.se#strˌɑ.te.gˌij.jɑ>n
oassestrategiija+N+Sg+Nom+PxPl2	oassestrategiijadet	ˈŏɑs.se#strˌɑ.te.gˌij.jɑ>deh
oassestrategiija+N+Sg+Loc	oassestrategiijas	ˈŏɑs.se#strˌɑ.te.gˌij.jɑ>s
oassestrategiija+N+Sg+Loc+PxDu1	oassestrategiijasteame	ˈŏɑs.se#strˌɑ.te.gˌij.jɑ>stĕɑ.me
oassestrategiija+N+Der/viđá+Adv	oassestrategiijaviđá	ˈŏɑs.se#strˌɑ.te.gˌij.jɑ>»vˌi.ðá
oassestrategiija+N+Der/Dimin+N+Der/viđá+Adv	oassestrategiijašviđá	ˈŏɑs.se#strˌɑ.te.gˌij.jɑ»ʃ»vˌi.ðá
oassestrategiija+N+Der/heapmi+A+Comp+Pl+Nom	oassestrategiijahabbot	ˈŏɑs.se#strˌɑ.te.gˌij.jɑ»hˌɑb.bo>h
oassestrategiija+N+Der/heapmi+A+Superl+Pl+Com	oassestrategiijahamosiiguin	ˈŏɑs.se#strˌɑ.te.gˌij.jɑ»hˌɑ.mos>ij.gujn
oassestrategiija+N+Der/heapmi+A+Sg+Acc	oassestrategiijaheame	ˈŏɑs.se#strˌɑ.te.gˌij.jɑ»hˌĕɑ.me>
oassestrategiija+N+Der/heapmi+A+Attr+Der/vuohta+N+Sg+Ill	oassestrategiijahisvuhtii	ˈŏɑs.se#strˌɑ.te.gˌij.jɑ»his>»vˌuh.tij
oassestrategiija+N+Der/huhtti+V+TV+Ger	oassestrategiijahuhtidin	ˈŏɑs.se#strˌɑ.te.gˌij.jɑ»hˌuh.ti>din
oassestrategiija+N+Der/huhtti+V+TV+Inf	oassestrategiijahuhttit	ˈŏɑs.se#strˌɑ.te.gˌij.jɑ»hˌuhː.ti>h
oassestrategiija+N+Der/huvva+V+IV+Ger	oassestrategiijahuvadiin	ˈŏɑs.se#strˌɑ.te.gˌij.jɑ»hˌu.vɑ>dijn
oassestrategiija+N+Der/huvva+V+IV+Ind+Prs+Sg2	oassestrategiijahuvat	ˈŏɑs.se#strˌɑ.te.gˌij.jɑ»hˌu.vɑ>h
oassestrategiija+N+Der/laš+A+Sg+Nom	oassestrategiijalaš	ˈŏɑs.se#strˌɑ.te.gˌij.jɑ»lɑʃ>
oassestrategiija+N+Der/laš+A+Der/vuohta+N+Sg+Ill	oassestrategiijalašvuhtii	ˈŏɑs.se#strˌɑ.te.gˌij.jɑ»lɑʃ»vˌuh.ti>i
oassestrategiija+N+Sg+Ill	oassestrategiijii	ˈŏɑs.se#strˌɑ.te.gˌij.ji>i
ovddidanstrategiija+N+Ess+PxPl1	ovddidanstrategiijaneamet	ˈoβt.ti.ðɑn#strˌɑ.te.gˌij.jɑ>nĕɑ.meh
ovddidanstrategiija+N+Ess	ovddidanstrategiijan	ˈoβt.ti.ðɑn#strˌɑ.te.gˌij.jɑ>n
ovddidanstrategiija+N+Pl+Nom+PxPl2	ovddidanstrategiijaideattet	ˈoβt.ti.ðɑn#strˌɑ.te.gˌij.jɑ>i.dĕɑt.teh
ovddidanstrategiija+N+Pl+Nom	ovddidanstrategiijat	ˈoβt.ti.ðɑn#strˌɑ.te.gˌij.jɑ>h
ovddidanstrategiija+N+Sg+Nom+PxDu3	ovddidanstrategiijaska	ˈoβt.ti.ðɑn#strˌɑ.te.gˌij.jɑ>skɑ
ovddidanstrategiija+N+Sg+Ill+PxDu2	ovddidanstrategiijaseatte	ˈoβt.ti.ðɑn#strˌɑ.te.gˌij.jɑ>sĕɑt.te
ovddidanstrategiija+N+Der/viđá+Adv	ovddidanstrategiijaviđá	ˈoβt.ti.ðɑn#strˌɑ.te.gˌij.jɑ>»vˌi.ðá
ovddidanstrategiija+N+Der/Dimin+N+Sg+Nom	ovddidanstrategiijaš	ˈoβt.ti.ðɑn#strˌɑ.te.gˌij.jɑ»ʃ
ovddidanstrategiija+N+Der/Dimin+N+Der/viđá+Adv	ovddidanstrategiijašviđá	ˈoβt.ti.ðɑn#strˌɑ.te.gˌij.jɑ»ʃ»vˌi.ðá
ovddidanstrategiija+N+Der/Dimin+N+Sg+Acc+PxSg2	ovddidanstrategiijažat	ˈoβt.ti.ðɑn#strˌɑ.te.gˌij.jɑ»žɑh
ovddidanstrategiija+N+Der/heapmi+A+Superl+Ess	ovddidanstrategiijaheamosin	ˈoβt.ti.ðɑn#strˌɑ.te.gˌij.jɑ»hˌĕɑ.mos>in
ovddidanstrategiija+N+Der/heapmi+A+Superl+Sg+Ill	ovddidanstrategiijahepmosii	ˈoβt.ti.ðɑn#strˌɑ.te.gˌij.jɑ»hˌep.mos>ij
ovddidanstrategiija+N+Der/heapmi+A+Attr+Der/vuohta+N+Sg+Ill	ovddidanstrategiijahisvuhtii	ˈoβt.ti.ðɑn#strˌɑ.te.gˌij.jɑ»his>»vˌuh.tij
ovddidanstrategiija+N+Der/huhtti+V+TV+Cond+Prs+Du3	ovddidanstrategiijahuhtášeigga	ˈoβt.ti.ðɑn#strˌɑ.te.gˌij.jɑ»hˌuhː.tá>ʃejg.gɑ
ovddidanstrategiija+N+Der/huvva+V+IV+Ind+Prs+Pl1	ovddidanstrategiijahuvvat	ˈoβt.ti.ðɑn#strˌɑ.te.gˌij.jɑ»hˌuv.vɑ>h
ovddidanstrategiija+N+Der/laš+A+Comp+Attr	ovddidanstrategiijalut	ˈoβt.ti.ðɑn#strˌɑ.te.gˌij.jɑ»lut>
ovddidanstrategiija+N+Der/laš+A+Ess	ovddidanstrategiijalažžan	ˈoβt.ti.ðɑn#strˌɑ.te.gˌij.jɑ»lˌɑž.žɑ>n
ovddidanstrategiija+N+Der/laš+A+Superl+Sg+Ill	ovddidanstrategiijalepmosii	ˈoβt.ti.ðɑn#strˌɑ.te.gˌij.jɑ»lˌep.mos>ij
ovddidanstrategiija+N+Der/laš+A+AttrCmp+Der/lunddot+A+Ess	ovddidanstrategiijalašlunddogin	ˈoβt.ti.ðɑn#strˌɑ.te.gˌij.jɑ»lɑʃ>»lˌund.do.gin
ovddidanstrategiija+N+Der/laš+A+Sg+Nom	ovddidanstrategiijalaš	ˈoβt.ti.ðɑn#strˌɑ.te.gˌij.jɑ»lɑʃ>
ovddidanstrategiija+N+Sg+Ill	ovddidanstrategiijii	ˈoβt.ti.ðɑn#strˌɑ.te.gˌij.ji>i
ovdánahttinstrategiija+N+Pl+Com+PxDu1	ovdánahttinstrategiijaideameguin	ˈovː.dá.nˌɑhː.tin#strˌɑ.te.gˌij.jɑ>i.dĕɑ.me.gujn
ovdánahttinstrategiija+N+Pl+Com	ovdánahttinstrategiijaiguin	ˈovː.dá.nˌɑhː.tin#strˌɑ.te.gˌij.jɑ>i.gujn
ovdánahttinstrategiija+N+Pl+Nom	ovdánahttinstrategiijat	ˈovː.dá.nˌɑhː.tin#strˌɑ.te.gˌij.jɑ>h
ovdánahttinstrategiija+N+Sg+Acc	ovdánahttinstrategiija	ˈovː.dá.nˌɑhː.tin#strˌɑ.te.gˌij.jɑ>
ovdánahttinstrategiija+N+Sg+Loc+PxSg3	ovdánahttinstrategiijastis	ˈovː.dá.nˌɑhː.tin#strˌɑ.te.gˌij.jɑ>stis
ovdánahttinstrategiija+N+Der/viđá+Adv	ovdánahttinstrategiijaviđá	ˈovː.dá.nˌɑhː.tin#strˌɑ.te.gˌij.jɑ>»vˌi.ðá
ovdánahttinstrategiija+N+Der/Dimin+N+Der/viđá+Adv	ovdánahttinstrategiijašviđá	ˈovː.dá.nˌɑhː.tin#strˌɑ.te.gˌij.jɑ»ʃ»vˌi.ðá
ovdánahttinstrategiija+N+Der/heapmi+A+Sg+Com	ovdánahttinstrategiijahemiin	ˈovː.dá.nˌɑhː.tin#strˌɑ.te.gˌij.jɑ»hˌe.mi>in
ovdánahttinstrategiija+N+Der/laš+A+Der/vuohta+N+Sg+Ill	ovdánahttinstrategiijalašvuhtii	ˈovː.dá.nˌɑhː.tin#strˌɑ.te.gˌij.jɑ»lɑʃ»vˌuh.ti>i
ovdánahttinstrategiija+N+Sg+Ill	ovdánahttinstrategiijii	ˈovː.dá.nˌɑhː.tin#strˌɑ.te.gˌij.ji>i
ovdánanstrategiija+N+Pl+Gen+PxSg3	ovdánanstrategiijaidis	ˈovː.dá.nɑn#strˌɑ.te.gˌij.jɑ>i.dis
ovdánanstrategiija+N+Sg+Ill	ovdánanstrategiijai	ˈovː.dá.nɑn#strˌɑ.te.gˌij.jɑ>i
ovdánanstrategiija+N+Der/Dimin+N+Ess	ovdánanstrategiijažin	ˈovː.dá.nɑn#strˌɑ.te.gˌij.jɑ»žin
ovdánanstrategiija+N+Der/heapmi+A+Attr+Der/vuohta+N+Ess+PxSg2	ovdánanstrategiijahisvuohtanat	ˈovː.dá.nɑn#strˌɑ.te.gˌij.jɑ»his>»vˌuoh.tɑ.nɑh
ovdánanstrategiija+N+Der/huvva+V+IV+Imprt+Pl2	ovdánanstrategiijahuvvit	ˈovː.dá.nɑn#strˌɑ.te.gˌij.jɑ»hˌuv.vi>h
ovdánanstrategiija+N+Der/laš+A+Superl+Sg+Ill	ovdánanstrategiijalepmosii	ˈovː.dá.nɑn#strˌɑ.te.gˌij.jɑ»lˌep.mos>ij
ovdánanstrategiija+N+Sg+Ill	ovdánanstrategiijii	ˈovː.dá.nɑn#strˌɑ.te.gˌij.ji>i
parlamentarista+N+Ess+PxPl1	parlamentaristaneamet	phˈɑr.lɑː.mˌenː.tɑ.rˌis.tɑ>nĕɑ.meh
parlamentarista+N+Ess+PxSg2	parlamentaristanat	phˈɑr.lɑː.mˌenː.tɑ.rˌis.tɑ>nɑh
parlamentarista+N+Sg+Acc+PxSg1	parlamentaristan	phˈɑr.lɑː.mˌenː.tɑ.rˌis.tɑ>n
parlamentarista+N+Der/viđá+Adv	parlamentaristaviđá	phˈɑr.lɑː.mˌenː.tɑ.rˌis.tɑ»vˌi.ðá
parlamentarista+N+Sg+Ill	parlamentaristii	phˈɑr.lɑː.mˌenː.tɑ.rˌis.ti>i
parlamentarista+N+Sg+Acc+PxSg2	parlamentaristtat	phˈɑr.lɑː.mˌenː.tɑ.rˌis.tɑ>h
parlamentarista+N+Sg+Com+PxSg1	parlamentaristtainan	phˈɑr.lɑː.mˌenː.tɑ.rˌis.tɑ>i.nɑn
parlamentarista+N+Sg+Com+PxSg2	parlamentaristtainat	phˈɑr.lɑː.mˌenː.tɑ.rˌis.tɑ>i.nɑh
parlamentarista+N+Sg+Loc+PxSg2	parlamentaristtastat	phˈɑr.lɑː.mˌenː.tɑ.rˌis.tɑ>stɑh
parlamentarista+N+Der/heapmi+A+Ess	parlamentaristtaheapmin	phˈɑr.lɑː.mˌenː.tɑ.rˌis.tɑ»hˌeɑp.mi>n
parlamentarista+N+Der/heapmi+A+Pl+Acc	parlamentaristtahemiid	phˈɑr.lɑː.mˌenː.tɑ.rˌis.tɑ»hˌe.mi>id
parlamentarista+N+Der/heapmi+A+Attr+Der/vuohta+N+Pl+Nom	parlamentaristtahisvuođat	phˈɑr.lɑː.mˌenː.tɑ.rˌis.tɑ»his>»vˌuo.ðɑh
parlamentarista+N+Der/huvva+V+IV+Ind+Prt+Sg3	parlamentaristtahuvai	phˈɑr.lɑː.mˌenː.tɑ.rˌis.tɑ»hˌu.vɑ>i
parlamentarista+N+Der/laš+A+Superl+Sg+Nom	parlamentaristtaleamos	phˈɑr.lɑː.mˌenː.tɑ.rˌis.tɑ»lˌĕɑ.mos>
parlamentarista+N+Der/laš+A+AttrCmp+Der/sánat+A+Pl+Nom	parlamentaristtalašsánagat	phˈɑr.lɑː.mˌenː.tɑ.rˌis.tɑ»lɑʃ>»sˌá.nɑ.gɑh
pasifista+N+Sg+Gen+PxDu1	pasifistame	phˈɑ.si.fˌisː.tɑ>me
pasifista+N+Sg+Ill+PxPl2	pasifistaseattet	phˈɑ.si.fˌisː.tɑ>sĕɑt.teh
pasifista+N+Der/viđá+Adv	pasifistaviđá	phˈɑ.si.fˌisː.tɑ»vˌi.ðá
pasifista+N+Sg+Ill	pasifistii	phˈɑ.si.fˌisː.ti>i
pasifista+N+Pl+Acc+PxPl1	pasifisttaideamet	phˈɑ.si.fˌis.tɑ>i.dĕɑ.meh
pasifista+N+Pl+Acc	pasifisttaid	phˈɑ.si.fˌis.tɑ>id
pasifista+N+Pl+Nom	pasifisttat	phˈɑ.si.fˌis.tɑ>h
pasifista+N+Sg+Acc+PxDu2	pasifisttade	phˈɑ.si.fˌis.tɑ>de
pasifista+N+Sg+Loc+PxSg3	pasifisttastis	phˈɑ.si.fˌis.tɑ>stis
pasifista+N+Der/Dimin+N+Sg+Nom	pasifisttaš	phˈɑ.si.fˌis.tɑ»ʃ
pasifista+N+Der/heapmi+A+Superl+Pl+Acc	pasifisttahepmosiid	phˈɑ.si.fˌis.tɑ»hˌep.mos>ijh
pasifista+N+Der/huhtti+V+TV+Ind+Prt+Pl1	pasifisttahuhtiimet	phˈɑ.si.fˌis.tɑ»hˌuh.ti>i.meh
pasifista+N+Der/huhtti+V+TV+Der/PassS+V+IV+Ind+Prt+Sg3	pasifisttahuhttui	phˈɑ.si.fˌis.tɑ»hˌuhː.tu>»i
pasifista+N+Der/huvva+V+IV+Ind+Prs+Du3	pasifisttahuvvaba	phˈɑ.si.fˌis.tɑ»hˌuv.vɑ>bɑ
pasifista+N+Der/huvva+V+IV+Imprt+Pl2	pasifisttahuvvet	phˈɑ.si.fˌis.tɑ»hˌuv.ve>h
pasifista+N+Der/laš+A+Der/vuohta+N+Sg+Ill	pasifisttalašvuhtii	phˈɑ.si.fˌis.tɑ»lɑʃ»vˌuh.ti>i
perfeksjonista+N+Ess+PxPl2	perfeksjonistaneattet	phˈerː.fek.sjˌo.nis.tɑ>nĕɑt.teh
perfeksjonista+N+Sg+Nom+PxSg1	perfeksjonistan	phˈerː.fek.sjˌo.nis.tɑ>n
perfeksjonista+N+Der/viđá+Adv	perfeksjonistaviđá	phˈerː.fek.sjˌo.nis.tɑ»vˌi.ðá
perfeksjonista+N+Sg+Ill	perfeksjonistii	phˈerː.fek.sjˌo.nis.ti>i
perfeksjonista+N+Pl+Nom	perfeksjonisttat	phˈerː.fek.sjˌo.nis.tɑ>h
perfeksjonista+N+Sg+Acc+PxPl2	perfeksjonisttadet	phˈerː.fek.sjˌo.nis.tɑ>deh
perfeksjonista+N+Sg+Gen+PxSg3	perfeksjonisttas	phˈerː.fek.sjˌo.nis.tɑ>s
perfeksjonista+N+Sg+Com+PxPl1	perfeksjonisttaineamet	phˈerː.fek.sjˌo.nis.tɑ>i.nĕɑ.meh
perfeksjonista+N+Sg+Loc	perfeksjonisttas	phˈerː.fek.sjˌo.nis.tɑ>s
perfeksjonista+N+Der/Dimin+N+Sg+Nom	perfeksjonisttaš	phˈerː.fek.sjˌo.nis.tɑ»ʃ
perfeksjonista+N+Der/Dimin+N+Der/viđá+Adv	perfeksjonisttašviđá	phˈerː.fek.sjˌo.nis.tɑ»ʃ»vˌi.ðá
perfeksjonista+N+Der/Dimin+N+Pl+Nom	perfeksjonisttažat	phˈerː.fek.sjˌo.nis.tɑ»žɑh
perfeksjonista+N+Der/Dimin+N+Sg+Loc	perfeksjonisttažis	phˈerː.fek.sjˌo.nis.tɑ»žis
perfeksjonista+N+Der/heapmi+A+Comp+Sg+Nom	perfeksjonisttahit	phˈerː.fek.sjˌo.nis.tɑ»hit>
perfeksjonista+N+Der/heapmi+A+Attr	perfeksjonisttahis	phˈerː.fek.sjˌo.nis.tɑ»his>
perfeksjonista+N+Der/huvva+V+IV+Imprt+ConNeg	perfeksjonisttahuva	phˈerː.fek.sjˌo.nis.tɑ»hˌu.vɑ>
perfeksjonista+N+Der/huvva+V+IV+Ind+Prs+Sg3	perfeksjonisttahuvvá	phˈerː.fek.sjˌo.nis.tɑ»hˌuvː.vá>
perfeksjonista+N+Der/laš+A+Comp+Pl+Gen	perfeksjonisttalabbuid	phˈerː.fek.sjˌo.nis.tɑ»lˌɑb.bu>id
perfeksjonista+N+Der/laš+A+Comp+Pl+Ill	perfeksjonisttalabbuide	phˈerː.fek.sjˌo.nis.tɑ»lˌɑb.bu>i.de
perfeksjonista+N+Der/laš+A+Comp+Attr	perfeksjonisttalat	phˈerː.fek.sjˌo.nis.tɑ»lɑt>
perfeksjonista+N+Der/laš+A+AttrCmp+Der/soajat+A+Der/vuohta+N+Sg+Ill	perfeksjonisttalašsoajatvuhtii	phˈerː.fek.sjˌo.nis.tɑ»lɑʃ>»sˌoɑ.jɑh»vˌuh.tij
pietista+N+Ess+PxDu3	pietistaneaskka	phˈi.e.tˌisː.tɑ>neɑs.kɑ
pietista+N+Ess+PxPl1	pietistaneamet	phˈi.e.tˌisː.tɑ>nĕɑ.meh
pietista+N+Ess+PxPl3	pietistaneaset	phˈi.e.tˌisː.tɑ>nĕɑ.seh
pietista+N+Ess+PxSg1	pietistanan	phˈi.e.tˌisː.tɑ>nɑn
pietista+N+Sg+Nom	pietista	phˈi.e.tˌisː.tɑ>
pietista+N+Der/viđá+Adv	pietistaviđá	phˈi.e.tˌisː.tɑ»vˌi.ðá
pietista+N+Sg+Ill	pietistii	phˈi.e.tˌisː.ti>i
pietista+N+Pl+Com+PxDu1	pietisttaideameguin	phˈi.e.tˌis.tɑ>i.dĕɑ.me.gujn
pietista+N+Pl+Nom+PxSg2	pietisttaidat	phˈi.e.tˌis.tɑ>i.dɑh
pietista+N+Pl+Nom	pietisttat	phˈi.e.tˌis.tɑ>h
pietista+N+Sg+Acc+PxSg3	pietisttas	phˈi.e.tˌis.tɑ>s
pietista+N+Sg+Com+PxSg1	pietisttainan	phˈi.e.tˌis.tɑ>i.nɑn
pietista+N+Sg+Com+PxSg2	pietisttainat	phˈi.e.tˌis.tɑ>i.nɑh
pietista+N+Sg+Loc	pietisttas	phˈi.e.tˌis.tɑ>s
pietista+N+Sg+Loc+PxSg2	pietisttastat	phˈi.e.tˌis.tɑ>stɑh
pietista+N+Der/Dimin+N+Der/Dimin+N+Sg+Nom	pietisttažaš	phˈi.e.tˌis.tɑ»žɑʃ>
pietista+N+Der/Dimin+N+Der/Dimin+N+Sg+Gen+PxPl1	pietisttažažžamet	phˈi.e.tˌis.tɑ»žˌɑž.žɑ>meh
pietista+N+Der/Dimin+N+Pl+Ill+PxSg3	pietisttažiiddásis	phˈi.e.tˌis.tɑ»žˌijd.dás>is
pietista+N+Der/heapmi+A+Comp+Pl+Com	pietisttahabbuiguin	phˈi.e.tˌis.tɑ»hˌɑb.bu>i.gujn
pietista+N+Der/heapmi+A+Attr	pietisttahis	phˈi.e.tˌis.tɑ»his>
pietista+N+Der/huhtti+V+TV+Ind+Prt+Du2	pietisttahuhtiide	phˈi.e.tˌis.tɑ»hˌuh.ti>i.de
pietista+N+Der/huhtti+V+TV+Imprt+Du1	pietisttahuhttu	phˈi.e.tˌis.tɑ»hˌuhː.tu>
pietista+N+Der/laš+A+Comp+Sg+Nom	pietisttalat	phˈi.e.tˌis.tɑ»lɑt>
platonista+N+Der/viđá+Adv	platonistaviđá	plˈɑ.to.nˌisː.tɑ»vˌi.ðá
platonista+N+Sg+Ill	platonistii	plˈɑ.to.nˌisː.ti>i
platonista+N+Pl+Acc+PxSg3	platonisttaidis	plˈɑ.to.nˌis.tɑ>i.dis
platonista+N+Sg+Acc+PxDu2	platonisttade	plˈɑ.to.nˌis.tɑ>de
platonista+N+Sg+Com+PxDu3	platonisttaineaskka	plˈɑ.to.nˌis.tɑ>i.neɑs.kɑ
platonista+N+Der/Dimin+N+Der/viđá+Adv	platonisttašviđá	plˈɑ.to.nˌis.tɑ»ʃ»vˌi.ðá
platonista+N+Der/heapmi+A+Ess	platonisttaheapmin	plˈɑ.to.nˌis.tɑ»hˌeɑp.mi>n
platonista+N+Der/heapmi+A+Sg+Ill	platonisttaheapmái	plˈɑ.to.nˌis.tɑ»hˌeɑp.má>i
platonista+N+Der/huvva+V+IV+VGen	platonisttahuva	plˈɑ.to.nˌis.tɑ»hˌu.vɑ>
platonista+N+Der/laš+A+Superl+Ess	platonisttalamosin	plˈɑ.to.nˌis.tɑ»lˌɑ.mos>in
platonista+N+Der/laš+A+Attr	platonisttalaš	plˈɑ.to.nˌis.tɑ»lɑʃ>
platonista+N+Der/laš+A+Der/vuohta+N+Sg+Ill	platonisttalašvuhtii	plˈɑ.to.nˌis.tɑ»lɑʃ»vˌuh.ti>i
plánastrategiija+N+Sg+Com+PxDu3	plánastrategiijaineaskka	plˈá.nɑ#strˌɑ.te.gˌij.jɑ>i.neɑs.kɑ
plánastrategiija+N+Sg+Ill+PxPl2	plánastrategiijaseattet	plˈá.nɑ#strˌɑ.te.gˌij.jɑ>sĕɑt.teh
plánastrategiija+N+Der/Dimin+N+Sg+Gen+PxSg1	plánastrategiijažan	plˈá.nɑ#strˌɑ.te.gˌij.jɑ»žɑn
plánastrategiija+N+Der/heapmi+A+Attr	plánastrategiijahis	plˈá.nɑ#strˌɑ.te.gˌij.jɑ»his>
plánastrategiija+N+Der/huhtti+V+TV+Der/muš+N+Der/viđá+Adv	plánastrategiijahuhttámoššviđá	plˈá.nɑ#strˌɑ.te.gˌij.jɑ»hˌuhː.tá>»moʃː»vˌi.ðá
plánastrategiija+N+Der/huhtti+V+TV+Cond+Prs+Du2	plánastrategiijahuhtáleidde	plˈá.nɑ#strˌɑ.te.gˌij.jɑ»hˌuhː.tá>lejd.de
plánastrategiija+N+Der/huvva+V+IV+Imprt+Pl1	plánastrategiijahuvvut	plˈá.nɑ#strˌɑ.te.gˌij.jɑ»hˌuv.vu>h
plánastrategiija+N+Sg+Ill	plánastrategiijii	plˈá.nɑ#strˌɑ.te.gˌij.ji>i
rasjonalista+N+Ess+PxDu1	rasjonalistaneame	rˈɑs.jo.nˌɑ.lis.tɑ>nĕɑ.me
rasjonalista+N+Ess+PxPl3	rasjonalistaneaset	rˈɑs.jo.nˌɑ.lis.tɑ>nĕɑ.seh
rasjonalista+N+Ess+PxSg3	rasjonalistanis	rˈɑs.jo.nˌɑ.lis.tɑ>nis
rasjonalista+N+Sg+Acc+PxDu1	rasjonalistame	rˈɑs.jo.nˌɑ.lis.tɑ>me
rasjonalista+N+Sg+Ill+PxDu1	rasjonalistaseame	rˈɑs.jo.nˌɑ.lis.tɑ>sĕɑ.me
rasjonalista+N+Sg+Ill+PxPl1	rasjonalistaseamet	rˈɑs.jo.nˌɑ.lis.tɑ>sĕɑ.meh
rasjonalista+N+Der/viđá+Adv	rasjonalistaviđá	rˈɑs.jo.nˌɑ.lis.tɑ»vˌi.ðá
rasjonalista+N+Sg+Ill	rasjonalistii	rˈɑs.jo.nˌɑ.lis.ti>i
rasjonalista+N+Pl+Acc+PxDu3	rasjonalisttaideaskka	rˈɑs.jo.nˌɑ.lis.tɑ>i.deɑs.kɑ
rasjonalista+N+Pl+Com+PxPl1	rasjonalisttaideametguin	rˈɑs.jo.nˌɑ.lis.tɑ>i.dĕɑ.met.gujn
rasjonalista+N+Pl+Nom+PxDu3	rasjonalisttaideaskka	rˈɑs.jo.nˌɑ.lis.tɑ>i.deɑs.kɑ
rasjonalista+N+Pl+Nom	rasjonalisttat	rˈɑs.jo.nˌɑ.lis.tɑ>h
rasjonalista+N+Sg+Acc+PxSg3	rasjonalisttas	rˈɑs.jo.nˌɑ.lis.tɑ>s
rasjonalista+N+Sg+Gen+PxPl2	rasjonalisttadet	rˈɑs.jo.nˌɑ.lis.tɑ>deh
rasjonalista+N+Sg+Com+PxDu3	rasjonalisttaineaskka	rˈɑs.jo.nˌɑ.lis.tɑ>i.neɑs.kɑ
rasjonalista+N+Sg+Com+PxPl1	rasjonalisttaineamet	rˈɑs.jo.nˌɑ.lis.tɑ>i.nĕɑ.meh
rasjonalista+N+Sg+Com	rasjonalisttain	rˈɑs.jo.nˌɑ.lis.tɑ>in
rasjonalista+N+Sg+Loc+PxPl2	rasjonalisttasteattet	rˈɑs.jo.nˌɑ.lis.tɑ>stĕɑt.teh
rasjonalista+N+Sg+Loc+PxSg1	rasjonalisttastan	rˈɑs.jo.nˌɑ.lis.tɑ>stɑn
rasjonalista+N+Der/Dimin+N+Sg+Nom	rasjonalisttaš	rˈɑs.jo.nˌɑ.lis.tɑ»ʃ
rasjonalista+N+Der/Dimin+N+Der/viđá+Adv	rasjonalisttašviđá	rˈɑs.jo.nˌɑ.lis.tɑ»ʃ»vˌi.ðá
rasjonalista+N+Der/Dimin+N+Ess	rasjonalisttažin	rˈɑs.jo.nˌɑ.lis.tɑ»žin
rasjonalista+N+Der/Dimin+N+Sg+Acc	rasjonalisttaža	rˈɑs.jo.nˌɑ.lis.tɑ»žɑ
rasjonalista+N+Der/heapmi+A+Comp+Sg+Nom	rasjonalisttahit	rˈɑs.jo.nˌɑ.lis.tɑ»hit>
rasjonalista+N+Der/heapmi+A+Comp+Attr	rasjonalisttahut	rˈɑs.jo.nˌɑ.lis.tɑ»hut>
rasjonalista+N+Der/heapmi+A+Sg+Com	rasjonalisttahemiin	rˈɑs.jo.nˌɑ.lis.tɑ»hˌe.mi>in
rasjonalista+N+Der/huhtti+V+TV+VGen	rasjonalisttahuhti	rˈɑs.jo.nˌɑ.lis.tɑ»hˌuh.ti>
rasjonalista+N+Der/huvva+V+IV+Imprt+Pl2	rasjonalisttahuvvit	rˈɑs.jo.nˌɑ.lis.tɑ»hˌuv.vi>h
rasjonalista+N+Der/laš+A+Comp+Sg+Nom	rasjonalisttalit	rˈɑs.jo.nˌɑ.lis.tɑ»lit>
rasjonalista+N+Der/laš+A+Comp+Sg+Nom	rasjonalisttalut	rˈɑs.jo.nˌɑ.lis.tɑ»lut>
rasjonalista+N+Der/laš+A+Sg+Nom	rasjonalisttalaš	rˈɑs.jo.nˌɑ.lis.tɑ»lɑʃ>
rasjonalista+N+Der/laš+A+Der/vuohta+N+Der/viđá+Adv	rasjonalisttalašvuohtaviđá	rˈɑs.jo.nˌɑ.lis.tɑ»lɑʃ»vˌuoh.tɑ»vˌi.ðá
rasjonalista+N+Der/laš+A+Der/vuohta+N+Pl+Acc+PxDu3	rasjonalisttalašvuođaideaskka	rˈɑs.jo.nˌɑ.lis.tɑ»lɑʃ»vˌuo.ðɑ>i.deɑs.kɑ
redigerenstudio+N+Ess+PxSg1	redigerenstudionan	rˈe.di.gˌe.ren#stˌu.dio>nɑn
redigerenstudio+N+Pl+Acc+PxPl3	redigerenstudioideaset	rˈe.di.gˌe.ren#stˌu.dio>i.dĕɑ.seh
redigerenstudio+N+Pl+Com+PxDu2	redigerenstudioideatteguin	rˈe.di.gˌe.ren#stˌu.dio>i.dĕɑt.te.gujn
redigerenstudio+N+Pl+Com+PxDu3	redigerenstudioideaskkaguin	rˈe.di.gˌe.ren#stˌu.dio>i.deɑs.kɑ.gujn
redigerenstudio+N+Pl+Nom+PxSg1	redigerenstudioidan	rˈe.di.gˌe.ren#stˌu.dio>i.dɑn
redigerenstudio+N+Pl+Nom	redigerenstudiot	rˈe.di.gˌe.ren#stˌu.dio>h
redigerenstudio+N+Sg+Acc	redigerenstudio	rˈe.di.gˌe.ren#stˌu.dio>
redigerenstudio+N+Sg+Gen+PxDu1	redigerenstudiome	rˈe.di.gˌe.ren#stˌu.dio>me
redigerenstudio+N+Sg+Gen+PxPl1	redigerenstudiomet	rˈe.di.gˌe.ren#stˌu.dio>meh
redigerenstudio+N+Sg+Gen+PxSg1	redigerenstudion	rˈe.di.gˌe.ren#stˌu.dio>n
redigerenstudio+N+Sg+Gen+PxSg2	redigerenstudiot	rˈe.di.gˌe.ren#stˌu.dio>h
redigerenstudio+N+Sg+Nom+PxPl1	redigerenstudiomet	rˈe.di.gˌe.ren#stˌu.dio>meh
redigerenstudio+N+Sg+Nom+PxPl3	redigerenstudioset	rˈe.di.gˌe.ren#stˌu.dio>seh
redigerenstudio+N+Sg+Com+PxPl2	redigerenstudioineattet	rˈe.di.gˌe.ren#stˌu.dio>i.nĕɑt.teh
redigerenstudio+N+Sg+Com+PxPl3	redigerenstudioineaset	rˈe.di.gˌe.ren#stˌu.dio>i.nĕɑ.seh
redigerenstudio+N+Sg+Com+PxSg3	redigerenstudioinis	rˈe.di.gˌe.ren#stˌu.dio>i.nis
redigerenstudio+N+Sg+Ill	redigerenstudioi	rˈe.di.gˌe.ren#stˌu.dio>i
redigerenstudio+N+Sg+Loc	redigerenstudios	rˈe.di.gˌe.ren#stˌu.dio>s
redigerenstudio+N+Sg+Loc+PxDu1	redigerenstudiosteame	rˈe.di.gˌe.ren#stˌu.dio>stĕɑ.me
redigerenstudio+N+Der/heapmi+A+Attr+Der/vuohta+N+Sg+Ill	redigerenstudiohisvuhtii	rˈe.di.gˌe.ren#stˌu.dio>»his»vˌuh.tij
redigerenstudio+N+Der/huhtti+V+TV+ConNegII	redigerenstudiohuhtto	rˈe.di.gˌe.ren#stˌu.dio>»hˌuhː.to
redigerenstudio+N+Der/huhtti+V+TV+Sup	redigerenstudiohuhtážit	rˈe.di.gˌe.ren#stˌu.dio>»hˌuhː.tá.žih
redigerenstudio+N+Der/huvva+V+IV+VAbess	redigerenstudiohuvahaga	rˈe.di.gˌe.ren#stˌu.dio>»hˌu.vɑ.hˌɑ.gɑ
redigerenstudio+N+Der/huvva+V+IV+VAbess+A+Attr	redigerenstudiohuvakeahtes	rˈe.di.gˌe.ren#stˌu.dio>»hˌu.vɑ.kˌĕɑh.tes
rekruterenstrategiija+N+Sg+Loc	rekruterenstrategiijas	rˈe.kru.tˌe.ren#strˌɑ.te.gˌij.jɑ>s
rekruterenstrategiija+N+Der/Dimin+N+Der/Dimin+N+Sg+Com+PxPl1	rekruterenstrategiijažaččaineamet	rˈe.kru.tˌe.ren#strˌɑ.te.gˌij.jɑ»žˌɑč.čɑ>i.nĕɑ.meh
rekruterenstrategiija+N+Der/heapmi+A+Superl+Sg+Gen	rekruterenstrategiijahepmosa	rˈe.kru.tˌe.ren#strˌɑ.te.gˌij.jɑ»hˌep.mos>ɑ
rekruterenstrategiija+N+Der/huhtti+V+TV+VAbess	rekruterenstrategiijahuhtekeahttájin	rˈe.kru.tˌe.ren#strˌɑ.te.gˌij.jɑ»hˌuh.te>kĕɑhː.tá.jin
rekruterenstrategiija+N+Der/laš+A+Der/vuohta+N+Sg+Ill	rekruterenstrategiijalašvuhtii	rˈe.kru.tˌe.ren#strˌɑ.te.gˌij.jɑ»lɑʃ»vˌuh.ti>i
rekruterenstrategiija+N+Sg+Ill	rekruterenstrategiijii	rˈe.kru.tˌe.ren#strˌɑ.te.gˌij.ji>i
rekrutterenstrategiija+N+Ess+PxSg3	rekrutterenstrategiijanis	rˈe.krut.tˌe.ren#strˌɑ.te.gˌij.jɑ>nis
rekrutterenstrategiija+N+Pl+Acc+PxPl1	rekrutterenstrategiijaideamet	rˈe.krut.tˌe.ren#strˌɑ.te.gˌij.jɑ>i.dĕɑ.meh
rekrutterenstrategiija+N+Der/Dimin+N+Sg+Gen+PxDu2	rekrutterenstrategiijažeatte	rˈe.krut.tˌe.ren#strˌɑ.te.gˌij.jɑ»žˌĕɑt.te
rekrutterenstrategiija+N+Der/heapmi+A+Attr	rekrutterenstrategiijahis	rˈe.krut.tˌe.ren#strˌɑ.te.gˌij.jɑ»his>
rekrutterenstrategiija+N+Der/huhtti+V+TV+Imprt+Pl1	rekrutterenstrategiijahuhttut	rˈe.krut.tˌe.ren#strˌɑ.te.gˌij.jɑ»hˌuhː.tu>h
rekrutterenstrategiija+N+Der/huhtti+V+TV+Cond+Prs+Sg1	rekrutterenstrategiijahuhtášin	rˈe.krut.tˌe.ren#strˌɑ.te.gˌij.jɑ»hˌuhː.tá>ʃin
rekrutterenstrategiija+N+Der/huvva+V+IV+PrfPrc	rekrutterenstrategiijahuvvan	rˈe.krut.tˌe.ren#strˌɑ.te.gˌij.jɑ»hˌuv.vɑ>n
rekrutterenstrategiija+N+Der/laš+A+Comp+Attr	rekrutterenstrategiijalit	rˈe.krut.tˌe.ren#strˌɑ.te.gˌij.jɑ»lit>
rekrutterenstrategiija+N+Der/laš+A+Comp+Sg+Nom	rekrutterenstrategiijalit	rˈe.krut.tˌe.ren#strˌɑ.te.gˌij.jɑ»lit>
rekrutterenstrategiija+N+Sg+Ill	rekrutterenstrategiijii	rˈe.krut.tˌe.ren#strˌɑ.te.gˌij.ji>i
sadista+N+Ess	sadistan	sˈɑ.dis.tɑ>n
sadista+N+Sg+Ill	sadistii	sˈɑ.dis.ti>i
sadista+N+Sg+Acc+PxSg3	sadisttas	sˈɑ.dis.tɑ>s
sadista+N+Der/huhtti+V+TV+Ger+PxDu3	sadisttahuhtidettiineaskka	sˈɑ.dis.tɑ»hˌuh.ti>det.tij.neɑs.kɑ
sadomasochista+N+Ess	sadomasochistan	sˈɑ.do#mˌɑ.sok.hˌisː.tɑ>n
sadomasochista+N+Der/viđá+Adv	sadomasochistaviđá	sˈɑ.do#mˌɑ.sok.hˌisː.tɑ»vˌi.ðá
sadomasochista+N+Sg+Ill	sadomasochistii	sˈɑ.do#mˌɑ.sok.hˌisː.ti>i
sadomasochista+N+Sg+Gen+PxDu3	sadomasochisttaska	sˈɑ.do#mˌɑ.sok.hˌis.tɑ>skɑ
sadomasochista+N+Sg+Loc+PxDu2	sadomasochisttasteatte	sˈɑ.do#mˌɑ.sok.hˌis.tɑ>stĕɑt.te
sadomasochista+N+Der/heapmi+A+Superl+Pl+Com	sadomasochisttahepmosiiguin	sˈɑ.do#mˌɑ.sok.hˌis.tɑ»hˌep.mos>ij.gujn
sadomasochista+N+Der/huvva+V+IV+Pot+Prs+Sg3	sadomasochisttahuvaš	sˈɑ.do#mˌɑ.sok.hˌis.tɑ»hˌu.vɑ>ʃ
servodatgeografiija+N+Pl+Com	servodatgeografiijaiguin	sˈerː.vo.ðɑh#gˌe.og.rˌɑ.fij.jɑ>i.gujn
servodatgeografiija+N+Sg+Loc	servodatgeografiijas	sˈerː.vo.ðɑh#gˌe.og.rˌɑ.fij.jɑ>s
servodatgeografiija+N+Der/huhtti+V+TV+Ger	servodatgeografiijahuhtedin	sˈerː.vo.ðɑh#gˌe.og.rˌɑ.fij.jɑ»hˌuh.te>din
servodatgeografiija+N+Sg+Ill	servodatgeografiijii	sˈerː.vo.ðɑh#gˌe.og.rˌɑ.fij.ji>i
servvodatgeografiija+N+Sg+Com+PxDu1	servvodatgeografiijaineame	sˈerv.vo.ðɑh#gˌe.og.rˌɑ.fij.jɑ>i.nĕɑ.me
servvodatgeografiija+N+Sg+Ill	servvodatgeografiijai	sˈerv.vo.ðɑh#gˌe.og.rˌɑ.fij.jɑ>i
servvodatgeografiija+N+Der/viđá+Adv	servvodatgeografiijaviđá	sˈerv.vo.ðɑh#gˌe.og.rˌɑ.fij.jɑ>»vˌi.ðá
servvodatgeografiija+N+Sg+Ill	servvodatgeografiijii	sˈerv.vo.ðɑh#gˌe.og.rˌɑ.fij.ji>i
sjåvinista+N+Ess+PxPl3	sjåvinistaneaset	sjˈoː.vi.nˌisː.tɑ>nĕɑ.seh
sjåvinista+N+Sg+Acc+PxPl1	sjåvinistamet	sjˈoː.vi.nˌisː.tɑ>meh
sjåvinista+N+Der/viđá+Adv	sjåvinistaviđá	sjˈoː.vi.nˌisː.tɑ»vˌi.ðá
sjåvinista+N+Sg+Ill	sjåvinistii	sjˈoː.vi.nˌisː.ti>i
sjåvinista+N+Pl+Nom	sjåvinisttat	sjˈoː.vi.nˌis.tɑ>h
sjåvinista+N+Sg+Acc+PxDu3	sjåvinisttaska	sjˈoː.vi.nˌis.tɑ>skɑ
sjåvinista+N+Sg+Gen+PxPl2	sjåvinisttadet	sjˈoː.vi.nˌis.tɑ>deh
sjåvinista+N+Sg+Com+PxDu3	sjåvinisttaineaskka	sjˈoː.vi.nˌis.tɑ>i.neɑs.kɑ
sjåvinista+N+Sg+Com+PxPl3	sjåvinisttaineaset	sjˈoː.vi.nˌis.tɑ>i.nĕɑ.seh
sjåvinista+N+Sg+Loc	sjåvinisttas	sjˈoː.vi.nˌis.tɑ>s
snackbára+N+Pl+Nom	snackbárat	snˈɑkː#bˌá.rɑ>h
snackbára+N+Sg+Com+PxDu2	snackbáraineatte	snˈɑkː#bˌá.rɑ>i.nĕɑt.te
snackbára+N+Sg+Loc	snackbáras	snˈɑkː#bˌá.rɑ>s
snackbára+N+Sg+Loc+PxDu2	snackbárasteatte	snˈɑkː#bˌá.rɑ>stĕɑt.te
snackbára+N+Der/huhtti+V+TV+VAbess+A+Attr	snackbárahuhtekeahtes	snˈɑkː#bˌá.rɑ»hˌuh.te>kĕɑh.tes
snackbára+N+Der/huvva+V+IV+Ind+Prs+Sg1	snackbárahuvan	snˈɑkː#bˌá.rɑ»hˌu.vɑ>n
snackbára+N+Der/viđá+Adv	snackbáraviđá	snˈɑkː#bˌá.rɑ»vˌi.ðá
snackbára+N+Sg+Ill	snackbárii	snˈɑkː#bˌá.ri>i
sosiáladarwinista+N+Sg+Nom+PxSg2	sosiáladarwinistat	sˈo.si.ˌá.lɑ#dˌɑrː.vi.nˌisː.tɑ>h
sosiáladarwinista+N+Sg+Ill	sosiáladarwinistii	sˈo.si.ˌá.lɑ#dˌɑrː.vi.nˌisː.ti>i
sosiálarealista+N+Ess+PxDu3	sosiálarealistaneaskka	sˈo.si.ˌá.lɑ#rˌe.ɑ.lˌisː.tɑ>neɑs.kɑ
sosiálarealista+N+Der/viđá+Adv	sosiálarealistaviđá	sˈo.si.ˌá.lɑ#rˌe.ɑ.lˌisː.tɑ»vˌi.ðá
sosiálarealista+N+Sg+Ill	sosiálarealistii	sˈo.si.ˌá.lɑ#rˌe.ɑ.lˌisː.ti>i
sosiálarealista+N+Pl+Loc+PxDu3	sosiálarealisttaineaskka	sˈo.si.ˌá.lɑ#rˌe.ɑ.lˌis.tɑ>i.neɑs.kɑ
sosiálarealista+N+Der/Dimin+N+Sg+Nom+PxSg1	sosiálarealisttažan	sˈo.si.ˌá.lɑ#rˌe.ɑ.lˌis.tɑ»žɑn
sosiálademokratiija+N+Der/huhtti+V+TV+Sup	sosiálademokratiijahuhtážit	sˈo.si.ˌá.lɑ#dˌe.mo.krˌɑ.tij.jɑ»hˌuhː.tá>žih
sosiálademokratiija+N+Sg+Ill	sosiálademokratiijii	sˈo.si.ˌá.lɑ#dˌe.mo.krˌɑ.tij.ji>i
sosiálapornografiija+N+Der/heapmi+A+Attr	sosiálapornografiijahis	sˈo.si.ˌá.lɑ#phˌor.no.grˌɑ.fij.jɑ»his>
sosiálapornografiija+N+Der/huhtti+V+TV+Sup	sosiálapornografiijahuhtážit	sˈo.si.ˌá.lɑ#phˌor.no.grˌɑ.fij.jɑ»hˌuhː.tá>žih
sosiálapornografiija+N+Der/laš+A+Comp+Attr	sosiálapornografiijalit	sˈo.si.ˌá.lɑ#phˌor.no.grˌɑ.fij.jɑ»lit>
sosiálapornografiija+N+Sg+Ill	sosiálapornografiijii	sˈo.si.ˌá.lɑ#phˌor.no.grˌɑ.fij.ji>i
stoahkanstudio+N+Ess+PxDu2	stoahkanstudioneatte	stˈoɑh.kɑn#stˌu.dio>nĕɑt.te
stoahkanstudio+N+Sg+Ill+PxDu3	stoahkanstudiosaskka	stˈoɑh.kɑn#stˌu.dio>sɑs.kɑ
stoahkanstudio+N+Sg+Loc	stoahkanstudios	stˈoɑh.kɑn#stˌu.dio>s
strategiija+N+Pl+Com	strategiijaiguin	strˈɑ.te.gˌij.jɑ>i.gujn
strategiija+N+Pl+Nom	strategiijat	strˈɑ.te.gˌij.jɑ>h
strategiija+N+Sg+Gen+PxPl1	strategiijamet	strˈɑ.te.gˌij.jɑ>meh
strategiija+N+Der/huhtti+V+TV+Ind+Prs+ConNeg	strategiijahuhte	strˈɑ.te.gˌij.jɑ»hˌuh.te>
strategiija+N+Sg+Ill	strategiijii	strˈɑ.te.gˌij.ji>i
studioságastallan+N+Der/viđá+Adv	studioságastallanviđá	stˈu.dio#sˌá.gɑs.tˌɑl.lɑn»vˌi.ðá
stuorraguovllustrategiija+N+Sg+Loc+PxDu3	stuorraguovllustrategiijasteaskka	stˈuor.rɑ#gˌuoβl.lu#strˌɑ.te.gˌij.jɑ>steɑs.kɑ
stuorraguovllustrategiija+N+Sg+Ill	stuorraguovllustrategiijii	stˈuor.rɑ#gˌuoβl.lu#strˌɑ.te.gˌij.ji>i
suddadanstrategiija+N+Sg+Ill+PxPl1	suddadanstrategiijaseamet	sˈud.dɑː.ðɑn#strˌɑ.te.gˌij.jɑ>sĕɑ.meh
suddadanstrategiija+N+Sg+Ill	suddadanstrategiijii	sˈud.dɑː.ðɑn#strˌɑ.te.gˌij.ji>i
suodjalanstrategiija+N+Der/viđá+Adv	suodjalanstrategiijaviđá	sˈuoc.cɑ.lɑn#strˌɑ.te.gˌij.jɑ>»vˌi.ðá
suodjalanstrategiija+N+Sg+Ill	suodjalanstrategiijii	sˈuoc.cɑ.lɑn#strˌɑ.te.gˌij.ji>i
surrealista+N+Sg+Gen+PxPl1	surrealistamet	sˈur.re.ˌɑ.lis.tɑ>meh
surrealista+N+Sg+Ill	surrealistii	sˈur.re.ˌɑ.lis.ti>i
surrealista+N+Pl+Nom	surrealisttat	sˈur.re.ˌɑ.lis.tɑ>h
surrealista+N+Der/heapmi+A+Attr+Der/vuohta+N+Sg+Com+PxDu3	surrealisttahisvuođaineaskka	sˈur.re.ˌɑ.lis.tɑ»his>»vˌuo.ðɑj.nˌeɑs.kɑ
surrealista+N+Der/huvva+V+IV+VAbess+A+Attr	surrealisttahuvakeahtes	sˈur.re.ˌɑ.lis.tɑ»hˌu.vɑ>kĕɑh.tes
telestudio+N+Ess+PxDu2	telestudioneatte	thˈe.le#stˌu.dio>nĕɑt.te
telestudio+N+Ess+PxDu3	telestudioneaskka	thˈe.le#stˌu.dio>neɑs.kɑ
telestudio+N+Ess+PxPl1	telestudioneamet	thˈe.le#stˌu.dio>nĕɑ.meh
telestudio+N+Ess+PxPl2	telestudioneattet	thˈe.le#stˌu.dio>nĕɑt.teh
telestudio+N+Ess+PxPl3	telestudioneaset	thˈe.le#stˌu.dio>nĕɑ.seh
telestudio+N+Ess+PxSg3	telestudionis	thˈe.le#stˌu.dio>nis
telestudio+N+Pl+Acc+PxPl3	telestudioideaset	thˈe.le#stˌu.dio>i.dĕɑ.seh
telestudio+N+Pl+Com+PxPl2	telestudioideattetguin	thˈe.le#stˌu.dio>i.dĕɑt.tet.gujn
telestudio+N+Pl+Com	telestudioiguin	thˈe.le#stˌu.dio>i.gujn
telestudio+N+Pl+Loc+PxPl3	telestudioineaset	thˈe.le#stˌu.dio>i.nĕɑ.seh
telestudio+N+Pl+Nom+PxDu1	telestudioideame	thˈe.le#stˌu.dio>i.dĕɑ.me
telestudio+N+Pl+Nom+PxPl1	telestudioideamet	thˈe.le#stˌu.dio>i.dĕɑ.meh
telestudio+N+Pl+Nom	telestudiot	thˈe.le#stˌu.dio>h
telestudio+N+Sg+Acc+PxDu3	telestudioskka	thˈe.le#stˌu.dio>skːɑ
telestudio+N+Sg+Acc+PxPl3	telestudioset	thˈe.le#stˌu.dio>seh
telestudio+N+Sg+Acc+PxSg3	telestudios	thˈe.le#stˌu.dio>s
telestudio+N+Sg+Nom+PxDu3	telestudioskka	thˈe.le#stˌu.dio>skːɑ
telestudio+N+Sg+Nom+PxSg1	telestudion	thˈe.le#stˌu.dio>n
telestudio+N+Sg+Nom+PxSg2	telestudiot	thˈe.le#stˌu.dio>h
telestudio+N+Sg+Com+PxDu1	telestudioineame	thˈe.le#stˌu.dio>i.nĕɑ.me
telestudio+N+Sg+Com+PxSg3	telestudioinis	thˈe.le#stˌu.dio>i.nis
telestudio+N+Sg+Com	telestudioin	thˈe.le#stˌu.dio>in
telestudio+N+Sg+Ill	telestudioi	thˈe.le#stˌu.dio>i
telestudio+N+Sg+Ill+PxDu1	telestudiosame	thˈe.le#stˌu.dio>sɑ.me
telestudio+N+Sg+Ill+PxDu2	telestudiosatte	thˈe.le#stˌu.dio>sɑt.te
telestudio+N+Sg+Ill+PxSg1	telestudiosan	thˈe.le#stˌu.dio>sɑn
telestudio+N+Sg+Loc	telestudios	thˈe.le#stˌu.dio>s
telestudio+N+Sg+Loc+PxDu3	telestudiosteaskka	thˈe.le#stˌu.dio>steɑs.kɑ
telestudio+N+Sg+Loc+PxSg3	telestudiostis	thˈe.le#stˌu.dio>stis
telestudio+N+Der/heapmi+A+Comp+Pl+Acc	telestudiohabbuid	thˈe.le#stˌu.dio>»hˌɑb.bujh
telestudio+N+Der/heapmi+A+Superl+Pl+Ill	telestudiohamosiidda	thˈe.le#stˌu.dio>»hˌɑ.mo.sˌijd.dɑ
telestudio+N+Der/heapmi+A+Ess	telestudioheapmin	thˈe.le#stˌu.dio>»hˌeɑp.min
telestudio+N+Der/heapmi+A+Attr	telestudiohis	thˈe.le#stˌu.dio>»his
telestudio+N+Der/heapmi+A+Attr+Der/vuohta+N+Sg+Ill	telestudiohisvuhtii	thˈe.le#stˌu.dio>»his»vˌuh.tij
telestudio+N+Der/heapmi+A+Attr+Der/vuohta+N+Sg+Com	telestudiohisvuođain	thˈe.le#stˌu.dio>»his»vˌuo.ðɑjn
telestudio+N+Der/huhtti+V+TV+Ger+PxPl3	telestudiohuhtedettiineaset	thˈe.le#stˌu.dio>»hˌuh.te.dˌet.tij.nˌĕɑ.seh
telestudio+N+Der/huhtti+V+TV+Imprt+Sg2	telestudiohuhte	thˈe.le#stˌu.dio>»hˌuh.te
telestudio+N+Der/huvva+V+IV+Ger	telestudiohuvadin	thˈe.le#stˌu.dio>»hˌu.vɑ.din
telestudio+N+Der/huvva+V+IV+Ind+Prs+Sg2	telestudiohuvat	thˈe.le#stˌu.dio>»hˌu.vɑh
tradisjonalista+N+Ess+PxDu2	tradisjonalistaneatte	trˈɑ.dis.jˌo.nɑ.lˌis.tɑ>nĕɑt.te
tradisjonalista+N+Sg+Ill+PxSg1	tradisjonalistasan	trˈɑ.dis.jˌo.nɑ.lˌis.tɑ>sɑn
tradisjonalista+N+Sg+Ill	tradisjonalistii	trˈɑ.dis.jˌo.nɑ.lˌis.ti>i
tradisjonalista+N+Pl+Nom	tradisjonalisttat	trˈɑ.dis.jˌo.nɑ.lˌis.tɑ>h
tradisjonalista+N+Sg+Loc+PxDu1	tradisjonalisttasteame	trˈɑ.dis.jˌo.nɑ.lˌis.tɑ>stĕɑ.me
tradisjonalista+N+Sg+Loc+PxDu3	tradisjonalisttasteaskka	trˈɑ.dis.jˌo.nɑ.lˌis.tɑ>steɑs.kɑ
tradisjonalista+N+Sg+Loc+PxPl1	tradisjonalisttasteamet	trˈɑ.dis.jˌo.nɑ.lˌis.tɑ>stĕɑ.meh
tradisjonalista+N+Sg+Loc+PxSg3	tradisjonalisttastis	trˈɑ.dis.jˌo.nɑ.lˌis.tɑ>stis
tradisjonalista+N+Der/Dimin+N+Sg+Nom	tradisjonalisttaš	trˈɑ.dis.jˌo.nɑ.lˌis.tɑ»ʃ
tradisjonalista+N+Der/Dimin+N+Der/viđá+Adv	tradisjonalisttašviđá	trˈɑ.dis.jˌo.nɑ.lˌis.tɑ»ʃ»vˌi.ðá
tradisjonalista+N+Der/Dimin+N+Pl+Nom	tradisjonalisttažat	trˈɑ.dis.jˌo.nɑ.lˌis.tɑ»žɑh
tradisjonalista+N+Der/Dimin+N+Sg+Gen	tradisjonalisttaža	trˈɑ.dis.jˌo.nɑ.lˌis.tɑ»žɑ
tradisjonalista+N+Der/Dimin+N+Sg+Loc+PxSg3	tradisjonalisttažisttis	trˈɑ.dis.jˌo.nɑ.lˌis.tɑ»žˌis.ti>s
tradisjonalista+N+Der/heapmi+A+Sg+Com	tradisjonalisttahemiin	trˈɑ.dis.jˌo.nɑ.lˌis.tɑ»hˌe.mi>in
tradisjonalista+N+Der/huhtti+V+TV+Ind+Prs+Sg2	tradisjonalisttahuhtát	trˈɑ.dis.jˌo.nɑ.lˌis.tɑ»hˌuhː.tá>h
tradisjonalista+N+Der/huvva+V+IV+Imprt+ConNeg	tradisjonalisttahuva	trˈɑ.dis.jˌo.nɑ.lˌis.tɑ»hˌu.vɑ>
tradisjonalista+N+Der/huvva+V+IV+Actio+Nom	tradisjonalisttahuvvan	trˈɑ.dis.jˌo.nɑ.lˌis.tɑ»hˌuv.vɑ>n
tradisjonalista+N+Der/huvva+V+IV+Ind+Prs+Sg3	tradisjonalisttahuvvá	trˈɑ.dis.jˌo.nɑ.lˌis.tɑ»hˌuvː.vá>
tradisjonalista+N+Der/laš+A+Ess	tradisjonalisttalažžan	trˈɑ.dis.jˌo.nɑ.lˌis.tɑ»lˌɑž.žɑ>n
trucksystema+N+Pl+Com+PxDu1	trucksystemaideameguin	trˈukː#sˌysː.te.mɑ>i.dĕɑ.me.gujn
trucksystema+N+Pl+Nom	trucksystemat	trˈukː#sˌysː.te.mɑ>h
trucksystema+N+Sg+Gen+PxDu2	trucksystemade	trˈukː#sˌysː.te.mɑ>de
trucksystema+N+Der/Dimin+N+Sg+Com	trucksystemažiin	trˈukː#sˌysː.te.mɑ»žijn
trucksystema+N+Der/huhtti+V+TV+VAbess+A+Attr	trucksystemahuhtekeahtes	trˈukː#sˌysː.te.mɑ»hˌuh.te>kĕɑh.tes
trucksystema+N+Der/huvva+V+IV+Sup	trucksystemahuvažit	trˈukː#sˌysː.te.mɑ»hˌu.vɑ>žih
trucksystema+N+Der/huvva+V+IV+VAbess	trucksystemahuvahaga	trˈukː#sˌysː.te.mɑ»hˌu.vɑ>hɑ.gɑ
trucksystema+N+Der/laš+A+Comp+Sg+Nom	trucksystemalit	trˈukː#sˌysː.te.mɑ»lit>
trucksystema+N+Der/viđá+Adv	trucksystemaviđá	trˈukː#sˌysː.te.mɑ»vˌi.ðá
trucksystema+N+Sg+Ill	trucksystemii	trˈukː#sˌysː.te.mi>i
truisma+N+Sg+Ill+PxDu3	truismaseaskka	trˈu.is.mɑ>seɑs.kɑ
truisma+N+Der/viđá+Adv	truismaviđá	trˈu.is.mɑ»vˌi.ðá
truisma+N+Sg+Ill	truismii	trˈu.is.mi>i
truisma+N+Pl+Loc+PxSg2	truismmainat	trˈu.is.mɑ>i.nɑh
truisma+N+Sg+Acc	truismma	trˈu.is.mɑ>
truisma+N+Sg+Com+PxPl1	truismmaineamet	trˈu.is.mɑ>i.nĕɑ.meh
truisma+N+Sg+Com+PxSg1	truismmainan	trˈu.is.mɑ>i.nɑn
truisma+N+Sg+Loc	truismmas	trˈu.is.mɑ>s
truisma+N+Der/Dimin+N+Der/Dimin+N+Pl+Nom	truismmažaččat	trˈu.is.mɑ»žˌɑč.čɑ>h
truisma+N+Der/laš+A+Der/vuohta+N+Sg+Gen+PxDu2	truismmalašvuođade	trˈu.is.mɑ»lɑʃ»vˌuo.ðɑ>de
varasguollestrategiija+N+Ess+PxDu3	varasguollestrategiijaneaskka	vˈɑ.rɑːs#gˌŭol.le#strˌɑ.te.gˌij.jɑ>neɑs.kɑ
varasguollestrategiija+N+Ess	varasguollestrategiijan	vˈɑ.rɑːs#gˌŭol.le#strˌɑ.te.gˌij.jɑ>n
varasguollestrategiija+N+Pl+Com	varasguollestrategiijaiguin	vˈɑ.rɑːs#gˌŭol.le#strˌɑ.te.gˌij.jɑ>i.gujn
varasguollestrategiija+N+Pl+Loc+PxDu2	varasguollestrategiijaineatte	vˈɑ.rɑːs#gˌŭol.le#strˌɑ.te.gˌij.jɑ>i.nĕɑt.te
varasguollestrategiija+N+Pl+Nom	varasguollestrategiijat	vˈɑ.rɑːs#gˌŭol.le#strˌɑ.te.gˌij.jɑ>h
varasguollestrategiija+N+Sg+Nom+PxPl3	varasguollestrategiijaset	vˈɑ.rɑːs#gˌŭol.le#strˌɑ.te.gˌij.jɑ>seh
varasguollestrategiija+N+Sg+Nom	varasguollestrategiija	vˈɑ.rɑːs#gˌŭol.le#strˌɑ.te.gˌij.jɑ>
varasguollestrategiija+N+Sg+Ill	varasguollestrategiijai	vˈɑ.rɑːs#gˌŭol.le#strˌɑ.te.gˌij.jɑ>i
varasguollestrategiija+N+Sg+Ill+PxPl3	varasguollestrategiijaseaset	vˈɑ.rɑːs#gˌŭol.le#strˌɑ.te.gˌij.jɑ>sĕɑ.seh
varasguollestrategiija+N+Sg+Ill+PxSg2	varasguollestrategiijasat	vˈɑ.rɑːs#gˌŭol.le#strˌɑ.te.gˌij.jɑ>sɑh
varasguollestrategiija+N+Sg+Loc+PxDu1	varasguollestrategiijasteame	vˈɑ.rɑːs#gˌŭol.le#strˌɑ.te.gˌij.jɑ>stĕɑ.me
varasguollestrategiija+N+Sg+Loc+PxDu2	varasguollestrategiijasteatte	vˈɑ.rɑːs#gˌŭol.le#strˌɑ.te.gˌij.jɑ>stĕɑt.te
varasguollestrategiija+N+Sg+Loc+PxPl2	varasguollestrategiijasteattet	vˈɑ.rɑːs#gˌŭol.le#strˌɑ.te.gˌij.jɑ>stĕɑt.teh
varasguollestrategiija+N+Sg+Loc+PxSg1	varasguollestrategiijastan	vˈɑ.rɑːs#gˌŭol.le#strˌɑ.te.gˌij.jɑ>stɑn
varasguollestrategiija+N+Der/viđá+Adv	varasguollestrategiijaviđá	vˈɑ.rɑːs#gˌŭol.le#strˌɑ.te.gˌij.jɑ>»vˌi.ðá
varasguollestrategiija+N+Der/Dimin+N+Der/viđá+Adv	varasguollestrategiijašviđá	vˈɑ.rɑːs#gˌŭol.le#strˌɑ.te.gˌij.jɑ»ʃ»vˌi.ðá
varasguollestrategiija+N+Der/Dimin+N+Der/Dimin+N+Sg+Nom	varasguollestrategiijažaš	vˈɑ.rɑːs#gˌŭol.le#strˌɑ.te.gˌij.jɑ»žɑʃ>
varasguollestrategiija+N+Der/heapmi+A+Superl+Ess	varasguollestrategiijaheamosin	vˈɑ.rɑːs#gˌŭol.le#strˌɑ.te.gˌij.jɑ»hˌĕɑ.mos>in
varasguollestrategiija+N+Der/huhtti+V+TV+Pot+Prs+ConNeg	varasguollestrategiijahuhteš	vˈɑ.rɑːs#gˌŭol.le#strˌɑ.te.gˌij.jɑ»hˌuh.te>ʃ
varasguollestrategiija+N+Der/huhtti+V+TV+Actio+Ess	varasguollestrategiijahuhttimen	vˈɑ.rɑːs#gˌŭol.le#strˌɑ.te.gˌij.jɑ»hˌuhː.ti>men
varasguollestrategiija+N+Der/huhtti+V+TV+Imprt+ConNegII	varasguollestrategiijahuhtto	vˈɑ.rɑːs#gˌŭol.le#strˌɑ.te.gˌij.jɑ»hˌuhː.to>
varasguollestrategiija+N+Der/huhtti+V+TV+Cond+Prs+Du3	varasguollestrategiijahuhtáleigga	vˈɑ.rɑːs#gˌŭol.le#strˌɑ.te.gˌij.jɑ»hˌuhː.tá>lejg.gɑ
varasguollestrategiija+N+Der/huhtti+V+TV+Cond+Prs+Du3	varasguollestrategiijahuhtášeigga	vˈɑ.rɑːs#gˌŭol.le#strˌɑ.te.gˌij.jɑ»hˌuhː.tá>ʃejg.gɑ
varasguollestrategiija+N+Der/huhtti+V+TV+Sup	varasguollestrategiijahuhtážit	vˈɑ.rɑːs#gˌŭol.le#strˌɑ.te.gˌij.jɑ»hˌuhː.tá>žih
varasguollestrategiija+N+Der/huvva+V+IV+Cond+Prs+Du1	varasguollestrategiijahuvašeimme	vˈɑ.rɑːs#gˌŭol.le#strˌɑ.te.gˌij.jɑ»hˌu.vɑ>ʃejm.me
varasguollestrategiija+N+Der/huvva+V+IV+Ind+Prt+Du2	varasguollestrategiijahuvaide	vˈɑ.rɑːs#gˌŭol.le#strˌɑ.te.gˌij.jɑ»hˌu.vɑ>i.de
varasguollestrategiija+N+Der/huvva+V+IV+Ind+Prt+Pl2	varasguollestrategiijahuvaidet	vˈɑ.rɑːs#gˌŭol.le#strˌɑ.te.gˌij.jɑ»hˌu.vɑ>i.deh
varasguollestrategiija+N+Der/huvva+V+IV+Imprt+Pl2	varasguollestrategiijahuvvet	vˈɑ.rɑːs#gˌŭol.le#strˌɑ.te.gˌij.jɑ»hˌuv.ve>h
varasguollestrategiija+N+Der/huvva+V+IV+Imprt+Du2	varasguollestrategiijahuvvi	vˈɑ.rɑːs#gˌŭol.le#strˌɑ.te.gˌij.jɑ»hˌuv.vi>
varasguollestrategiija+N+Der/laš+A+Der/vuohta+N+Sg+Ill	varasguollestrategiijalašvuhtii	vˈɑ.rɑːs#gˌŭol.le#strˌɑ.te.gˌij.jɑ»lɑʃ»vˌuh.ti>i
varasguollestrategiija+N+Sg+Ill	varasguollestrategiijii	vˈɑ.rɑːs#gˌŭol.le#strˌɑ.te.gˌij.ji>i
váldostrategiija+N+Ess+PxPl3	váldostrategiijaneaset	vˈálː.do#strˌɑ.te.gˌij.jɑ>nĕɑ.seh
váldostrategiija+N+Ess	váldostrategiijan	vˈálː.do#strˌɑ.te.gˌij.jɑ>n
váldostrategiija+N+Pl+Gen	váldostrategiijaid	vˈálː.do#strˌɑ.te.gˌij.jɑ>id
váldostrategiija+N+Pl+Nom	váldostrategiijat	vˈálː.do#strˌɑ.te.gˌij.jɑ>h
váldostrategiija+N+Sg+Gen+PxDu1	váldostrategiijame	vˈálː.do#strˌɑ.te.gˌij.jɑ>me
váldostrategiija+N+Sg+Gen+PxPl2	váldostrategiijadet	vˈálː.do#strˌɑ.te.gˌij.jɑ>deh
váldostrategiija+N+Sg+Gen+PxSg2	váldostrategiijat	vˈálː.do#strˌɑ.te.gˌij.jɑ>h
váldostrategiija+N+Sg+Nom+PxDu2	váldostrategiijade	vˈálː.do#strˌɑ.te.gˌij.jɑ>de
váldostrategiija+N+Sg+Ill+PxSg1	váldostrategiijasan	vˈálː.do#strˌɑ.te.gˌij.jɑ>sɑn
váldostrategiija+N+Sg+Loc+PxPl1	váldostrategiijasteamet	vˈálː.do#strˌɑ.te.gˌij.jɑ>stĕɑ.meh
váldostrategiija+N+Der/viđá+Adv	váldostrategiijaviđá	vˈálː.do#strˌɑ.te.gˌij.jɑ>»vˌi.ðá
váldostrategiija+N+Der/Dimin+N+Der/viđá+Adv	váldostrategiijašviđá	vˈálː.do#strˌɑ.te.gˌij.jɑ»ʃ»vˌi.ðá
váldostrategiija+N+Der/Dimin+N+Ess	váldostrategiijažin	vˈálː.do#strˌɑ.te.gˌij.jɑ»žin
váldostrategiija+N+Der/Dimin+N+Pl+Nom	váldostrategiijažat	vˈálː.do#strˌɑ.te.gˌij.jɑ»žɑh
váldostrategiija+N+Der/Dimin+N+Der/Dimin+N+Sg+Nom	váldostrategiijažaš	vˈálː.do#strˌɑ.te.gˌij.jɑ»žɑʃ>
váldostrategiija+N+Der/Dimin+N+Der/Dimin+N+Ess+PxPl2	váldostrategiijažažžaneattet	vˈálː.do#strˌɑ.te.gˌij.jɑ»žˌɑž.žɑ>nĕɑt.teh
váldostrategiija+N+Der/Dimin+N+Sg+Com+PxSg1	váldostrategiijažiinnán	vˈálː.do#strˌɑ.te.gˌij.jɑ»žˌijn.ná>n
váldostrategiija+N+Der/heapmi+A+Comp+Attr	váldostrategiijahat	vˈálː.do#strˌɑ.te.gˌij.jɑ»hɑt>
váldostrategiija+N+Der/heapmi+A+Attr+Der/vuohta+N+Der/viđá+Adv	váldostrategiijahisvuohtaviđá	vˈálː.do#strˌɑ.te.gˌij.jɑ»his>»vˌuoh.tɑ»vˌi.ðá
váldostrategiija+N+Der/huhtti+V+TV+Der/NomAct+N+Sg+Gen	váldostrategiijahuhttin	vˈálː.do#strˌɑ.te.gˌij.jɑ»hˌuhː.ti>»n
váldostrategiija+N+Der/huvva+V+IV+VAbess+A+Attr	váldostrategiijahuvakeahtes	vˈálː.do#strˌɑ.te.gˌij.jɑ»hˌu.vɑ>kĕɑh.tes
váldostrategiija+N+Der/laš+A+Ess	váldostrategiijalažžan	vˈálː.do#strˌɑ.te.gˌij.jɑ»lˌɑž.žɑ>n
váldostrategiija+N+Der/laš+A+Attr	váldostrategiijalaš	vˈálː.do#strˌɑ.te.gˌij.jɑ»lɑʃ>
váldostrategiija+N+Sg+Ill	váldostrategiijii	vˈálː.do#strˌɑ.te.gˌij.ji>i
áideanarkiija+N+Ess+PxDu3	áideanarkiijaneaskka	ˈájː.de#ˌɑn.ɑr.kˌij.jɑ>neɑs.kɑ
áideanarkiija+N+Pl+Com	áideanarkiijaiguin	ˈájː.de#ˌɑn.ɑr.kˌij.jɑ>i.gujn
áideanarkiija+N+Pl+Nom	áideanarkiijat	ˈájː.de#ˌɑn.ɑr.kˌij.jɑ>h
áideanarkiija+N+Sg+Acc+PxSg1	áideanarkiijan	ˈájː.de#ˌɑn.ɑr.kˌij.jɑ>n
áideanarkiija+N+Sg+Gen+PxSg2	áideanarkiijat	ˈájː.de#ˌɑn.ɑr.kˌij.jɑ>h
áideanarkiija+N+Sg+Nom+PxDu1	áideanarkiijame	ˈájː.de#ˌɑn.ɑr.kˌij.jɑ>me
áideanarkiija+N+Sg+Com+PxPl3	áideanarkiijaineaset	ˈájː.de#ˌɑn.ɑr.kˌij.jɑ>i.nĕɑ.seh
áideanarkiija+N+Sg+Ill	áideanarkiijai	ˈájː.de#ˌɑn.ɑr.kˌij.jɑ>i
áideanarkiija+N+Der/viđá+Adv	áideanarkiijaviđá	ˈájː.de#ˌɑn.ɑr.kˌij.jɑ>»vˌi.ðá
áideanarkiija+N+Der/Dimin+N+Sg+Nom	áideanarkiijaš	ˈájː.de#ˌɑn.ɑr.kˌij.jɑ»ʃ
áideanarkiija+N+Der/Dimin+N+Sg+Acc	áideanarkiijaža	ˈájː.de#ˌɑn.ɑr.kˌij.jɑ»žɑ
áideanarkiija+N+Der/Dimin+N+Der/Dimin+N+Sg+Ill+PxSg2	áideanarkiijažažžasat	ˈájː.de#ˌɑn.ɑr.kˌij.jɑ»žˌɑž.žɑ>sɑh
áideanarkiija+N+Der/heapmi+A+Comp+Sg+Nom	áideanarkiijahat	ˈájː.de#ˌɑn.ɑr.kˌij.jɑ»hɑt>
áideanarkiija+N+Der/heapmi+A+Ess	áideanarkiijaheapmin	ˈájː.de#ˌɑn.ɑr.kˌij.jɑ»hˌeɑp.mi>n
áideanarkiija+N+Der/heapmi+A+Sg+Com	áideanarkiijahemiin	ˈájː.de#ˌɑn.ɑr.kˌij.jɑ»hˌe.mi>in
áideanarkiija+N+Der/heapmi+A+Attr+Der/vuohta+N+Sg+Ill	áideanarkiijahisvuhtii	ˈájː.de#ˌɑn.ɑr.kˌij.jɑ»his>»vˌuh.tij
áideanarkiija+N+Der/huhtti+V+TV+Ind+Prs+ConNeg	áideanarkiijahuhte	ˈájː.de#ˌɑn.ɑr.kˌij.jɑ»hˌuh.te>
áideanarkiija+N+Der/huhtti+V+TV+Cond+Prs+Sg1	áideanarkiijahuhtášedjen	ˈájː.de#ˌɑn.ɑr.kˌij.jɑ»hˌuhː.tá>ʃec.cen
áideanarkiija+N+Der/huvva+V+IV+Ger+PxDu1	áideanarkiijahuvadettiineame	ˈájː.de#ˌɑn.ɑr.kˌij.jɑ»hˌu.vɑ>det.tij.nĕɑ.me
áideanarkiija+N+Der/huvva+V+IV+Ger+PxPl1	áideanarkiijahuvadettiineamet	ˈájː.de#ˌɑn.ɑr.kˌij.jɑ»hˌu.vɑ>det.tij.nĕɑ.meh
áideanarkiija+N+Der/huvva+V+IV+ConNegII	áideanarkiijahuvvo	ˈájː.de#ˌɑn.ɑr.kˌij.jɑ»hˌuv.vo>
áideanarkiija+N+Der/laš+A+Comp+Pl+Nom	áideanarkiijalabbot	ˈájː.de#ˌɑn.ɑr.kˌij.jɑ»lˌɑb.bo>h
áideanarkiija+N+Der/laš+A+Comp+Sg+Ill	áideanarkiijalebbui	ˈájː.de#ˌɑn.ɑr.kˌij.jɑ»lˌeb.bu>i
áideanarkiija+N+Der/laš+A+Comp+Sg+Nom	áideanarkiijalut	ˈájː.de#ˌɑn.ɑr.kˌij.jɑ»lut>
áideanarkiija+N+Der/laš+A+Ess	áideanarkiijalažžan	ˈájː.de#ˌɑn.ɑr.kˌij.jɑ»lˌɑž.žɑ>n
áideanarkiija+N+Sg+Ill	áideanarkiijii	ˈájː.de#ˌɑn.ɑr.kˌij.ji>i
álbmotdearvvasvuođastrategiija+N+Pl+Nom+PxDu3	álbmotdearvvasvuođastrategiijaideaskka	ˈál.pmoh#dˌeɑrv.vɑs.vˌuo.ðɑ#strˌɑ.te.gˌij.jɑ>i.deɑs.kɑ
álbmotdearvvasvuođastrategiija+N+Der/Dimin+N+Der/viđá+Adv	álbmotdearvvasvuođastrategiijašviđá	ˈál.pmoh#dˌeɑrv.vɑs.vˌuo.ðɑ#strˌɑ.te.gˌij.jɑ»ʃ»vˌi.ðá
álbmotdearvvasvuođastrategiija+N+Der/Dimin+N+Pl+Com	álbmotdearvvasvuođastrategiijažiiguin	ˈál.pmoh#dˌeɑrv.vɑs.vˌuo.ðɑ#strˌɑ.te.gˌij.jɑ»žˌij.gujn
álbmotdearvvasvuođastrategiija+N+Der/huvva+V+IV+Ger+PxSg1	álbmotdearvvasvuođastrategiijahuvadettiinan	ˈál.pmoh#dˌeɑrv.vɑs.vˌuo.ðɑ#strˌɑ.te.gˌij.jɑ»hˌu.vɑ>det.tij.nɑn
álbmotdearvvasvuođastrategiija+N+Der/huvva+V+IV+Imprt+Du2	álbmotdearvvasvuođastrategiijahuvvi	ˈál.pmoh#dˌeɑrv.vɑs.vˌuo.ðɑ#strˌɑ.te.gˌij.jɑ»hˌuv.vi>
álbmotdearvvasvuođastrategiija+N+Sg+Ill	álbmotdearvvasvuođastrategiijii	ˈál.pmoh#dˌeɑrv.vɑs.vˌuo.ðɑ#strˌɑ.te.gˌij.ji>i
álbmotdearvvašvuođastrategiija+N+Ess+PxDu1	álbmotdearvvašvuođastrategiijaneame	ˈál.pmoh#dˌeɑrv.vɑʃ.vˌuo.ðɑ#strˌɑ.te.gˌij.jɑ>nĕɑ.me
álbmotdearvvašvuođastrategiija+N+Ess	álbmotdearvvašvuođastrategiijan	ˈál.pmoh#dˌeɑrv.vɑʃ.vˌuo.ðɑ#strˌɑ.te.gˌij.jɑ>n
álbmotdearvvašvuođastrategiija+N+Pl+Nom	álbmotdearvvašvuođastrategiijat	ˈál.pmoh#dˌeɑrv.vɑʃ.vˌuo.ðɑ#strˌɑ.te.gˌij.jɑ>h
álbmotdearvvašvuođastrategiija+N+Sg+Gen+PxDu1	álbmotdearvvašvuođastrategiijame	ˈál.pmoh#dˌeɑrv.vɑʃ.vˌuo.ðɑ#strˌɑ.te.gˌij.jɑ>me
álbmotdearvvašvuođastrategiija+N+Sg+Gen+PxPl1	álbmotdearvvašvuođastrategiijamet	ˈál.pmoh#dˌeɑrv.vɑʃ.vˌuo.ðɑ#strˌɑ.te.gˌij.jɑ>meh
álbmotdearvvašvuođastrategiija+N+Sg+Com+PxPl1	álbmotdearvvašvuođastrategiijaineamet	ˈál.pmoh#dˌeɑrv.vɑʃ.vˌuo.ðɑ#strˌɑ.te.gˌij.jɑ>i.nĕɑ.meh
álbmotdearvvašvuođastrategiija+N+Der/heapmi+A+Superl+Pl+Ill	álbmotdearvvašvuođastrategiijahepmosiidda	ˈál.pmoh#dˌeɑrv.vɑʃ.vˌuo.ðɑ#strˌɑ.te.gˌij.jɑ»hˌep.mos>ijd.dɑ
álbmotdearvvašvuođastrategiija+N+Der/heapmi+A+Attr	álbmotdearvvašvuođastrategiijahis	ˈál.pmoh#dˌeɑrv.vɑʃ.vˌuo.ðɑ#strˌɑ.te.gˌij.jɑ»his>
álbmotdearvvašvuođastrategiija+N+Der/huvva+V+IV+Imprt+Pl2	álbmotdearvvašvuođastrategiijahuvvet	ˈál.pmoh#dˌeɑrv.vɑʃ.vˌuo.ðɑ#strˌɑ.te.gˌij.jɑ»hˌuv.ve>h
álbmotdearvvašvuođastrategiija+N+Der/huvva+V+IV+Ind+Prt+Sg1	álbmotdearvvašvuođastrategiijahuvven	ˈál.pmoh#dˌeɑrv.vɑʃ.vˌuo.ðɑ#strˌɑ.te.gˌij.jɑ»hˌuv.ve>n
álbmotdearvvašvuođastrategiija+N+Sg+Ill	álbmotdearvvašvuođastrategiijii	ˈál.pmoh#dˌeɑrv.vɑʃ.vˌuo.ðɑ#strˌɑ.te.gˌij.ji>i
álgoálbmotstrategiija+N+Ess+PxDu3	álgoálbmotstrategiijaneaskka	ˈálː.go#ˌál.pmoh#strˌɑ.te.gˌij.jɑ>neɑs.kɑ
álgoálbmotstrategiija+N+Pl+Com	álgoálbmotstrategiijaiguin	ˈálː.go#ˌál.pmoh#strˌɑ.te.gˌij.jɑ>i.gujn
álgoálbmotstrategiija+N+Sg+Ill+PxSg3	álgoálbmotstrategiijasis	ˈálː.go#ˌál.pmoh#strˌɑ.te.gˌij.jɑ>sis
álgoálbmotstrategiija+N+Sg+Loc	álgoálbmotstrategiijas	ˈálː.go#ˌál.pmoh#strˌɑ.te.gˌij.jɑ>s
álgoálbmotstrategiija+N+Der/viđá+Adv	álgoálbmotstrategiijaviđá	ˈálː.go#ˌál.pmoh#strˌɑ.te.gˌij.jɑ>»vˌi.ðá
álgoálbmotstrategiija+N+Der/Dimin+N+Sg+Nom	álgoálbmotstrategiijaš	ˈálː.go#ˌál.pmoh#strˌɑ.te.gˌij.jɑ»ʃ
álgoálbmotstrategiija+N+Der/Dimin+N+Sg+Gen+PxDu2	álgoálbmotstrategiijažeatte	ˈálː.go#ˌál.pmoh#strˌɑ.te.gˌij.jɑ»žˌĕɑt.te
álgoálbmotstrategiija+N+Der/heapmi+A+Superl+Sg+Loc	álgoálbmotstrategiijahepmosis	ˈálː.go#ˌál.pmoh#strˌɑ.te.gˌij.jɑ»hˌep.mos>is
álgoálbmotstrategiija+N+Der/heapmi+A+Sg+Com	álgoálbmotstrategiijahemiin	ˈálː.go#ˌál.pmoh#strˌɑ.te.gˌij.jɑ»hˌe.mi>in
álgoálbmotstrategiija+N+Der/huhtti+V+TV+Imprt+ConNeg	álgoálbmotstrategiijahuhte	ˈálː.go#ˌál.pmoh#strˌɑ.te.gˌij.jɑ»hˌuh.te>
álgoálbmotstrategiija+N+Der/huhtti+V+TV+Ind+Prs+Sg2	álgoálbmotstrategiijahuhtát	ˈálː.go#ˌál.pmoh#strˌɑ.te.gˌij.jɑ»hˌuhː.tá>h
álgoálbmotstrategiija+N+Der/huvva+V+IV+Ind+Prt+Pl1	álgoálbmotstrategiijahuvaimet	ˈálː.go#ˌál.pmoh#strˌɑ.te.gˌij.jɑ»hˌu.vɑ>i.meh
álgoálbmotstrategiija+N+Der/huvva+V+IV+VAbess	álgoálbmotstrategiijahuvakeahttájin	ˈálː.go#ˌál.pmoh#strˌɑ.te.gˌij.jɑ»hˌu.vɑ>kĕɑhː.tá.jin
álgoálbmotstrategiija+N+Der/huvva+V+IV+Imprt+Du2	álgoálbmotstrategiijahuvvi	ˈálː.go#ˌál.pmoh#strˌɑ.te.gˌij.jɑ»hˌuv.vi>
álgoálbmotstrategiija+N+Der/laš+A+Comp+Sg+Nom	álgoálbmotstrategiijalit	ˈálː.go#ˌál.pmoh#strˌɑ.te.gˌij.jɑ»lit>
álgoálbmotstrategiija+N+Sg+Ill	álgoálbmotstrategiijii	ˈálː.go#ˌál.pmoh#strˌɑ.te.gˌij.ji>i
čállinstrategiija+N+Ess+PxDu2	čállinstrategiijaneatte	čˈál.lin#strˌɑ.te.gˌij.jɑ>nĕɑt.te
čállinstrategiija+N+Ess+PxPl2	čállinstrategiijaneattet	čˈál.lin#strˌɑ.te.gˌij.jɑ>nĕɑt.teh
čállinstrategiija+N+Ess+PxPl3	čállinstrategiijaneaset	čˈál.lin#strˌɑ.te.gˌij.jɑ>nĕɑ.seh
čállinstrategiija+N+Ess+PxSg2	čállinstrategiijanat	čˈál.lin#strˌɑ.te.gˌij.jɑ>nɑh
čállinstrategiija+N+Ess	čállinstrategiijan	čˈál.lin#strˌɑ.te.gˌij.jɑ>n
čállinstrategiija+N+Pl+Gen+PxPl1	čállinstrategiijaideamet	čˈál.lin#strˌɑ.te.gˌij.jɑ>i.dĕɑ.meh
čállinstrategiija+N+Pl+Ill	čállinstrategiijaide	čˈál.lin#strˌɑ.te.gˌij.jɑ>i.de
čállinstrategiija+N+Pl+Loc+PxPl1	čállinstrategiijaineamet	čˈál.lin#strˌɑ.te.gˌij.jɑ>i.nĕɑ.meh
čállinstrategiija+N+Pl+Loc+PxSg3	čállinstrategiijainis	čˈál.lin#strˌɑ.te.gˌij.jɑ>i.nis
čállinstrategiija+N+Pl+Nom	čállinstrategiijat	čˈál.lin#strˌɑ.te.gˌij.jɑ>h
čállinstrategiija+N+Sg+Nom+PxPl2	čállinstrategiijadet	čˈál.lin#strˌɑ.te.gˌij.jɑ>deh
čállinstrategiija+N+Sg+Com+PxDu2	čállinstrategiijaineatte	čˈál.lin#strˌɑ.te.gˌij.jɑ>i.nĕɑt.te
čállinstrategiija+N+Sg+Com+PxPl3	čállinstrategiijaineaset	čˈál.lin#strˌɑ.te.gˌij.jɑ>i.nĕɑ.seh
čállinstrategiija+N+Sg+Ill	čállinstrategiijai	čˈál.lin#strˌɑ.te.gˌij.jɑ>i
čállinstrategiija+N+Sg+Ill+PxPl1	čállinstrategiijaseamet	čˈál.lin#strˌɑ.te.gˌij.jɑ>sĕɑ.meh
čállinstrategiija+N+Sg+Loc	čállinstrategiijas	čˈál.lin#strˌɑ.te.gˌij.jɑ>s
čállinstrategiija+N+Der/viđá+Adv	čállinstrategiijaviđá	čˈál.lin#strˌɑ.te.gˌij.jɑ>»vˌi.ðá
čállinstrategiija+N+Der/Dimin+N+Der/viđá+Adv	čállinstrategiijašviđá	čˈál.lin#strˌɑ.te.gˌij.jɑ»ʃ»vˌi.ðá
čállinstrategiija+N+Der/Dimin+N+Sg+Acc+PxDu2	čállinstrategiijažeatte	čˈál.lin#strˌɑ.te.gˌij.jɑ»žˌĕɑt.te
čállinstrategiija+N+Der/heapmi+A+Superl+Ess	čállinstrategiijahamosin	čˈál.lin#strˌɑ.te.gˌij.jɑ»hˌɑ.mos>in
čállinstrategiija+N+Der/heapmi+A+Sg+Gen	čállinstrategiijaheami	čˈál.lin#strˌɑ.te.gˌij.jɑ»hˌeɑ.mi>
čállinstrategiija+N+Der/heapmi+A+Sg+Ill	čállinstrategiijaheapmái	čˈál.lin#strˌɑ.te.gˌij.jɑ»hˌeɑp.má>i
čállinstrategiija+N+Der/heapmi+A+Pl+Acc	čállinstrategiijahemiid	čˈál.lin#strˌɑ.te.gˌij.jɑ»hˌe.mi>id
čállinstrategiija+N+Der/heapmi+A+Sg+Com	čállinstrategiijahemiin	čˈál.lin#strˌɑ.te.gˌij.jɑ»hˌe.mi>in
čállinstrategiija+N+Der/heapmi+A+Attr	čállinstrategiijahis	čˈál.lin#strˌɑ.te.gˌij.jɑ»his>
čállinstrategiija+N+Der/huhtti+V+TV+Pot+Prs+ConNeg	čállinstrategiijahuhteš	čˈál.lin#strˌɑ.te.gˌij.jɑ»hˌuh.te>ʃ
čállinstrategiija+N+Der/huhtti+V+TV+VAbess	čállinstrategiijahuhtekeahttá	čˈál.lin#strˌɑ.te.gˌij.jɑ»hˌuh.te>kĕɑhː.tá
čállinstrategiija+N+Der/huhtti+V+TV+Ind+Prt+Sg2	čállinstrategiijahuhttet	čˈál.lin#strˌɑ.te.gˌij.jɑ»hˌuhː.te>h
čállinstrategiija+N+Der/huhtti+V+TV+Imprt+Du2	čállinstrategiijahuhtti	čˈál.lin#strˌɑ.te.gˌij.jɑ»hˌuhː.ti>
čállinstrategiija+N+Der/huhtti+V+TV+Ind+Prs+Sg1	čállinstrategiijahuhtán	čˈál.lin#strˌɑ.te.gˌij.jɑ»hˌuhː.tá>n
čállinstrategiija+N+Der/huhtti+V+TV+Sup	čállinstrategiijahuhtážit	čˈál.lin#strˌɑ.te.gˌij.jɑ»hˌuhː.tá>žih
čállinstrategiija+N+Der/huvva+V+IV+VGen	čállinstrategiijahuva	čˈál.lin#strˌɑ.te.gˌij.jɑ»hˌu.vɑ>
čállinstrategiija+N+Der/huvva+V+IV+Imprt+Pl2	čállinstrategiijahuvvet	čˈál.lin#strˌɑ.te.gˌij.jɑ»hˌuv.ve>h
čállinstrategiija+N+Der/huvva+V+IV+Imprt+Du2	čállinstrategiijahuvvi	čˈál.lin#strˌɑ.te.gˌij.jɑ»hˌuv.vi>
čállinstrategiija+N+Der/huvva+V+IV+Imprt+Du1	čállinstrategiijahuvvu	čˈál.lin#strˌɑ.te.gˌij.jɑ»hˌuv.vu>
čállinstrategiija+N+Der/laš+A+Comp+Attr	čállinstrategiijalet	čˈál.lin#strˌɑ.te.gˌij.jɑ»let>
čállinstrategiija+N+Der/laš+A+Comp+Sg+Nom	čállinstrategiijalut	čˈál.lin#strˌɑ.te.gˌij.jɑ»lut>
čállinstrategiija+N+Der/laš+A+Sg+Nom	čállinstrategiijalaš	čˈál.lin#strˌɑ.te.gˌij.jɑ»lɑʃ>
čállinstrategiija+N+Der/laš+A+Der/vuohta+N+Sg+Ill	čállinstrategiijalašvuhtii	čˈál.lin#strˌɑ.te.gˌij.jɑ»lɑʃ»vˌuh.ti>i
čállinstrategiija+N+Der/laš+A+Der/vuohta+N+Der/viđá+Adv	čállinstrategiijalašvuohtaviđá	čˈál.lin#strˌɑ.te.gˌij.jɑ»lɑʃ»vˌuoh.tɑ»vˌi.ðá
čállinstrategiija+N+Sg+Ill	čállinstrategiijii	čˈál.lin#strˌɑ.te.gˌij.ji>i
šibitdoavtterkantuvra+N+Sg+Nom+PxPl3	šibitdoavttergántuvraset	ʃˈiː.bih#dˌŏɑvt.ter#gˌánː.tuv.rɑ>seh
šibitdoavtterkantuvra+N+Sg+Nom+PxSg3	šibitdoavttergántuvras	ʃˈiː.bih#dˌŏɑvt.ter#gˌánː.tuv.rɑ>s
šibitdoavtterkantuvra+N+Ess+PxPl3	šibitdoavttergántuvraneaset	ʃˈiː.bih#dˌŏɑvt.ter#gˌánː.tuv.rɑ>nĕɑ.seh
šibitdoavtterkantuvra+N+Ess+PxSg3	šibitdoavttergántuvranis	ʃˈiː.bih#dˌŏɑvt.ter#gˌánː.tuv.rɑ>nis
šibitdoavtterkantuvra+N+Sg+Nom+PxPl1	šibitdoavttergántuvramet	ʃˈiː.bih#dˌŏɑvt.ter#gˌánː.tuv.rɑ>meh
šibitdoavtterkantuvra+N+Der/huvva+V+IV+Cond+Prs+Pl2	šibitdoavttergántuvrrahuvaleiddet	ʃˈiː.bih#dˌŏɑvt.ter#gˌánː.tuvr.rɑ»hˌu.vɑ>lejd.deh
šibitdoavtterkantuvra+N+Der/huvva+V+IV+Ind+Prs+Du1	šibitdoavttergántuvrrahuvve	ʃˈiː.bih#dˌŏɑvt.ter#gˌánː.tuvr.rɑ»hˌuv.ve>
šibitdoavtterkantuvra+N+Der/laš+A+Sg+Nom	šibitdoavttergántuvrralaš	ʃˈiː.bih#dˌŏɑvt.ter#gˌánː.tuvr.rɑ»lɑʃ>
šibitdoavtterkantuvra+N+Sg+Nom+PxDu3	šibitdoavtterkantuvraska	ʃˈiː.bih#dˌŏɑvt.ter#khˌɑnː.tuv.rɑ>skɑ
šibitdoavtterkantuvra+N+Sg+Nom+PxPl3	šibitdoavtterkantuvraset	ʃˈiː.bih#dˌŏɑvt.ter#khˌɑnː.tuv.rɑ>seh
šibitdoavtterkantuvra+N+Sg+Nom+PxSg3	šibitdoavtterkantuvras	ʃˈiː.bih#dˌŏɑvt.ter#khˌɑnː.tuv.rɑ>s
šibitdoavtterkantuvra+N+Sg+Nom	šibitdoavtterkantuvra	ʃˈiː.bih#dˌŏɑvt.ter#khˌɑnː.tuv.rɑ>
šibitdoavtterkantuvra+N+Sg+Nom+PxDu3	šibitdoavtterkontuvraska	ʃˈiː.bih#dˌŏɑvt.ter#khˌonː.tuv.rɑ>skɑ
šibitdoavtterkantuvra+N+Sg+Nom+PxPl3	šibitdoavtterkontuvraset	ʃˈiː.bih#dˌŏɑvt.ter#khˌonː.tuv.rɑ>seh
šibitdoavtterkantuvra+N+Sg+Nom+PxSg3	šibitdoavtterkontuvras	ʃˈiː.bih#dˌŏɑvt.ter#khˌonː.tuv.rɑ>s
šibitdoavtterkantuvra+N+Sg+Nom	šibitdoavtterkontuvra	ʃˈiː.bih#dˌŏɑvt.ter#khˌonː.tuv.rɑ>
šibitdoavtterkantuvra+N+Ess+PxDu1	šibitdoavtterkantuvraneame	ʃˈiː.bih#dˌŏɑvt.ter#khˌɑnː.tuv.rɑ>nĕɑ.me
šibitdoavtterkantuvra+N+Sg+Gen+PxSg1	šibitdoavtterkantuvran	ʃˈiː.bih#dˌŏɑvt.ter#khˌɑnː.tuv.rɑ>n
šibitdoavtterkantuvra+N+Sg+Ill	šibitdoavtterkantuvrii	ʃˈiː.bih#dˌŏɑvt.ter#khˌɑnː.tuv.ri>i
šibitdoavtterkantuvra+N+Ess+PxDu1	šibitdoavtterkontuvraneame	ʃˈiː.bih#dˌŏɑvt.ter#khˌonː.tuv.rɑ>nĕɑ.me
šibitdoavtterkantuvra+N+Sg+Ill	šibitdoavtterkontuvrii	ʃˈiː.bih#dˌŏɑvt.ter#khˌonː.tuv.ri>i
šibitdoavtterkantuvra+N+Ess	šibitdoavttergántorin	ʃˈiː.bih#dˌŏɑvt.ter#gˌánː.tor>in
šibitdoavtterkantuvra+N+Pl+Nom	šibitdoavttergántorat	ʃˈiː.bih#dˌŏɑvt.ter#gˌánː.tor>ɑh
šibitdoavtterkantuvra+N+Sg+Gen	šibitdoavttergántora	ʃˈiː.bih#dˌŏɑvt.ter#gˌánː.tor>ɑ
šibitdoavtterkantuvra+N+Pl+Gen	šibitdoavttergántoriid	ʃˈiː.bih#dˌŏɑvt.ter#gˌánː.tor>ijh
šibitdoavtterkantuvra+N+Pl+Ill+PxPl2	šibitdoavttergántoriiddáseattet	ʃˈiː.bih#dˌŏɑvt.ter#gˌánː.tor>ijd.dá.sĕɑt.teh
šibitdoavtterkantuvra+N+Der/Dimin+N+Pl+Nom	šibitdoavttergántoraččat	ʃˈiː.bih#dˌŏɑvt.ter#gˌánː.tor»ˌɑč.čɑ>h
šibitdoavtterkantuvra+N+Der/viđá+Adv	šibitdoavttergántorviđá	ʃˈiː.bih#dˌŏɑvt.ter#gˌánː.tor»vˌi.ðá
šibitdoavtterkantuvra+N+Ess	šibitdoavttergánttorin	ʃˈiː.bih#dˌŏɑvt.ter#gˌánt.tor>in
šibitdoavtterkantuvra+N+Sg+Nom+PxSg2	šibitdoavttergánttorat	ʃˈiː.bih#dˌŏɑvt.ter#gˌánt.tor>ɑh
šibitdoavtterkantuvra+N+Der/heapmi+A+Sg+Com	šibitdoavttergánttorhemiin	ʃˈiː.bih#dˌŏɑvt.ter#gˌánt.tor»hˌe.mi>in
šibitdoavtterkantuvra+N+Der/laš+A+AttrCmp+Der/bealjat+A+Sg+Nom	šibitdoavttergánttorlašbealjat	ʃˈiː.bih#dˌŏɑvt.ter#gˌánt.tor»lɑʃ>»bˌeɑl.jɑh
šibitdoavtterkantuvra+N+Der/viđá+Adv	šibitdoavttergánttorviđá	ʃˈiː.bih#dˌŏɑvt.ter#gˌánt.tor»vˌi.ðá
šibitdoavtterkantuvra+N+Sg+Gen+PxDu1	šibitdoavtterkontoreame	ʃˈiː.bih#dˌŏɑvt.ter#khˌonː.tor>ĕɑ.me
šibitdoavtterkantuvra+N+Der/viđá+Adv	šibitdoavtterkontorviđá	ʃˈiː.bih#dˌŏɑvt.ter#khˌonː.tor»vˌi.ðá
šibitdoavtterkantuvra+N+Ess	šibitdoavtterkonttorin	ʃˈiː.bih#dˌŏɑvt.ter#khˌont.tor>in
šibitdoavtterkantuvra+N+Sg+Acc+PxDu3	šibitdoavtterkonttoreaskka	ʃˈiː.bih#dˌŏɑvt.ter#khˌont.tor>eɑs.kɑ
šibitdoavtterkantuvra+N+Der/Dimin+N+Der/Dimin+N+Der/viđá+Adv	šibitdoavtterkonttoraččašviđá	ʃˈiː.bih#dˌŏɑvt.ter#khˌont.tor»ˌɑč.čɑ»ʃ»vˌi.ðá
šibitdoavtterkantuvra+N+Der/Dimin+N+Sg+Acc+PxPl2	šibitdoavtterkonttoraččadet	ʃˈiː.bih#dˌŏɑvt.ter#khˌont.tor»ˌɑč.čɑ>deh
šibitdoavtterkantuvra+N+Der/Dimin+N+Sg+Nom	šibitdoavtterkonttoraš	ʃˈiː.bih#dˌŏɑvt.ter#khˌont.tor»ɑʃ>
šibitdoavtterkantuvra+N+Der/Dimin+N+Sg+Ill	šibitdoavtterkonttoražžii	ʃˈiː.bih#dˌŏɑvt.ter#khˌont.tor»ˌɑž.ži>i
šibitdoavtterkantuvra+N+Der/heapmi+A+Ess	šibitdoavtterkonttorheapmin	ʃˈiː.bih#dˌŏɑvt.ter#khˌont.tor»hˌeɑp.mi>n
šibitdoavtterkantuvra+N+Der/heapmi+A+Attr	šibitdoavtterkonttorhis	ʃˈiː.bih#dˌŏɑvt.ter#khˌont.tor»his>
šibitdoavtterkantuvra+N+Der/viđá+Adv	šibitdoavtterkonttorviđá	ʃˈiː.bih#dˌŏɑvt.ter#khˌont.tor»vˌi.ðá
šiehtadallanstrategiija+N+Ess+PxSg3	šiehtadallanstrategiijanis	ʃˈieh.tɑ.ðˌɑl.lɑn#strˌɑ.te.gˌij.jɑ>nis
šiehtadallanstrategiija+N+Pl+Acc+PxDu1	šiehtadallanstrategiijaideame	ʃˈieh.tɑ.ðˌɑl.lɑn#strˌɑ.te.gˌij.jɑ>i.dĕɑ.me
šiehtadallanstrategiija+N+Pl+Acc+PxDu3	šiehtadallanstrategiijaideaskka	ʃˈieh.tɑ.ðˌɑl.lɑn#strˌɑ.te.gˌij.jɑ>i.deɑs.kɑ
šiehtadallanstrategiija+N+Pl+Acc+PxPl2	šiehtadallanstrategiijaideattet	ʃˈieh.tɑ.ðˌɑl.lɑn#strˌɑ.te.gˌij.jɑ>i.dĕɑt.teh
šiehtadallanstrategiija+N+Pl+Loc+PxSg1	šiehtadallanstrategiijainan	ʃˈieh.tɑ.ðˌɑl.lɑn#strˌɑ.te.gˌij.jɑ>i.nɑn
šiehtadallanstrategiija+N+Pl+Nom+PxPl1	šiehtadallanstrategiijaideamet	ʃˈieh.tɑ.ðˌɑl.lɑn#strˌɑ.te.gˌij.jɑ>i.dĕɑ.meh
šiehtadallanstrategiija+N+Pl+Nom+PxPl2	šiehtadallanstrategiijaideattet	ʃˈieh.tɑ.ðˌɑl.lɑn#strˌɑ.te.gˌij.jɑ>i.dĕɑt.teh
šiehtadallanstrategiija+N+Pl+Nom	šiehtadallanstrategiijat	ʃˈieh.tɑ.ðˌɑl.lɑn#strˌɑ.te.gˌij.jɑ>h
šiehtadallanstrategiija+N+Sg+Acc+PxDu2	šiehtadallanstrategiijade	ʃˈieh.tɑ.ðˌɑl.lɑn#strˌɑ.te.gˌij.jɑ>de
šiehtadallanstrategiija+N+Sg+Gen+PxDu2	šiehtadallanstrategiijade	ʃˈieh.tɑ.ðˌɑl.lɑn#strˌɑ.te.gˌij.jɑ>de
šiehtadallanstrategiija+N+Sg+Com+PxDu1	šiehtadallanstrategiijaineame	ʃˈieh.tɑ.ðˌɑl.lɑn#strˌɑ.te.gˌij.jɑ>i.nĕɑ.me
šiehtadallanstrategiija+N+Sg+Com+PxSg1	šiehtadallanstrategiijainan	ʃˈieh.tɑ.ðˌɑl.lɑn#strˌɑ.te.gˌij.jɑ>i.nɑn
šiehtadallanstrategiija+N+Sg+Ill	šiehtadallanstrategiijai	ʃˈieh.tɑ.ðˌɑl.lɑn#strˌɑ.te.gˌij.jɑ>i
šiehtadallanstrategiija+N+Der/viđá+Adv	šiehtadallanstrategiijaviđá	ʃˈieh.tɑ.ðˌɑl.lɑn#strˌɑ.te.gˌij.jɑ>»vˌi.ðá
šiehtadallanstrategiija+N+Der/Dimin+N+Der/viđá+Adv	šiehtadallanstrategiijašviđá	ʃˈieh.tɑ.ðˌɑl.lɑn#strˌɑ.te.gˌij.jɑ»ʃ»vˌi.ðá
šiehtadallanstrategiija+N+Der/Dimin+N+Sg+Nom+PxSg1	šiehtadallanstrategiijažan	ʃˈieh.tɑ.ðˌɑl.lɑn#strˌɑ.te.gˌij.jɑ»žɑn
šiehtadallanstrategiija+N+Der/Dimin+N+Sg+Gen	šiehtadallanstrategiijaža	ʃˈieh.tɑ.ðˌɑl.lɑn#strˌɑ.te.gˌij.jɑ»žɑ
šiehtadallanstrategiija+N+Der/heapmi+A+Comp+Attr	šiehtadallanstrategiijahut	ʃˈieh.tɑ.ðˌɑl.lɑn#strˌɑ.te.gˌij.jɑ»hut>
šiehtadallanstrategiija+N+Der/heapmi+A+Comp+Sg+Nom	šiehtadallanstrategiijahut	ʃˈieh.tɑ.ðˌɑl.lɑn#strˌɑ.te.gˌij.jɑ»hut>
šiehtadallanstrategiija+N+Der/heapmi+A+Attr	šiehtadallanstrategiijahis	ʃˈieh.tɑ.ðˌɑl.lɑn#strˌɑ.te.gˌij.jɑ»his>
šiehtadallanstrategiija+N+Der/huhtti+V+TV+Der/NomAg+N+Pl+Nom	šiehtadallanstrategiijahuhttit	ʃˈieh.tɑ.ðˌɑl.lɑn#strˌɑ.te.gˌij.jɑ»hˌuhː.ti>»h
šiehtadallanstrategiija+N+Der/huhtti+V+TV+Cond+Prs+Pl3	šiehtadallanstrategiijahuhtále	ʃˈieh.tɑ.ðˌɑl.lɑn#strˌɑ.te.gˌij.jɑ»hˌuhː.tá>le
šiehtadallanstrategiija+N+Der/huvva+V+IV+Cond+Prs+Du3	šiehtadallanstrategiijahuvašeigga	ʃˈieh.tɑ.ðˌɑl.lɑn#strˌɑ.te.gˌij.jɑ»hˌu.vɑ>ʃejg.gɑ
šiehtadallanstrategiija+N+Der/huvva+V+IV+Ind+Prt+Pl2	šiehtadallanstrategiijahuvaidet	ʃˈieh.tɑ.ðˌɑl.lɑn#strˌɑ.te.gˌij.jɑ»hˌu.vɑ>i.deh
šiehtadallanstrategiija+N+Der/huvva+V+IV+VAbess+A+Attr	šiehtadallanstrategiijahuvakeahtes	ʃˈieh.tɑ.ðˌɑl.lɑn#strˌɑ.te.gˌij.jɑ»hˌu.vɑ>kĕɑh.tes
šiehtadallanstrategiija+N+Der/huvva+V+IV+PrfPrc	šiehtadallanstrategiijahuvvan	ʃˈieh.tɑ.ðˌɑl.lɑn#strˌɑ.te.gˌij.jɑ»hˌuv.vɑ>n
šiehtadallanstrategiija+N+Der/laš+A+Comp+Sg+Nom	šiehtadallanstrategiijalit	ʃˈieh.tɑ.ðˌɑl.lɑn#strˌɑ.te.gˌij.jɑ»lit>
šiehtadallanstrategiija+N+Der/laš+A+Ess	šiehtadallanstrategiijalažžan	ʃˈieh.tɑ.ðˌɑl.lɑn#strˌɑ.te.gˌij.jɑ»lˌɑž.žɑ>n
šiehtadallanstrategiija+N+Sg+Ill	šiehtadallanstrategiijii	ʃˈieh.tɑ.ðˌɑl.lɑn#strˌɑ.te.gˌij.ji>i
