Aaiún+N+Prop+Sg+Acc	Aaiún	ˈɑː.iún>
Aaiún+N+Prop+Sg+Nom	Aaiún	ˈɑː.iún>
Aaiún+N+Prop+Sg+Com	Aaiúnain	ˈɑː.iún>ɑjn
Aaiún+N+Prop+Sg+Ill	Aaiúnii	ˈɑː.iún>ij
Aaiún+N+Prop+Der/laš+A+Pl+Acc+PxSg2	Aaiúnalaččaidat	ˈɑː.iún>ɑ.lɑt.tʃɑj.dɑh
Aaiún+N+Prop+Der/laš+A+Pl+Nom	Aaiúnalaččat	ˈɑː.iún>ɑ.lɑt.tʃɑh
Aaiún+N+Prop+Der/laš+A+Attr+Der/vuohta+N+Sg+Ill	Aaiúnalašvuhtii	ˈɑː.iún>ɑ.lɑʃ»vˌuh.tij
Aaiún+N+Prop+Der/laš+A+AttrCmp+Der/asat+A+Pl+Nom	Aaiúnalašasagat	ˈɑː.iún>ɑ.lɑʃ»ˌɑ.sɑ.gɑh
Aaiún+N+Prop+Der/laš+A+AttrCmp+Der/liikkat+A+Attr	Aaiúnalašliikkat	ˈɑː.iún>ɑ.lɑʃ»lˌijhk.kɑh
Aaiún+N+Prop+Der/laš+A+Sg+Gen+PxSg1	Aaiúnalažžan	ˈɑː.iún>ɑ.lɑdː.tʃɑn
Aaiún+N+Prop+Der/laš+A+Ess+PxSg1	Aaiúnalažžanan	ˈɑː.iún>ɑ.lɑdː.tʃɑ.nɑn
Aaiún+N+Prop+Der/laš+A+Ess+PxSg2	Aaiúnalažžanat	ˈɑː.iún>ɑ.lɑdː.tʃɑ.nɑh
Aaiún+N+Prop+Der/laš+A+Sg+Ill	Aaiúnalažžii	ˈɑː.iún>ɑ.lɑdː.tʃij
Apple+N+Prop+Ess	Applen	ˈɑpː.le>n
Apple+N+Prop+Sg+Acc	Apple	ˈɑpː.le>
Apple+N+Prop+Sg+Gen	Apple	ˈɑpː.le>
Apple+N+Prop+Sg+Nom	Apple	ˈɑpː.le>
Apple+N+Prop+Sg+Loc	Apples	ˈɑpː.le>s
Apple+N+Prop+Sg+Com	Appliin	ˈɑpː.li>in
Apple+N+Prop+Sg+Ill	Applii	ˈɑpː.li>i
Ayrshire+N+Prop+Sg+Nom	Ayrshire	ˈɑyr#shˌi.re>
Ayrshire+N+Prop+Sg+Loc	Ayrshires	ˈɑyr#shˌi.re>s
Ayrshire+N+Prop+Der/laš+A+Pl+Com+PxDu2	Ayrshirelaččaideatteguin	ˈɑyr#shˌi.re>lɑt.tʃɑj.dĕæt.te.gujn
Ayrshire+N+Prop+Der/laš+A+Pl+Loc	Ayrshirelaččain	ˈɑyr#shˌi.re>lɑt.tʃɑjn
Ayrshire+N+Prop+Der/laš+A+Sg+Gen+PxSg3	Ayrshirelaččas	ˈɑyr#shˌi.re>lɑt.tʃɑs
Ayrshire+N+Prop+Der/laš+A+Attr+Der/vuohta+N+Der/viđá+Adv	Ayrshirelašvuohtaviđá	ˈɑyr#shˌi.re>lɑʃ»vˌuoh.tɑ»vˌi.ðɑː
Ayrshire+N+Prop+Der/laš+A+Ess+PxSg2	Ayrshirelažžanat	ˈɑyr#shˌi.re>lɑdː.tʃɑ.nɑh
Ayrshire+N+Prop+Sg+Com	Ayrshiriin	ˈɑyr#shˌi.ri>in
Ayrshire+N+Prop+Sg+Ill	Ayrshirii	ˈɑyr#shˌi.ri>i
Buckinghamshire+N+Prop+Ess	Buckinghanshiren	pˈuts.king.hɑn#shˌi.re>n
Buckinghamshire+N+Prop+Sg+Acc	Buckinghanshire	pˈuts.king.hɑn#shˌi.re>
Buckinghamshire+N+Prop+Sg+Gen	Buckinghanshire	pˈuts.king.hɑn#shˌi.re>
Buckinghamshire+N+Prop+Sg+Nom	Buckinghanshire	pˈuts.king.hɑn#shˌi.re>
Buckinghamshire+N+Prop+Sg+Loc	Buckinghanshires	pˈuts.king.hɑn#shˌi.re>s
Buckinghamshire+N+Prop+Der/laš+A+Pl+Acc+PxSg2	Buckinghanshirelaččaidat	pˈuts.king.hɑn#shˌi.re>lɑt.tʃɑj.dɑh
Buckinghamshire+N+Prop+Der/laš+A+Pl+Gen	Buckinghanshirelaččaid	pˈuts.king.hɑn#shˌi.re>lɑt.tʃɑjh
Buckinghamshire+N+Prop+Der/laš+A+Sg+Com+PxSg2	Buckinghanshirelaččainat	pˈuts.king.hɑn#shˌi.re>lɑt.tʃɑj.nɑh
Buckinghamshire+N+Prop+Der/laš+A+Sg+Gen	Buckinghanshirelačča	pˈuts.king.hɑn#shˌi.re>lɑt.tʃɑ
Buckinghamshire+N+Prop+Der/laš+A+Sg+Loc	Buckinghanshirelaččas	pˈuts.king.hɑn#shˌi.re>lɑt.tʃɑs
Buckinghamshire+N+Prop+Der/laš+A+AttrCmp+Der/šlájat+A+Attr	Buckinghanshirelaššlájat	pˈuts.king.hɑn#shˌi.re>lɑʃ»ʃlˌɑː.jɑh
Buckinghamshire+N+Prop+Der/laš+A+Sg+Nom	Buckinghanshirelaš	pˈuts.king.hɑn#shˌi.re>lɑʃ
Buckinghamshire+N+Prop+Der/laš+A+Sg+Acc+PxPl1	Buckinghanshirelažžamet	pˈuts.king.hɑn#shˌi.re>lɑdː.tʃɑ.meh
Buckinghamshire+N+Prop+Der/laš+A+Sg+Gen+PxPl1	Buckinghanshirelažžamet	pˈuts.king.hɑn#shˌi.re>lɑdː.tʃɑ.meh
Buckinghamshire+N+Prop+Der/laš+A+Ess+PxDu3	Buckinghanshirelažžaneaskka	pˈuts.king.hɑn#shˌi.re>lɑdː.tʃɑ.neæs.kɑ
Buckinghamshire+N+Prop+Der/laš+A+Sg+Ill	Buckinghanshirelažžii	pˈuts.king.hɑn#shˌi.re>lɑdː.tʃij
Buckinghamshire+N+Prop+Sg+Com	Buckinghanshiriin	pˈuts.king.hɑn#shˌi.ri>in
Buckinghamshire+N+Prop+Sg+Ill	Buckinghanshirii	pˈuts.king.hɑn#shˌi.ri>i
Chattanooga+N+Prop+Ess	Chattanoogan	tshˈɑtː.tɑː.nˌo.o.gɑ>n
Chattanooga+N+Prop+Sg+Gen	Chattanooga	tshˈɑtː.tɑː.nˌo.o.gɑ>
Chattanooga+N+Prop+Sg+Nom	Chattanooga	tshˈɑtː.tɑː.nˌo.o.gɑ>
Chattanooga+N+Prop+Sg+Com	Chattanoogain	tshˈɑtː.tɑː.nˌo.o.gɑ>in
Chattanooga+N+Prop+Sg+Ill	Chattanoogai	tshˈɑtː.tɑː.nˌo.o.gɑ>i
Chattanooga+N+Prop+Sg+Loc	Chattanoogas	tshˈɑtː.tɑː.nˌo.o.gɑ>s
Chattanooga+N+Prop+Der/laš+A+Pl+Com	Chattanoogalaččaiguin	tshˈɑtː.tɑː.nˌo.o.gɑ>lɑt.tʃɑj.gujn
Chattanooga+N+Prop+Der/laš+A+Attr	Chattanoogalaš	tshˈɑtː.tɑː.nˌo.o.gɑ>lɑʃ
Chattanooga+N+Prop+Der/laš+A+Attr+Der/vuohta+N+Sg+Ill	Chattanoogalašvuhtii	tshˈɑtː.tɑː.nˌo.o.gɑ>lɑʃ»vˌuh.tij
Chattanooga+N+Prop+Der/laš+A+AttrCmp+Der/girjjat+A+Sg+Acc	Chattanoogalašgirjjaga	tshˈɑtː.tɑː.nˌo.o.gɑ>lɑʃ»gˌirj.jɑ.gɑ
Chattanooga+N+Prop+Der/laš+A+AttrCmp+Der/šlájat+A+Pl+Nom	Chattanoogalaššlájagat	tshˈɑtː.tɑː.nˌo.o.gɑ>lɑʃ»ʃlˌɑː.jɑ.gɑh
Chattanooga+N+Prop+Der/laš+A+Sg+Nom	Chattanoogalaš	tshˈɑtː.tɑː.nˌo.o.gɑ>lɑʃ
Chattanooga+N+Prop+Der/laš+A+Sg+Acc+PxDu1	Chattanoogalažžame	tshˈɑtː.tɑː.nˌo.o.gɑ>lɑdː.tʃɑ.me
Chattanooga+N+Prop+Der/laš+A+Ess+PxDu1	Chattanoogalažžaneame	tshˈɑtː.tɑː.nˌo.o.gɑ>lɑdː.tʃɑ.nĕæ.me
Chattanooga+N+Prop+Der/laš+A+Ess+PxPl3	Chattanoogalažžaneaset	tshˈɑtː.tɑː.nˌo.o.gɑ>lɑdː.tʃɑ.nĕæ.seh
Chattanooga+N+Prop+Der/laš+A+Sg+Ill	Chattanoogalažžii	tshˈɑtː.tɑː.nˌo.o.gɑ>lɑdː.tʃij
Cyaneed+N+Prop+Ess	Cyaneedan	tsˈy.ɑ.nˌe.ed>ɑn
Cyaneed+N+Prop+Sg+Acc	Cyaneed	tsˈy.ɑ.nˌe.ed>
Cyaneed+N+Prop+Sg+Gen	Cyaneed	tsˈy.ɑ.nˌe.ed>
Cyaneed+N+Prop+Sg+Nom	Cyaneed	tsˈy.ɑ.nˌe.ed>
Cyaneed+N+Prop+Sg+Acc	Cyaneeda	tsˈy.ɑ.nˌe.ed>ɑ
Cyaneed+N+Prop+Sg+Com	Cyaneedain	tsˈy.ɑ.nˌe.ed>ɑjn
Cyaneed+N+Prop+Sg+Loc	Cyaneedas	tsˈy.ɑ.nˌe.ed>ɑs
Cyaneed+N+Prop+Sg+Ill	Cyaneedii	tsˈy.ɑ.nˌe.ed>ij
Dorsetshire+N+Prop+Ess	Dorsetshiren	tˈorə.seh#shˌi.re>n
Dorsetshire+N+Prop+Sg+Acc	Dorsetshire	tˈorə.seh#shˌi.re>
Dorsetshire+N+Prop+Sg+Gen	Dorsetshire	tˈorə.seh#shˌi.re>
Dorsetshire+N+Prop+Sg+Nom	Dorsetshire	tˈorə.seh#shˌi.re>
Dorsetshire+N+Prop+Sg+Loc	Dorsetshires	tˈorə.seh#shˌi.re>s
Dorsetshire+N+Prop+Der/laš+A+Pl+Acc	Dorsetshirelaččaid	tˈorə.seh#shˌi.re>lɑt.tʃɑjh
Dorsetshire+N+Prop+Der/laš+A+Pl+Com	Dorsetshirelaččaiguin	tˈorə.seh#shˌi.re>lɑt.tʃɑj.gujn
Dorsetshire+N+Prop+Der/laš+A+Pl+Loc+PxSg2	Dorsetshirelaččainat	tˈorə.seh#shˌi.re>lɑt.tʃɑj.nɑh
Dorsetshire+N+Prop+Der/laš+A+Sg+Acc+PxPl2	Dorsetshirelaččadet	tˈorə.seh#shˌi.re>lɑt.tʃɑ.deh
Dorsetshire+N+Prop+Der/laš+A+Sg+Gen+PxPl2	Dorsetshirelaččadet	tˈorə.seh#shˌi.re>lɑt.tʃɑ.deh
Dorsetshire+N+Prop+Der/laš+A+Attr	Dorsetshirelaš	tˈorə.seh#shˌi.re>lɑʃ
Dorsetshire+N+Prop+Der/laš+A+AttrCmp+Der/šlájat+A+Pl+Acc	Dorsetshirelaššlájagiid	tˈorə.seh#shˌi.re>lɑʃ»ʃlˌɑː.jɑ.gijh
Dorsetshire+N+Prop+Der/laš+A+Sg+Nom	Dorsetshirelaš	tˈorə.seh#shˌi.re>lɑʃ
Dorsetshire+N+Prop+Der/laš+A+Sg+Ill+PxDu2	Dorsetshirelažžaseatte	tˈorə.seh#shˌi.re>lɑdː.tʃɑ.sĕæt.te
Dorsetshire+N+Prop+Der/laš+A+Sg+Ill+PxSg3	Dorsetshirelažžasis	tˈorə.seh#shˌi.re>lɑdː.tʃɑ.sis
Dorsetshire+N+Prop+Der/laš+A+Ess+PxPl1	Dorsetshirelažžaneamet	tˈorə.seh#shˌi.re>lɑdː.tʃɑ.nĕæ.meh
Dorsetshire+N+Prop+Der/laš+A+Ess+PxSg3	Dorsetshirelažžanis	tˈorə.seh#shˌi.re>lɑdː.tʃɑ.nis
Dorsetshire+N+Prop+Der/laš+A+Ess	Dorsetshirelažžan	tˈorə.seh#shˌi.re>lɑdː.tʃɑn
Dorsetshire+N+Prop+Der/laš+A+Sg+Ill	Dorsetshirelažžii	tˈorə.seh#shˌi.re>lɑdː.tʃij
Dorsetshire+N+Prop+Sg+Com	Dorsetshiriin	tˈorə.seh#shˌi.ri>in
Dorsetshire+N+Prop+Sg+Ill	Dorsetshirii	tˈorə.seh#shˌi.ri>i
Gateshead+N+Prop+Sg+Acc	Gateshead	kˈɑ.tes.heæd>
Gateshead+N+Prop+Sg+Loc	Gatesheadas	kˈɑ.tes.heæd>ɑs
Gateshead+N+Prop+Sg+Ill	Gatesheadii	kˈɑ.tes.heæd>ij
Gateshead+N+Prop+Der/laš+A+Pl+Acc+PxDu1	Gatesheadalaččaideame	kˈɑ.tes.heæd>ɑ.lɑt.tʃɑj.dĕæ.me
Gateshead+N+Prop+Der/laš+A+Pl+Nom+PxDu1	Gatesheadalaččaideame	kˈɑ.tes.heæd>ɑ.lɑt.tʃɑj.dĕæ.me
Gateshead+N+Prop+Der/laš+A+Sg+Loc	Gatesheadalaččas	kˈɑ.tes.heæd>ɑ.lɑt.tʃɑs
Gateshead+N+Prop+Der/laš+A+Sg+Loc+PxPl2	Gatesheadalaččasteattet	kˈɑ.tes.heæd>ɑ.lɑt.tʃɑs.tĕæt.teh
Gateshead+N+Prop+Der/laš+A+Attr+Der/vuohta+N+Ess+PxPl2	Gatesheadalašvuohtaneattet	kˈɑ.tes.heæd>ɑ.lɑʃ»vˌuoh.tɑ.nˌĕæt.teh
Gateshead+N+Prop+Der/laš+A+AttrCmp+Der/nierat+A+Sg+Loc	Gatesheadalašnieragis	kˈɑ.tes.heæd>ɑ.lɑʃ»nˌie.rɑ.gis
Gateshead+N+Prop+Der/laš+A+Sg+Nom	Gatesheadalaš	kˈɑ.tes.heæd>ɑ.lɑʃ
Gateshead+N+Prop+Der/laš+A+Sg+Ill	Gatesheadalažžii	kˈɑ.tes.heæd>ɑ.lɑdː.tʃij
Gilead+N+Prop+Sem/Mal+Ess	Gileadin	kˈi.leæd>in
Gilead+N+Prop+Sem/Mal+Pl+Nom	Gileadat	kˈi.leæd>ɑh
Gilead+N+Prop+Sem/Mal+Pl+Com	Gileadiiguin	kˈi.leæd>ij.gujn
Gilead+N+Prop+Sem/Mal+Sg+Gen	Gileada	kˈi.leæd>ɑ
Gilead+N+Prop+Sem/Mal+Attr	Gilead	kˈi.leæd>
Gislaved+N+Prop+Sg+Com	Gislavedain	kˈis.lɑː.ved>ɑjn
Gislaved+N+Prop+Sg+Ill	Gislavedii	kˈis.lɑː.ved>ij
Gislaved+N+Prop+Der/laš+A+Pl+Com+PxDu1	Gislavedalaččaideameguin	kˈis.lɑː.ved>ɑ.lɑt.tʃɑj.dĕæ.me.gujn
Gislaved+N+Prop+Der/laš+A+Sg+Nom	Gislavedalaš	kˈis.lɑː.ved>ɑ.lɑʃ
Gloucerstershire+N+Prop+Ess	Gloucerstershiren	glˈou.tserə.ster#shˌi.re>n
Gloucerstershire+N+Prop+Sg+Acc	Gloucerstershire	glˈou.tserə.ster#shˌi.re>
Gloucerstershire+N+Prop+Sg+Nom	Gloucerstershire	glˈou.tserə.ster#shˌi.re>
Gloucerstershire+N+Prop+Der/laš+A+Pl+Nom	Gloucerstershirelaččat	glˈou.tserə.ster#shˌi.re>lɑt.tʃɑh
Gloucerstershire+N+Prop+Der/laš+A+Sg+Com+PxSg1	Gloucerstershirelaččainan	glˈou.tserə.ster#shˌi.re>lɑt.tʃɑj.nɑn
Gloucerstershire+N+Prop+Der/laš+A+Sg+Gen+PxSg1	Gloucerstershirelažžan	glˈou.tserə.ster#shˌi.re>lɑdː.tʃɑn
Gloucerstershire+N+Prop+Der/laš+A+Sg+Nom+PxPl2	Gloucerstershirelažžadet	glˈou.tserə.ster#shˌi.re>lɑdː.tʃɑ.deh
Gloucerstershire+N+Prop+Sg+Com	Gloucerstershiriin	glˈou.tserə.ster#shˌi.ri>in
Gloucerstershire+N+Prop+Sg+Ill	Gloucerstershirii	glˈou.tserə.ster#shˌi.ri>i
Grinstead+N+Prop+Ess	Grinsteadan	grˈinː.steæd>ɑn
Grinstead+N+Prop+Sg+Nom	Grinstead	grˈinː.steæd>
Grinstead+N+Prop+Sg+Acc	Grinsteada	grˈinː.steæd>ɑ
Grinstead+N+Prop+Sg+Gen	Grinsteada	grˈinː.steæd>ɑ
Grinstead+N+Prop+Sg+Ill	Grinsteadii	grˈinː.steæd>ij
Grinstead+N+Prop+Der/laš+A+Pl+Acc+PxPl2	Grinsteadalaččaideattet	grˈinː.steæd>ɑ.lɑt.tʃɑj.dĕæt.teh
Grinstead+N+Prop+Der/laš+A+Pl+Acc	Grinsteadalaččaid	grˈinː.steæd>ɑ.lɑt.tʃɑjh
Grinstead+N+Prop+Der/laš+A+Pl+Loc+PxSg3	Grinsteadalaččainis	grˈinː.steæd>ɑ.lɑt.tʃɑj.nis
Grinstead+N+Prop+Der/laš+A+Pl+Nom+PxDu1	Grinsteadalaččaideame	grˈinː.steæd>ɑ.lɑt.tʃɑj.dĕæ.me
Grinstead+N+Prop+Der/laš+A+Sg+Acc	Grinsteadalačča	grˈinː.steæd>ɑ.lɑt.tʃɑ
Grinstead+N+Prop+Der/laš+A+Sg+Com+PxPl2	Grinsteadalaččaineattet	grˈinː.steæd>ɑ.lɑt.tʃɑj.nĕæt.teh
Grinstead+N+Prop+Der/laš+A+Sg+Loc	Grinsteadalaččas	grˈinː.steæd>ɑ.lɑt.tʃɑs
Grinstead+N+Prop+Der/laš+A+Sg+Nom	Grinsteadalaš	grˈinː.steæd>ɑ.lɑʃ
Grinstead+N+Prop+Der/laš+A+Sg+Nom+PxSg2	Grinsteadalažžat	grˈinː.steæd>ɑ.lɑdː.tʃɑh
Hampshire+N+Prop+Sg+Acc	Hampshire	hˈɑmp#shˌi.re>
Hampshire+N+Prop+Sg+Gen	Hampshire	hˈɑmp#shˌi.re>
Hampshire+N+Prop+Sg+Loc	Hampshires	hˈɑmp#shˌi.re>s
Hampshire+N+Prop+Der/laš+A+Pl+Acc+PxSg1	Hampshirelaččaidan	hˈɑmp#shˌi.re>lɑt.tʃɑj.dɑn
Hampshire+N+Prop+Der/laš+A+Sg+Gen+PxPl2	Hampshirelaččadet	hˈɑmp#shˌi.re>lɑt.tʃɑ.deh
Hampshire+N+Prop+Der/laš+A+Attr	Hampshirelaš	hˈɑmp#shˌi.re>lɑʃ
Hampshire+N+Prop+Der/laš+A+Sg+Nom	Hampshirelaš	hˈɑmp#shˌi.re>lɑʃ
Hampshire+N+Prop+Der/laš+A+Sg+Gen+PxPl1	Hampshirelažžamet	hˈɑmp#shˌi.re>lɑdː.tʃɑ.meh
Hampshire+N+Prop+Der/laš+A+Ess+PxPl2	Hampshirelažžaneattet	hˈɑmp#shˌi.re>lɑdː.tʃɑ.nĕæt.teh
Hampshire+N+Prop+Der/laš+A+Sg+Ill	Hampshirelažžii	hˈɑmp#shˌi.re>lɑdː.tʃij
Hampshire+N+Prop+Sg+Com	Hampshiriin	hˈɑmp#shˌi.ri>in
Hampshire+N+Prop+Sg+Ill	Hampshirii	hˈɑmp#shˌi.ri>i
Head+N+Prop+Sem/Sur+Ess	Headan	hˈeæd>ɑn
Head+N+Prop+Sem/Sur+Pl+Acc	Headaid	hˈeæd>ɑjh
Head+N+Prop+Sem/Sur+Pl+Ill	Headaide	hˈeæd>ɑj.de
Head+N+Prop+Sem/Sur+Sg+Gen	Head	hˈeæd>
Head+N+Prop+Sem/Sur+Sg+Nom	Head	hˈeæd>
Head+N+Prop+Sem/Sur+Sg+Com	Headain	hˈeæd>ɑjn
Head+N+Prop+Sem/Sur+Sg+Gen	Heada	hˈeæd>ɑ
Head+N+Prop+Sem/Sur+Sg+Ill	Headii	hˈeæd>ij
Herefordshire+N+Prop+Ess	Hereforshiren	hˈe.re.for#shˌi.re>n
Herefordshire+N+Prop+Sg+Gen	Hereforshire	hˈe.re.for#shˌi.re>
Herefordshire+N+Prop+Sg+Nom	Hereforshire	hˈe.re.for#shˌi.re>
Herefordshire+N+Prop+Der/laš+A+Attr+Der/vuohta+N+Pl+Nom	Hereforshirelašvuođat	hˈe.re.for#shˌi.re>lɑʃ»vˌuo.ðɑh
Herefordshire+N+Prop+Der/laš+A+Sg+Nom+PxSg3	Hereforshirelažžas	hˈe.re.for#shˌi.re>lɑdː.tʃɑs
Herefordshire+N+Prop+Sg+Com	Hereforshiriin	hˈe.re.for#shˌi.ri>in
Herefordshire+N+Prop+Sg+Ill	Hereforshirii	hˈe.re.for#shˌi.ri>i
Hertfordshire+N+Prop+Sg+Loc	Hertforshires	hˈert.for#shˌi.re>s
Hertfordshire+N+Prop+Der/laš+A+Pl+Nom	Hertforshirelaččat	hˈert.for#shˌi.re>lɑt.tʃɑh
Hertfordshire+N+Prop+Der/laš+A+Sg+Ill+PxDu3	Hertforshirelažžaseaskka	hˈert.for#shˌi.re>lɑdː.tʃɑ.seæs.kɑ
Hertfordshire+N+Prop+Sg+Com	Hertforshiriin	hˈert.for#shˌi.ri>in
Hertfordshire+N+Prop+Sg+Ill	Hertforshirii	hˈert.for#shˌi.ri>i
Lancashire+N+Prop+Ess	Lancashiren	lˈɑnː.n̥tsɑ#shˌi.re>n
Lancashire+N+Prop+Sg+Acc	Lancashire	lˈɑnː.n̥tsɑ#shˌi.re>
Lancashire+N+Prop+Sg+Gen	Lancashire	lˈɑnː.n̥tsɑ#shˌi.re>
Lancashire+N+Prop+Sg+Nom	Lancashire	lˈɑnː.n̥tsɑ#shˌi.re>
Lancashire+N+Prop+Sg+Loc	Lancashires	lˈɑnː.n̥tsɑ#shˌi.re>s
Lancashire+N+Prop+Der/laš+A+Pl+Com	Lancashirelaččaiguin	lˈɑnː.n̥tsɑ#shˌi.re>lɑt.tʃɑj.gujn
Lancashire+N+Prop+Der/laš+A+Pl+Nom+PxSg1	Lancashirelaččaidan	lˈɑnː.n̥tsɑ#shˌi.re>lɑt.tʃɑj.dɑn
Lancashire+N+Prop+Der/laš+A+Sg+Com+PxPl2	Lancashirelaččaineattet	lˈɑnː.n̥tsɑ#shˌi.re>lɑt.tʃɑj.nĕæt.teh
Lancashire+N+Prop+Der/laš+A+Sg+Gen	Lancashirelačča	lˈɑnː.n̥tsɑ#shˌi.re>lɑt.tʃɑ
Lancashire+N+Prop+Der/laš+A+Attr+Der/vuohta+N+Der/viđá+Adv	Lancashirelašvuohtaviđá	lˈɑnː.n̥tsɑ#shˌi.re>lɑʃ»vˌuoh.tɑ»vˌi.ðɑː
Lancashire+N+Prop+Der/laš+A+Sg+Ill	Lancashirelažžii	lˈɑnː.n̥tsɑ#shˌi.re>lɑdː.tʃij
Lancashire+N+Prop+Sg+Com	Lancashiriin	lˈɑnː.n̥tsɑ#shˌi.ri>in
Lancashire+N+Prop+Sg+Ill	Lancashirii	lˈɑnː.n̥tsɑ#shˌi.ri>i
Leatherhead+N+Prop+Ess	Leatherheadan	lˈĕæt.her.heæd>ɑn
Leatherhead+N+Prop+Sg+Com	Leatherheadain	lˈĕæt.her.heæd>ɑjn
Leatherhead+N+Prop+Sg+Gen	Leatherheada	lˈĕæt.her.heæd>ɑ
Leatherhead+N+Prop+Sg+Ill	Leatherheadii	lˈĕæt.her.heæd>ij
Leatherhead+N+Prop+Der/laš+A+Pl+Loc+PxSg1	Leatherheadalaččainan	lˈĕæt.her.heæd>ɑ.lɑt.tʃɑj.nɑn
Leatherhead+N+Prop+Der/laš+A+Sg+Loc	Leatherheadalaččas	lˈĕæt.her.heæd>ɑ.lɑt.tʃɑs
Leatherhead+N+Prop+Der/laš+A+Attr	Leatherheadalaš	lˈĕæt.her.heæd>ɑ.lɑʃ
Leatherhead+N+Prop+Der/laš+A+AttrCmp+Der/mohkat+A+Sg+Ill	Leatherheadalašmohkagii	lˈĕæt.her.heæd>ɑ.lɑʃ»mˌoh.kɑ.gij
Leatherhead+N+Prop+Der/laš+A+Sg+Nom	Leatherheadalaš	lˈĕæt.her.heæd>ɑ.lɑʃ
Leatherhead+N+Prop+Der/laš+A+Sg+Ill	Leatherheadalažžii	lˈĕæt.her.heæd>ɑ.lɑdː.tʃij
Leicestershire+N+Prop+Ess	Leicestershiren	lˈejː.çtses.ter#shˌi.re>n
Leicestershire+N+Prop+Sg+Nom	Leicestershire	lˈejː.çtses.ter#shˌi.re>
Leicestershire+N+Prop+Der/laš+A+Pl+Nom	Leicestershirelaččat	lˈejː.çtses.ter#shˌi.re>lɑt.tʃɑh
Leicestershire+N+Prop+Der/laš+A+Sg+Acc+PxSg2	Leicestershirelaččat	lˈejː.çtses.ter#shˌi.re>lɑt.tʃɑh
Leicestershire+N+Prop+Der/laš+A+AttrCmp+Der/sávnnjat+A+Attr	Leicestershirelašsávnnjat	lˈejː.çtses.ter#shˌi.re>lɑʃ»sˌɑːvn.ɲɑh
Leicestershire+N+Prop+Der/laš+A+Sg+Ill+PxSg1	Leicestershirelažžasan	lˈejː.çtses.ter#shˌi.re>lɑdː.tʃɑ.sɑn
Leicestershire+N+Prop+Sg+Com	Leicestershiriin	lˈejː.çtses.ter#shˌi.ri>in
Leicestershire+N+Prop+Sg+Ill	Leicestershirii	lˈejː.çtses.ter#shˌi.ri>i
Maidenhead+N+Prop+Ess	Maidenheadan	mˈɑjː.ten.heæd>ɑn
Maidenhead+N+Prop+Sg+Acc	Maidenhead	mˈɑjː.ten.heæd>
Maidenhead+N+Prop+Sg+Gen	Maidenhead	mˈɑjː.ten.heæd>
Maidenhead+N+Prop+Sg+Nom	Maidenhead	mˈɑjː.ten.heæd>
Maidenhead+N+Prop+Sg+Com	Maidenheadain	mˈɑjː.ten.heæd>ɑjn
Maidenhead+N+Prop+Sg+Loc	Maidenheadas	mˈɑjː.ten.heæd>ɑs
Maidenhead+N+Prop+Sg+Ill	Maidenheadii	mˈɑjː.ten.heæd>ij
Maidenhead+N+Prop+Der/laš+A+Pl+Acc+PxPl2	Maidenheadalaččaideattet	mˈɑjː.ten.heæd>ɑ.lɑt.tʃɑj.dĕæt.teh
Maidenhead+N+Prop+Der/laš+A+Pl+Acc+PxPl3	Maidenheadalaččaideaset	mˈɑjː.ten.heæd>ɑ.lɑt.tʃɑj.dĕæ.seh
Maidenhead+N+Prop+Der/laš+A+Pl+Com+PxPl2	Maidenheadalaččaideattetguin	mˈɑjː.ten.heæd>ɑ.lɑt.tʃɑj.dĕæt.tet.gujn
Maidenhead+N+Prop+Der/laš+A+Pl+Nom+PxSg1	Maidenheadalaččaidan	mˈɑjː.ten.heæd>ɑ.lɑt.tʃɑj.dɑn
Maidenhead+N+Prop+Der/laš+A+Pl+Nom	Maidenheadalaččat	mˈɑjː.ten.heæd>ɑ.lɑt.tʃɑh
Maidenhead+N+Prop+Der/laš+A+Sg+Acc+PxDu2	Maidenheadalaččade	mˈɑjː.ten.heæd>ɑ.lɑt.tʃɑ.de
Maidenhead+N+Prop+Der/laš+A+Sg+Acc+PxSg2	Maidenheadalaččat	mˈɑjː.ten.heæd>ɑ.lɑt.tʃɑh
Maidenhead+N+Prop+Der/laš+A+Sg+Com+PxPl1	Maidenheadalaččaineamet	mˈɑjː.ten.heæd>ɑ.lɑt.tʃɑj.nĕæ.meh
Maidenhead+N+Prop+Der/laš+A+Sg+Gen+PxPl3	Maidenheadalaččaset	mˈɑjː.ten.heæd>ɑ.lɑt.tʃɑ.seh
Maidenhead+N+Prop+Der/laš+A+Sg+Gen+PxSg3	Maidenheadalaččas	mˈɑjː.ten.heæd>ɑ.lɑt.tʃɑs
Maidenhead+N+Prop+Der/laš+A+Sg+Loc	Maidenheadalaččas	mˈɑjː.ten.heæd>ɑ.lɑt.tʃɑs
Maidenhead+N+Prop+Der/laš+A+Attr+Der/vuohta+N+Sg+Ill	Maidenheadalašvuhtii	mˈɑjː.ten.heæd>ɑ.lɑʃ»vˌuh.tij
Maidenhead+N+Prop+Der/laš+A+Attr+Der/vuohta+N+Pl+Nom	Maidenheadalašvuođat	mˈɑjː.ten.heæd>ɑ.lɑʃ»vˌuo.ðɑh
Maidenhead+N+Prop+Der/laš+A+AttrCmp+Der/bealat+A+Ess	Maidenheadalašbealagin	mˈɑjː.ten.heæd>ɑ.lɑʃ»bˌeæ.lɑ.gin
Maidenhead+N+Prop+Der/laš+A+AttrCmp+Der/ivnnat+A+Sg+Com	Maidenheadalašivnnagiin	mˈɑjː.ten.heæd>ɑ.lɑʃ»ˌivn.nɑ.gijn
Maidenhead+N+Prop+Der/laš+A+AttrCmp+Der/njunat+A+Attr	Maidenheadalašnjunat	mˈɑjː.ten.heæd>ɑ.lɑʃ»ɲˌu.nɑh
Maidenhead+N+Prop+Der/laš+A+AttrCmp+Der/šlájat+A+Sg+Nom	Maidenheadalaššlájat	mˈɑjː.ten.heæd>ɑ.lɑʃ»ʃlˌɑː.jɑh
Maidenhead+N+Prop+Der/laš+A+Sg+Nom	Maidenheadalaš	mˈɑjː.ten.heæd>ɑ.lɑʃ
Maidenhead+N+Prop+Der/laš+A+Sg+Gen+PxSg1	Maidenheadalažžan	mˈɑjː.ten.heæd>ɑ.lɑdː.tʃɑn
Maidenhead+N+Prop+Der/laš+A+Sg+Nom+PxPl3	Maidenheadalažžaset	mˈɑjː.ten.heæd>ɑ.lɑdː.tʃɑ.seh
Maidenhead+N+Prop+Der/laš+A+Sg+Nom+PxSg1	Maidenheadalažžan	mˈɑjː.ten.heæd>ɑ.lɑdː.tʃɑn
Maidenhead+N+Prop+Der/laš+A+Sg+Ill	Maidenheadalažžii	mˈɑjː.ten.heæd>ɑ.lɑdː.tʃij
Need+N+Prop+Ess	Needan	nˈe.ed>ɑn
Need+N+Prop+Sg+Acc	Need	nˈe.ed>
Need+N+Prop+Sg+Gen	Need	nˈe.ed>
Need+N+Prop+Sg+Nom	Need	nˈe.ed>
Need+N+Prop+Sg+Com	Needain	nˈe.ed>ɑjn
Need+N+Prop+Sg+Gen	Needa	nˈe.ed>ɑ
Need+N+Prop+Sg+Ill	Needii	nˈe.ed>ij
Northamptonshire+N+Prop+Sg+Acc	Northamptonshire	nˈorth.ɑmhp.ton#shˌi.re>
Northamptonshire+N+Prop+Sg+Gen	Northamptonshire	nˈorth.ɑmhp.ton#shˌi.re>
Northamptonshire+N+Prop+Sg+Nom	Northamptonshire	nˈorth.ɑmhp.ton#shˌi.re>
Northamptonshire+N+Prop+Sg+Loc	Northamptonshires	nˈorth.ɑmhp.ton#shˌi.re>s
Northamptonshire+N+Prop+Der/laš+A+Sg+Nom	Northamptonshirelaš	nˈorth.ɑmhp.ton#shˌi.re>lɑʃ
Northamptonshire+N+Prop+Der/laš+A+Sg+Gen+PxPl1	Northamptonshirelažžamet	nˈorth.ɑmhp.ton#shˌi.re>lɑdː.tʃɑ.meh
Northamptonshire+N+Prop+Der/laš+A+Ess	Northamptonshirelažžan	nˈorth.ɑmhp.ton#shˌi.re>lɑdː.tʃɑn
Northamptonshire+N+Prop+Der/laš+A+Sg+Ill	Northamptonshirelažžii	nˈorth.ɑmhp.ton#shˌi.re>lɑdː.tʃij
Northamptonshire+N+Prop+Sg+Com	Northamptonshiriin	nˈorth.ɑmhp.ton#shˌi.ri>in
Northamptonshire+N+Prop+Sg+Ill	Northamptonshirii	nˈorth.ɑmhp.ton#shˌi.ri>i
Nottinghamshire+N+Prop+Sg+Acc	Nottinghanshire	nˈotː.ting.hɑn#shˌi.re>
Nottinghamshire+N+Prop+Sg+Nom	Nottinghanshire	nˈotː.ting.hɑn#shˌi.re>
Nottinghamshire+N+Prop+Sg+Loc	Nottinghanshires	nˈotː.ting.hɑn#shˌi.re>s
Nottinghamshire+N+Prop+Der/laš+A+Sg+Com	Nottinghanshirelaččain	nˈotː.ting.hɑn#shˌi.re>lɑt.tʃɑjn
Nottinghamshire+N+Prop+Der/laš+A+Attr	Nottinghanshirelaš	nˈotː.ting.hɑn#shˌi.re>lɑʃ
Nottinghamshire+N+Prop+Sg+Com	Nottinghanshiriin	nˈotː.ting.hɑn#shˌi.ri>in
Nottinghamshire+N+Prop+Sg+Ill	Nottinghanshirii	nˈotː.ting.hɑn#shˌi.ri>i
Oxfordshire+N+Prop+Ess	Oxforshiren	ˈoks.for#shˌi.re>n
Oxfordshire+N+Prop+Sg+Acc	Oxforshire	ˈoks.for#shˌi.re>
Oxfordshire+N+Prop+Sg+Nom	Oxforshire	ˈoks.for#shˌi.re>
Oxfordshire+N+Prop+Sg+Loc	Oxforshires	ˈoks.for#shˌi.re>s
Oxfordshire+N+Prop+Der/laš+A+Pl+Acc+PxPl2	Oxforshirelaččaideattet	ˈoks.for#shˌi.re>lɑt.tʃɑj.dĕæt.teh
Oxfordshire+N+Prop+Der/laš+A+Pl+Com+PxSg3	Oxforshirelaččaidisguin	ˈoks.for#shˌi.re>lɑt.tʃɑj.dis.gujn
Oxfordshire+N+Prop+Der/laš+A+Pl+Gen+PxDu3	Oxforshirelaččaideaskka	ˈoks.for#shˌi.re>lɑt.tʃɑj.deæs.kɑ
Oxfordshire+N+Prop+Der/laš+A+Pl+Loc+PxDu2	Oxforshirelaččaineatte	ˈoks.for#shˌi.re>lɑt.tʃɑj.nĕæt.te
Oxfordshire+N+Prop+Der/laš+A+Pl+Nom+PxPl1	Oxforshirelaččaideamet	ˈoks.for#shˌi.re>lɑt.tʃɑj.dĕæ.meh
Oxfordshire+N+Prop+Der/laš+A+Pl+Nom	Oxforshirelaččat	ˈoks.for#shˌi.re>lɑt.tʃɑh
Oxfordshire+N+Prop+Der/laš+A+Sg+Acc+PxSg2	Oxforshirelaččat	ˈoks.for#shˌi.re>lɑt.tʃɑh
Oxfordshire+N+Prop+Der/laš+A+Sg+Com+PxPl1	Oxforshirelaččaineamet	ˈoks.for#shˌi.re>lɑt.tʃɑj.nĕæ.meh
Oxfordshire+N+Prop+Der/laš+A+Sg+Loc	Oxforshirelaččas	ˈoks.for#shˌi.re>lɑt.tʃɑs
Oxfordshire+N+Prop+Der/laš+A+Attr+Der/vuohta+N+Der/viđá+Adv	Oxforshirelašvuohtaviđá	ˈoks.for#shˌi.re>lɑʃ»vˌuoh.tɑ»vˌi.ðɑː
Oxfordshire+N+Prop+Der/laš+A+AttrCmp+Der/čoarvvat+A+Ess	Oxforshirelaščoarvvagin	ˈoks.for#shˌi.re>lɑʃ»tʃˌoɑrv.vɑ.gin
Oxfordshire+N+Prop+Der/laš+A+Sg+Nom	Oxforshirelaš	ˈoks.for#shˌi.re>lɑʃ
Oxfordshire+N+Prop+Der/laš+A+Sg+Gen+PxSg1	Oxforshirelažžan	ˈoks.for#shˌi.re>lɑdː.tʃɑn
Oxfordshire+N+Prop+Der/laš+A+Sg+Ill+PxSg2	Oxforshirelažžasat	ˈoks.for#shˌi.re>lɑdː.tʃɑ.sɑh
Oxfordshire+N+Prop+Der/laš+A+Sg+Ill	Oxforshirelažžii	ˈoks.for#shˌi.re>lɑdː.tʃij
Oxfordshire+N+Prop+Sg+Com	Oxforshiriin	ˈoks.for#shˌi.ri>in
Oxfordshire+N+Prop+Sg+Ill	Oxforshirii	ˈoks.for#shˌi.ri>i
Paintbrush+N+Prop+Sem/Sur+Ess	Paintbrushan	phˈɑjnt.brush>ɑn
Paintbrush+N+Prop+Sem/Sur+Pl+Acc	Paintbrushaid	phˈɑjnt.brush>ɑjh
Paintbrush+N+Prop+Sem/Sur+Pl+Com	Paintbrushaiguin	phˈɑjnt.brush>ɑj.gujn
Paintbrush+N+Prop+Sem/Sur+Pl+Gen	Paintbrushaid	phˈɑjnt.brush>ɑjh
Paintbrush+N+Prop+Sem/Sur+Pl+Ill	Paintbrushaide	phˈɑjnt.brush>ɑj.de
Paintbrush+N+Prop+Sem/Sur+Pl+Loc	Paintbrushain	phˈɑjnt.brush>ɑjn
Paintbrush+N+Prop+Sem/Sur+Sg+Acc	Paintbrush	phˈɑjnt.brush>
Paintbrush+N+Prop+Sem/Sur+Sg+Gen	Paintbrush	phˈɑjnt.brush>
Paintbrush+N+Prop+Sem/Sur+Sg+Nom	Paintbrush	phˈɑjnt.brush>
Paintbrush+N+Prop+Sem/Sur+Sg+Acc	Paintbrusha	phˈɑjnt.brush>ɑ
Paintbrush+N+Prop+Sem/Sur+Sg+Com	Paintbrushain	phˈɑjnt.brush>ɑjn
Paintbrush+N+Prop+Sem/Sur+Sg+Gen	Paintbrusha	phˈɑjnt.brush>ɑ
Paintbrush+N+Prop+Sem/Sur+Sg+Loc	Paintbrushas	phˈɑjnt.brush>ɑs
Paintbrush+N+Prop+Sem/Sur+Sg+Ill	Paintbrushii	phˈɑjnt.brush>ij
Reed+N+Prop+Sem/Sur+Ess	Reedan	rˈe.ed>ɑn
Reed+N+Prop+Sem/Sur+Pl+Acc	Reedaid	rˈe.ed>ɑjh
Reed+N+Prop+Sem/Sur+Pl+Gen	Reedaid	rˈe.ed>ɑjh
Reed+N+Prop+Sem/Sur+Pl+Ill	Reedaide	rˈe.ed>ɑj.de
Reed+N+Prop+Sem/Sur+Pl+Loc	Reedain	rˈe.ed>ɑjn
Reed+N+Prop+Sem/Sur+Pl+Nom	Reedat	rˈe.ed>ɑh
Reed+N+Prop+Sem/Sur+Sg+Acc	Reed	rˈe.ed>
Reed+N+Prop+Sem/Sur+Sg+Gen	Reed	rˈe.ed>
Reed+N+Prop+Sem/Sur+Sg+Nom	Reed	rˈe.ed>
Reed+N+Prop+Sem/Sur+Sg+Acc	Reeda	rˈe.ed>ɑ
Reed+N+Prop+Sem/Sur+Sg+Com	Reedain	rˈe.ed>ɑjn
Reed+N+Prop+Sem/Sur+Sg+Gen	Reeda	rˈe.ed>ɑ
Reed+N+Prop+Sem/Sur+Sg+Loc	Reedas	rˈe.ed>ɑs
Reed+N+Prop+Sem/Sur+Sg+Ill	Reedii	rˈe.ed>ij
Shropshire+N+Prop+Ess	Shrotshiren	shrˈoh#shˌi.re>n
Shropshire+N+Prop+Sg+Nom	Shrotshire	shrˈoh#shˌi.re>
Shropshire+N+Prop+Sg+Loc	Shrotshires	shrˈoh#shˌi.re>s
Shropshire+N+Prop+Der/laš+A+Sg+Com+PxDu1	Shrotshirelaččaineame	shrˈoh#shˌi.re>lɑt.tʃɑj.nĕæ.me
Shropshire+N+Prop+Der/laš+A+Sg+Gen+PxPl3	Shrotshirelaččaset	shrˈoh#shˌi.re>lɑt.tʃɑ.seh
Shropshire+N+Prop+Der/laš+A+Attr	Shrotshirelaš	shrˈoh#shˌi.re>lɑʃ
Shropshire+N+Prop+Der/laš+A+Attr+Der/vuohta+N+Sg+Ill	Shrotshirelašvuhtii	shrˈoh#shˌi.re>lɑʃ»vˌuh.tij
Shropshire+N+Prop+Der/laš+A+AttrCmp+Der/čiegat+A+Ess	Shrotshirelaščiegagin	shrˈoh#shˌi.re>lɑʃ»tʃˌie.gɑ.gin
Shropshire+N+Prop+Der/laš+A+Sg+Ill	Shrotshirelažžii	shrˈoh#shˌi.re>lɑdː.tʃij
Shropshire+N+Prop+Sg+Com	Shrotshiriin	shrˈoh#shˌi.ri>in
Shropshire+N+Prop+Sg+Ill	Shrotshirii	shrˈoh#shˌi.ri>i
Staffordshire+N+Prop+Ess	Stafforshiren	stˈɑf.for#shˌi.re>n
Staffordshire+N+Prop+Sg+Gen	Stafforshire	stˈɑf.for#shˌi.re>
Staffordshire+N+Prop+Sg+Nom	Stafforshire	stˈɑf.for#shˌi.re>
Staffordshire+N+Prop+Sg+Loc	Stafforshires	stˈɑf.for#shˌi.re>s
Staffordshire+N+Prop+Der/laš+A+Sg+Gen+PxPl2	Stafforshirelaččadet	stˈɑf.for#shˌi.re>lɑt.tʃɑ.deh
Staffordshire+N+Prop+Der/laš+A+Attr	Stafforshirelaš	stˈɑf.for#shˌi.re>lɑʃ
Staffordshire+N+Prop+Der/laš+A+AttrCmp+Der/asat+A+Sg+Nom	Stafforshirelašasat	stˈɑf.for#shˌi.re>lɑʃ»ˌɑ.sɑh
Staffordshire+N+Prop+Der/laš+A+AttrCmp+Der/fárddat+A+Sg+Gen	Stafforshirelašfárddaga	stˈɑf.for#shˌi.re>lɑʃ»fˌɑːrt.tɑ.gɑ
Staffordshire+N+Prop+Der/laš+A+Sg+Nom	Stafforshirelaš	stˈɑf.for#shˌi.re>lɑʃ
Staffordshire+N+Prop+Der/laš+A+Sg+Nom+PxSg3	Stafforshirelažžas	stˈɑf.for#shˌi.re>lɑdː.tʃɑs
Staffordshire+N+Prop+Der/laš+A+Ess+PxSg1	Stafforshirelažžanan	stˈɑf.for#shˌi.re>lɑdː.tʃɑ.nɑn
Staffordshire+N+Prop+Der/laš+A+Ess+PxSg2	Stafforshirelažžanat	stˈɑf.for#shˌi.re>lɑdː.tʃɑ.nɑh
Staffordshire+N+Prop+Sg+Com	Stafforshiriin	stˈɑf.for#shˌi.ri>in
Staffordshire+N+Prop+Sg+Ill	Stafforshirii	stˈɑf.for#shˌi.ri>i
Tweed+N+Prop+Sem/Sur+Ess	Tweedan	tβˈe.ed>ɑn
Tweed+N+Prop+Sem/Sur+Pl+Acc	Tweedaid	tβˈe.ed>ɑjh
Tweed+N+Prop+Sem/Sur+Pl+Com	Tweedaiguin	tβˈe.ed>ɑj.gujn
Tweed+N+Prop+Sem/Sur+Pl+Gen	Tweedaid	tβˈe.ed>ɑjh
Tweed+N+Prop+Sem/Sur+Pl+Ill	Tweedaide	tβˈe.ed>ɑj.de
Tweed+N+Prop+Sem/Sur+Pl+Loc	Tweedain	tβˈe.ed>ɑjn
Tweed+N+Prop+Sem/Sur+Pl+Nom	Tweedat	tβˈe.ed>ɑh
Tweed+N+Prop+Sem/Sur+Sg+Acc	Tweed	tβˈe.ed>
Tweed+N+Prop+Sem/Sur+Sg+Gen	Tweed	tβˈe.ed>
Tweed+N+Prop+Sem/Sur+Sg+Nom	Tweed	tβˈe.ed>
Tweed+N+Prop+Sem/Sur+Sg+Acc	Tweeda	tβˈe.ed>ɑ
Tweed+N+Prop+Sem/Sur+Sg+Com	Tweedain	tβˈe.ed>ɑjn
Tweed+N+Prop+Sem/Sur+Sg+Gen	Tweeda	tβˈe.ed>ɑ
Tweed+N+Prop+Sem/Sur+Sg+Loc	Tweedas	tβˈe.ed>ɑs
Tweed+N+Prop+Sem/Sur+Sg+Ill	Tweedii	tβˈe.ed>ij
Warwickshire+N+Prop+Ess	Warwickshiren	βˈɑr.βitsk#shˌi.re>n
Warwickshire+N+Prop+Sg+Gen	Warwickshire	βˈɑr.βitsk#shˌi.re>
Warwickshire+N+Prop+Sg+Loc	Warwickshires	βˈɑr.βitsk#shˌi.re>s
Warwickshire+N+Prop+Der/laš+A+Sg+Com+PxDu3	Warwickshirelaččaineaskka	βˈɑr.βitsk#shˌi.re>lɑt.tʃɑj.neæs.kɑ
Warwickshire+N+Prop+Der/laš+A+Attr+Der/vuohta+N+Sg+Ill	Warwickshirelašvuhtii	βˈɑr.βitsk#shˌi.re>lɑʃ»vˌuh.tij
Warwickshire+N+Prop+Der/laš+A+Sg+Acc+PxDu1	Warwickshirelažžame	βˈɑr.βitsk#shˌi.re>lɑdː.tʃɑ.me
Warwickshire+N+Prop+Sg+Com	Warwickshiriin	βˈɑr.βitsk#shˌi.ri>in
Warwickshire+N+Prop+Sg+Ill	Warwickshirii	βˈɑr.βitsk#shˌi.ri>i
Whateverland+N+Prop+Sg+Gen	Whateverland	βhˈɑt.e.ver#lɑnd>
Whateverland+N+Prop+Sg+Acc	Whateverlanda	βhˈɑt.e.ver#lɑnd>ɑ
Whateverland+N+Prop+Sg+Loc	Whateverlandas	βhˈɑt.e.ver#lɑnd>ɑs
Whateverland+N+Prop+Sg+Ill	Whateverlandii	βhˈɑt.e.ver#lɑnd>ij
Whateverland+N+Prop+Der/laš+A+Pl+Nom	Whateverlandalaččat	βhˈɑt.e.ver#lɑnd>ɑ.lɑt.tʃɑh
Wheel+N+Prop+Sem/Sur+Sg+Acc	Wheel	βhˈe.el>
Wheel+N+Prop+Sem/Sur+Sg+Nom	Wheel	βhˈe.el>
WheelMouse+N+Prop+Sg+Com	WheelMousiin	βhˈe.elə.mˌou.si>in
Whist+N+Prop+Sem/Sur+Sg+Nom	Whist	βhˈist>
Whist+N+Prop+Sem/Sur+Sg+Com	Whistain	βhˈist>ɑjn
Whist+N+Prop+Sem/Sur+Sg+Loc	Whistas	βhˈist>ɑs
White+N+Prop+Sem/Sur+Ess	Whiten	βhˈi.te>n
White+N+Prop+Sem/Sur+Pl+Nom	Whitet	βhˈi.te>h
Whitehorse+N+Prop+Sem/Sur+Pl+Com	Whitehorsiiguin	βhˈi.te.hˌorə.si>i.gujn
Whitesnake+N+Prop+Sg+Com	Whitesnakiin	βhˈi.te.snˌɑ.ki>in
White+N+Prop+Sem/Sur+Pl+Loc	Whitiin	βhˈi.ti>in
White+N+Prop+Sem/Sur+Sg+Com	Whitiin	βhˈi.ti>in
Wiltshire+N+Prop+Ess	Wiltshiren	βˈilh#shˌi.re>n
Wiltshire+N+Prop+Sg+Nom	Wiltshire	βˈilh#shˌi.re>
Wiltshire+N+Prop+Sg+Loc	Wiltshires	βˈilh#shˌi.re>s
Wiltshire+N+Prop+Der/laš+A+Sg+Loc+PxDu3	Wiltshirelaččasteaskka	βˈilh#shˌi.re>lɑt.tʃɑs.teæs.kɑ
Wiltshire+N+Prop+Der/laš+A+Attr+Der/vuohta+N+Sg+Nom+PxPl1	Wiltshirelašvuohtamet	βˈilh#shˌi.re>lɑʃ»vˌuoh.tɑ.meh
Wiltshire+N+Prop+Der/laš+A+Sg+Acc+PxSg1	Wiltshirelažžan	βˈilh#shˌi.re>lɑdː.tʃɑn
Wiltshire+N+Prop+Der/laš+A+Sg+Gen+PxPl1	Wiltshirelažžamet	βˈilh#shˌi.re>lɑdː.tʃɑ.meh
Wiltshire+N+Prop+Der/laš+A+Sg+Ill	Wiltshirelažžii	βˈilh#shˌi.re>lɑdː.tʃij
Wiltshire+N+Prop+Sg+Com	Wiltshiriin	βˈilh#shˌi.ri>in
Wiltshire+N+Prop+Sg+Ill	Wiltshirii	βˈilh#shˌi.ri>i
Yorkshire+N+Prop+Ess	Yorkshiren	ˈyork#shˌi.re>n
Yorkshire+N+Prop+Sg+Acc	Yorkshire	ˈyork#shˌi.re>
Yorkshire+N+Prop+Sg+Loc	Yorkshires	ˈyork#shˌi.re>s
Yorkshire+N+Prop+Der/laš+A+Pl+Acc+PxSg2	Yorkshirelaččaidat	ˈyork#shˌi.re>lɑt.tʃɑj.dɑh
Yorkshire+N+Prop+Der/laš+A+Pl+Com+PxDu2	Yorkshirelaččaideatteguin	ˈyork#shˌi.re>lɑt.tʃɑj.dĕæt.te.gujn
Yorkshire+N+Prop+Der/laš+A+Pl+Ill	Yorkshirelaččaide	ˈyork#shˌi.re>lɑt.tʃɑj.de
Yorkshire+N+Prop+Der/laš+A+Pl+Nom+PxDu1	Yorkshirelaččaideame	ˈyork#shˌi.re>lɑt.tʃɑj.dĕæ.me
Yorkshire+N+Prop+Der/laš+A+Sg+Gen+PxDu3	Yorkshirelaččaska	ˈyork#shˌi.re>lɑt.tʃɑs.kɑ
Yorkshire+N+Prop+Der/laš+A+Sg+Loc+PxPl1	Yorkshirelaččasteamet	ˈyork#shˌi.re>lɑt.tʃɑs.tĕæ.meh
Yorkshire+N+Prop+Der/laš+A+Attr	Yorkshirelaš	ˈyork#shˌi.re>lɑʃ
Yorkshire+N+Prop+Der/laš+A+Attr+Der/vuohta+N+Sg+Ill	Yorkshirelašvuhtii	ˈyork#shˌi.re>lɑʃ»vˌuh.tij
Yorkshire+N+Prop+Der/laš+A+AttrCmp+Der/gaccat+A+Pl+Nom	Yorkshirelašgaccagat	ˈyork#shˌi.re>lɑʃ»gˌɑt.tsɑ.gɑh
Yorkshire+N+Prop+Der/laš+A+AttrCmp+Der/heakkat+A+Sg+Nom	Yorkshirelašheakkat	ˈyork#shˌi.re>lɑʃ»hˌeæk.kɑh
Yorkshire+N+Prop+Der/laš+A+AttrCmp+Der/ivnnat+A+Pl+Nom	Yorkshirelašivnnagat	ˈyork#shˌi.re>lɑʃ»ˌivn.nɑ.gɑh
Yorkshire+N+Prop+Der/laš+A+AttrCmp+Der/kultuvrrat+A+Der/vuohta+N+Pl+Com+PxPl3	Yorkshirelaškultuvrratvuođaideasetguin	ˈyork#shˌi.re>lɑʃ»kˌul.htuvr.rɑh»vˌuo.ðɑj.dˌĕæ.set.gujn
Yorkshire+N+Prop+Der/laš+A+Sg+Nom	Yorkshirelaš	ˈyork#shˌi.re>lɑʃ
Yorkshire+N+Prop+Der/laš+A+Ess+PxDu1	Yorkshirelažžaneame	ˈyork#shˌi.re>lɑdː.tʃɑ.nĕæ.me
Yorkshire+N+Prop+Der/laš+A+Ess+PxPl2	Yorkshirelažžaneattet	ˈyork#shˌi.re>lɑdː.tʃɑ.nĕæt.teh
Yorkshire+N+Prop+Der/laš+A+Ess+PxSg2	Yorkshirelažžanat	ˈyork#shˌi.re>lɑdː.tʃɑ.nɑh
Yorkshire+N+Prop+Der/laš+A+Sg+Ill	Yorkshirelažžii	ˈyork#shˌi.re>lɑdː.tʃij
Yorkshire+N+Prop+Sg+Com	Yorkshiriin	ˈyork#shˌi.ri>in
Yorkshire+N+Prop+Sg+Ill	Yorkshirii	ˈyork#shˌi.ri>i
Aaiún+N+Prop+Ess	Aaiúnan	ˈɑː.iún>ɑn
Aaiún+N+Prop+Sg+Acc	Aaiún	ˈɑː.iún>
Aaiún+N+Prop+Sg+Acc	Aaiúna	ˈɑː.iún>ɑ
Aaiún+N+Prop+Sg+Com	Aaiúnain	ˈɑː.iún>ɑjn
Aaiún+N+Prop+Sg+Ill	Aaiúnii	ˈɑː.iún>ij
Aaiún+N+Prop+Der/laš+A+Pl+Gen	Aaiúnalaččaid	ˈɑː.iún>ɑ.lɑt.tʃɑjh
Aaiún+N+Prop+Der/laš+A+Sg+Acc+PxDu3	Aaiúnalaččaska	ˈɑː.iún>ɑ.lɑt.tʃɑs.kɑ
Aaiún+N+Prop+Der/laš+A+Sg+Gen+PxDu2	Aaiúnalaččade	ˈɑː.iún>ɑ.lɑt.tʃɑ.de
Aaiún+N+Prop+Der/laš+A+Sg+Loc+PxPl1	Aaiúnalaččasteamet	ˈɑː.iún>ɑ.lɑt.tʃɑs.tĕæ.meh
Aaiún+N+Prop+Der/laš+A+Attr+Der/vuohta+N+Sg+Ill	Aaiúnalašvuhtii	ˈɑː.iún>ɑ.lɑʃ»vˌuh.tij
Aaiún+N+Prop+Der/laš+A+AttrCmp+Der/agat+A+Attr	Aaiúnalašagat	ˈɑː.iún>ɑ.lɑʃ»ˌɑ.gɑh
Aaiún+N+Prop+Der/laš+A+Sg+Nom	Aaiúnalaš	ˈɑː.iún>ɑ.lɑʃ
Aaiún+N+Prop+Der/laš+A+Sg+Gen+PxDu1	Aaiúnalažžame	ˈɑː.iún>ɑ.lɑdː.tʃɑ.me
Aaiún+N+Prop+Der/laš+A+Sg+Ill	Aaiúnalažžii	ˈɑː.iún>ɑ.lɑdː.tʃij
Apple+N+Prop+Ess	Applen	ˈɑpː.le>n
Apple+N+Prop+Sg+Acc	Apple	ˈɑpː.le>
Apple+N+Prop+Sg+Gen	Apple	ˈɑpː.le>
Apple+N+Prop+Sg+Nom	Apple	ˈɑpː.le>
Apple+N+Prop+Sg+Loc	Apples	ˈɑpː.le>s
Apple+N+Prop+Sg+Com	Appliin	ˈɑpː.li>in
Apple+N+Prop+Sg+Ill	Applii	ˈɑpː.li>i
Ayrshire+N+Prop+Ess	Ayrshiren	ˈɑyr#shˌi.re>n
Ayrshire+N+Prop+Sg+Acc	Ayrshire	ˈɑyr#shˌi.re>
Ayrshire+N+Prop+Sg+Nom	Ayrshire	ˈɑyr#shˌi.re>
Ayrshire+N+Prop+Sg+Loc	Ayrshires	ˈɑyr#shˌi.re>s
Ayrshire+N+Prop+Der/laš+A+Pl+Gen+PxSg2	Ayrshirelaččaidat	ˈɑyr#shˌi.re>lɑt.tʃɑj.dɑh
Ayrshire+N+Prop+Der/laš+A+Sg+Gen+PxPl1	Ayrshirelažžamet	ˈɑyr#shˌi.re>lɑdː.tʃɑ.meh
Ayrshire+N+Prop+Der/laš+A+Ess+PxPl3	Ayrshirelažžaneaset	ˈɑyr#shˌi.re>lɑdː.tʃɑ.nĕæ.seh
Ayrshire+N+Prop+Der/laš+A+Sg+Ill	Ayrshirelažžii	ˈɑyr#shˌi.re>lɑdː.tʃij
Ayrshire+N+Prop+Sg+Com	Ayrshiriin	ˈɑyr#shˌi.ri>in
Ayrshire+N+Prop+Sg+Ill	Ayrshirii	ˈɑyr#shˌi.ri>i
Buckinghamshire+N+Prop+Ess	Buckinghanshiren	pˈuts.king.hɑn#shˌi.re>n
Buckinghamshire+N+Prop+Sg+Acc	Buckinghanshire	pˈuts.king.hɑn#shˌi.re>
Buckinghamshire+N+Prop+Sg+Gen	Buckinghanshire	pˈuts.king.hɑn#shˌi.re>
Buckinghamshire+N+Prop+Sg+Nom	Buckinghanshire	pˈuts.king.hɑn#shˌi.re>
Buckinghamshire+N+Prop+Sg+Loc	Buckinghanshires	pˈuts.king.hɑn#shˌi.re>s
Buckinghamshire+N+Prop+Der/laš+A+Pl+Acc+PxPl1	Buckinghanshirelaččaideamet	pˈuts.king.hɑn#shˌi.re>lɑt.tʃɑj.dĕæ.meh
Buckinghamshire+N+Prop+Der/laš+A+Pl+Acc	Buckinghanshirelaččaid	pˈuts.king.hɑn#shˌi.re>lɑt.tʃɑjh
Buckinghamshire+N+Prop+Der/laš+A+Pl+Com+PxPl2	Buckinghanshirelaččaideattetguin	pˈuts.king.hɑn#shˌi.re>lɑt.tʃɑj.dĕæt.tet.gujn
Buckinghamshire+N+Prop+Der/laš+A+Sg+Acc+PxSg3	Buckinghanshirelaččas	pˈuts.king.hɑn#shˌi.re>lɑt.tʃɑs
Buckinghamshire+N+Prop+Der/laš+A+Sg+Loc	Buckinghanshirelaččas	pˈuts.king.hɑn#shˌi.re>lɑt.tʃɑs
Buckinghamshire+N+Prop+Der/laš+A+Attr	Buckinghanshirelaš	pˈuts.king.hɑn#shˌi.re>lɑʃ
Buckinghamshire+N+Prop+Der/laš+A+Attr+Der/vuohta+N+Sg+Ill	Buckinghanshirelašvuhtii	pˈuts.king.hɑn#shˌi.re>lɑʃ»vˌuh.tij
Buckinghamshire+N+Prop+Der/laš+A+AttrCmp+Der/ivnnat+A+Der/vuohta+N+Der/viđá+Adv	Buckinghanshirelašivnnatvuohtaviđá	pˈuts.king.hɑn#shˌi.re>lɑʃ»ˌivn.nɑh»vˌuoh.tɑ»vˌi.ðɑː
Buckinghamshire+N+Prop+Der/laš+A+Sg+Nom	Buckinghanshirelaš	pˈuts.king.hɑn#shˌi.re>lɑʃ
Buckinghamshire+N+Prop+Der/laš+A+Sg+Ill	Buckinghanshirelažžii	pˈuts.king.hɑn#shˌi.re>lɑdː.tʃij
Buckinghamshire+N+Prop+Sg+Com	Buckinghanshiriin	pˈuts.king.hɑn#shˌi.ri>in
Buckinghamshire+N+Prop+Sg+Ill	Buckinghanshirii	pˈuts.king.hɑn#shˌi.ri>i
Chattanooga+N+Prop+Ess	Chattanoogan	tshˈɑtː.tɑː.nˌo.o.gɑ>n
Chattanooga+N+Prop+Sg+Acc	Chattanooga	tshˈɑtː.tɑː.nˌo.o.gɑ>
Chattanooga+N+Prop+Sg+Gen	Chattanooga	tshˈɑtː.tɑː.nˌo.o.gɑ>
Chattanooga+N+Prop+Sg+Nom	Chattanooga	tshˈɑtː.tɑː.nˌo.o.gɑ>
Chattanooga+N+Prop+Sg+Ill	Chattanoogai	tshˈɑtː.tɑː.nˌo.o.gɑ>i
Chattanooga+N+Prop+Sg+Loc	Chattanoogas	tshˈɑtː.tɑː.nˌo.o.gɑ>s
Chattanooga+N+Prop+Der/laš+A+Pl+Acc+PxSg1	Chattanoogalaččaidan	tshˈɑtː.tɑː.nˌo.o.gɑ>lɑt.tʃɑj.dɑn
Chattanooga+N+Prop+Der/laš+A+Pl+Acc	Chattanoogalaččaid	tshˈɑtː.tɑː.nˌo.o.gɑ>lɑt.tʃɑjh
Chattanooga+N+Prop+Der/laš+A+Pl+Loc+PxDu3	Chattanoogalaččaineaskka	tshˈɑtː.tɑː.nˌo.o.gɑ>lɑt.tʃɑj.neæs.kɑ
Chattanooga+N+Prop+Der/laš+A+Pl+Nom	Chattanoogalaččat	tshˈɑtː.tɑː.nˌo.o.gɑ>lɑt.tʃɑh
Chattanooga+N+Prop+Der/laš+A+Sg+Acc+PxPl2	Chattanoogalaččadet	tshˈɑtː.tɑː.nˌo.o.gɑ>lɑt.tʃɑ.deh
Chattanooga+N+Prop+Der/laš+A+Sg+Com	Chattanoogalaččain	tshˈɑtː.tɑː.nˌo.o.gɑ>lɑt.tʃɑjn
Chattanooga+N+Prop+Der/laš+A+Sg+Loc	Chattanoogalaččas	tshˈɑtː.tɑː.nˌo.o.gɑ>lɑt.tʃɑs
Chattanooga+N+Prop+Der/laš+A+Sg+Loc+PxPl3	Chattanoogalaččasteaset	tshˈɑtː.tɑː.nˌo.o.gɑ>lɑt.tʃɑs.tĕæ.seh
Chattanooga+N+Prop+Der/laš+A+Sg+Loc+PxSg1	Chattanoogalaččastan	tshˈɑtː.tɑː.nˌo.o.gɑ>lɑt.tʃɑs.tɑn
Chattanooga+N+Prop+Der/laš+A+Attr	Chattanoogalaš	tshˈɑtː.tɑː.nˌo.o.gɑ>lɑʃ
Chattanooga+N+Prop+Der/laš+A+AttrCmp+Der/bealat+A+Pl+Com	Chattanoogalašbealagiiguin	tshˈɑtː.tɑː.nˌo.o.gɑ>lɑʃ»bˌeæ.lɑ.gˌij.gujn
Chattanooga+N+Prop+Der/laš+A+AttrCmp+Der/nálat+A+Sg+Nom	Chattanoogalašnálat	tshˈɑtː.tɑː.nˌo.o.gɑ>lɑʃ»nˌɑː.lɑh
Chattanooga+N+Prop+Der/laš+A+AttrCmp+Der/uvssot+A+Sg+Gen	Chattanoogalašuvssoga	tshˈɑtː.tɑː.nˌo.o.gɑ>lɑʃ»ˌuvs.so.gɑ
Chattanooga+N+Prop+Der/laš+A+Sg+Nom	Chattanoogalaš	tshˈɑtː.tɑː.nˌo.o.gɑ>lɑʃ
Chattanooga+N+Prop+Der/laš+A+Sg+Acc+PxDu1	Chattanoogalažžame	tshˈɑtː.tɑː.nˌo.o.gɑ>lɑdː.tʃɑ.me
Chattanooga+N+Prop+Der/laš+A+Sg+Ill+PxPl3	Chattanoogalažžaseaset	tshˈɑtː.tɑː.nˌo.o.gɑ>lɑdː.tʃɑ.sĕæ.seh
Chattanooga+N+Prop+Der/laš+A+Sg+Ill	Chattanoogalažžii	tshˈɑtː.tɑː.nˌo.o.gɑ>lɑdː.tʃij
Cyaneed+N+Prop+Ess	Cyaneedan	tsˈy.ɑ.nˌe.ed>ɑn
Cyaneed+N+Prop+Sg+Gen	Cyaneed	tsˈy.ɑ.nˌe.ed>
Cyaneed+N+Prop+Sg+Nom	Cyaneed	tsˈy.ɑ.nˌe.ed>
Cyaneed+N+Prop+Sg+Acc	Cyaneeda	tsˈy.ɑ.nˌe.ed>ɑ
Cyaneed+N+Prop+Sg+Com	Cyaneedain	tsˈy.ɑ.nˌe.ed>ɑjn
Cyaneed+N+Prop+Sg+Gen	Cyaneeda	tsˈy.ɑ.nˌe.ed>ɑ
Cyaneed+N+Prop+Sg+Loc	Cyaneedas	tsˈy.ɑ.nˌe.ed>ɑs
Cyaneed+N+Prop+Sg+Ill	Cyaneedii	tsˈy.ɑ.nˌe.ed>ij
Dorsetshire+N+Prop+Ess	Dorsetshiren	tˈorə.seh#shˌi.re>n
Dorsetshire+N+Prop+Sg+Acc	Dorsetshire	tˈorə.seh#shˌi.re>
Dorsetshire+N+Prop+Sg+Loc	Dorsetshires	tˈorə.seh#shˌi.re>s
Dorsetshire+N+Prop+Der/laš+A+Pl+Com	Dorsetshirelaččaiguin	tˈorə.seh#shˌi.re>lɑt.tʃɑj.gujn
Dorsetshire+N+Prop+Der/laš+A+Pl+Ill+PxDu1	Dorsetshirelaččaidasame	tˈorə.seh#shˌi.re>lɑt.tʃɑj.dɑ.sɑ.me
Dorsetshire+N+Prop+Der/laš+A+Pl+Ill+PxSg1	Dorsetshirelaččaidasan	tˈorə.seh#shˌi.re>lɑt.tʃɑj.dɑ.sɑn
Dorsetshire+N+Prop+Der/laš+A+Sg+Gen+PxPl2	Dorsetshirelaččadet	tˈorə.seh#shˌi.re>lɑt.tʃɑ.deh
Dorsetshire+N+Prop+Der/laš+A+Attr	Dorsetshirelaš	tˈorə.seh#shˌi.re>lɑʃ
Dorsetshire+N+Prop+Der/laš+A+Attr+Der/vuohta+N+Ess+PxDu2	Dorsetshirelašvuohtaneatte	tˈorə.seh#shˌi.re>lɑʃ»vˌuoh.tɑ.nˌĕæt.te
Dorsetshire+N+Prop+Der/laš+A+Ess+PxPl1	Dorsetshirelažžaneamet	tˈorə.seh#shˌi.re>lɑdː.tʃɑ.nĕæ.meh
Dorsetshire+N+Prop+Der/laš+A+Sg+Ill	Dorsetshirelažžii	tˈorə.seh#shˌi.re>lɑdː.tʃij
Dorsetshire+N+Prop+Sg+Com	Dorsetshiriin	tˈorə.seh#shˌi.ri>in
Dorsetshire+N+Prop+Sg+Ill	Dorsetshirii	tˈorə.seh#shˌi.ri>i
Gateshead+N+Prop+Ess	Gatesheadan	kˈɑ.tes.heæd>ɑn
Gateshead+N+Prop+Sg+Nom	Gateshead	kˈɑ.tes.heæd>
Gateshead+N+Prop+Sg+Ill	Gatesheadii	kˈɑ.tes.heæd>ij
Gateshead+N+Prop+Der/laš+A+Pl+Ill+PxPl3	Gatesheadalaččaidasaset	kˈɑ.tes.heæd>ɑ.lɑt.tʃɑj.dɑ.sɑ.seh
Gateshead+N+Prop+Der/laš+A+Sg+Acc+PxDu2	Gatesheadalaččade	kˈɑ.tes.heæd>ɑ.lɑt.tʃɑ.de
Gateshead+N+Prop+Der/laš+A+Sg+Loc	Gatesheadalaččas	kˈɑ.tes.heæd>ɑ.lɑt.tʃɑs
Gateshead+N+Prop+Der/laš+A+Attr+Der/vuohta+N+Sg+Ill	Gatesheadalašvuhtii	kˈɑ.tes.heæd>ɑ.lɑʃ»vˌuh.tij
Gateshead+N+Prop+Der/laš+A+AttrCmp+Der/čoarvvat+A+Sg+Nom	Gatesheadalaščoarvvat	kˈɑ.tes.heæd>ɑ.lɑʃ»tʃˌoɑrv.vɑh
Gateshead+N+Prop+Der/laš+A+Sg+Ill+PxSg3	Gatesheadalažžasis	kˈɑ.tes.heæd>ɑ.lɑdː.tʃɑ.sis
Gateshead+N+Prop+Der/laš+A+Sg+Ill	Gatesheadalažžii	kˈɑ.tes.heæd>ɑ.lɑdː.tʃij
Gilead+N+Prop+Sem/Mal+Pl+Nom	Gileadat	kˈi.leæd>ɑh
Gilead+N+Prop+Sem/Mal+Sg+Gen	Gileada	kˈi.leæd>ɑ
Gilead+N+Prop+Sem/Mal+Attr	Gilead	kˈi.leæd>
Gislaved+N+Prop+Sg+Ill	Gislavedii	kˈis.lɑː.ved>ij
Gislaved+N+Prop+Der/laš+A+Pl+Gen+PxPl1	Gislavedalaččaideamet	kˈis.lɑː.ved>ɑ.lɑt.tʃɑj.dĕæ.meh
Gislaved+N+Prop+Der/laš+A+Attr+Der/vuohta+N+Sg+Ill	Gislavedalašvuhtii	kˈis.lɑː.ved>ɑ.lɑʃ»vˌuh.tij
Gislaved+N+Prop+Der/laš+A+Sg+Nom+PxPl1	Gislavedalažžamet	kˈis.lɑː.ved>ɑ.lɑdː.tʃɑ.meh
Gislaved+N+Prop+Der/laš+A+Ess+PxPl1	Gislavedalažžaneamet	kˈis.lɑː.ved>ɑ.lɑdː.tʃɑ.nĕæ.meh
Gislaved+N+Prop+Der/laš+A+Sg+Ill	Gislavedalažžii	kˈis.lɑː.ved>ɑ.lɑdː.tʃij
Gloucerstershire+N+Prop+Ess	Gloucerstershiren	glˈou.tserə.ster#shˌi.re>n
Gloucerstershire+N+Prop+Sg+Loc	Gloucerstershires	glˈou.tserə.ster#shˌi.re>s
Gloucerstershire+N+Prop+Der/laš+A+Pl+Gen+PxPl2	Gloucerstershirelaččaideattet	glˈou.tserə.ster#shˌi.re>lɑt.tʃɑj.dĕæt.teh
Gloucerstershire+N+Prop+Der/laš+A+AttrCmp+Der/čoarvvat+A+Der/vuohta+N+Sg+Ill	Gloucerstershirelaščoarvvatvuhtii	glˈou.tserə.ster#shˌi.re>lɑʃ»tʃˌoɑrv.vɑh»vˌuh.tij
Gloucerstershire+N+Prop+Der/laš+A+Sg+Nom	Gloucerstershirelaš	glˈou.tserə.ster#shˌi.re>lɑʃ
Gloucerstershire+N+Prop+Der/laš+A+Sg+Ill	Gloucerstershirelažžii	glˈou.tserə.ster#shˌi.re>lɑdː.tʃij
Gloucerstershire+N+Prop+Sg+Com	Gloucerstershiriin	glˈou.tserə.ster#shˌi.ri>in
Gloucerstershire+N+Prop+Sg+Ill	Gloucerstershirii	glˈou.tserə.ster#shˌi.ri>i
Grinstead+N+Prop+Ess	Grinsteadan	grˈinː.steæd>ɑn
Grinstead+N+Prop+Sg+Gen	Grinstead	grˈinː.steæd>
Grinstead+N+Prop+Sg+Nom	Grinstead	grˈinː.steæd>
Grinstead+N+Prop+Sg+Gen	Grinsteada	grˈinː.steæd>ɑ
Grinstead+N+Prop+Sg+Loc	Grinsteadas	grˈinː.steæd>ɑs
Grinstead+N+Prop+Sg+Ill	Grinsteadii	grˈinː.steæd>ij
Grinstead+N+Prop+Der/laš+A+Pl+Com	Grinsteadalaččaiguin	grˈinː.steæd>ɑ.lɑt.tʃɑj.gujn
Grinstead+N+Prop+Der/laš+A+Pl+Gen+PxPl1	Grinsteadalaččaideamet	grˈinː.steæd>ɑ.lɑt.tʃɑj.dĕæ.meh
Grinstead+N+Prop+Der/laš+A+Pl+Loc+PxDu2	Grinsteadalaččaineatte	grˈinː.steæd>ɑ.lɑt.tʃɑj.nĕæt.te
Grinstead+N+Prop+Der/laš+A+Sg+Nom	Grinsteadalaš	grˈinː.steæd>ɑ.lɑʃ
Grinstead+N+Prop+Der/laš+A+Ess+PxDu1	Grinsteadalažžaneame	grˈinː.steæd>ɑ.lɑdː.tʃɑ.nĕæ.me
Grinstead+N+Prop+Der/laš+A+Sg+Ill	Grinsteadalažžii	grˈinː.steæd>ɑ.lɑdː.tʃij
Hampshire+N+Prop+Sg+Gen	Hampshire	hˈɑmp#shˌi.re>
Hampshire+N+Prop+Sg+Nom	Hampshire	hˈɑmp#shˌi.re>
Hampshire+N+Prop+Sg+Loc	Hampshires	hˈɑmp#shˌi.re>s
Hampshire+N+Prop+Der/laš+A+Sg+Com+PxDu2	Hampshirelaččaineatte	hˈɑmp#shˌi.re>lɑt.tʃɑj.nĕæt.te
Hampshire+N+Prop+Der/laš+A+Attr	Hampshirelaš	hˈɑmp#shˌi.re>lɑʃ
Hampshire+N+Prop+Der/laš+A+Sg+Nom	Hampshirelaš	hˈɑmp#shˌi.re>lɑʃ
Hampshire+N+Prop+Der/laš+A+Sg+Nom+PxDu3	Hampshirelažžaska	hˈɑmp#shˌi.re>lɑdː.tʃɑs.kɑ
Hampshire+N+Prop+Der/laš+A+Sg+Ill	Hampshirelažžii	hˈɑmp#shˌi.re>lɑdː.tʃij
Hampshire+N+Prop+Sg+Com	Hampshiriin	hˈɑmp#shˌi.ri>in
Hampshire+N+Prop+Sg+Ill	Hampshirii	hˈɑmp#shˌi.ri>i
Head+N+Prop+Sem/Sur+Ess	Headan	hˈeæd>ɑn
Head+N+Prop+Sem/Sur+Sg+Acc	Heada	hˈeæd>ɑ
Head+N+Prop+Sem/Sur+Sg+Com	Headain	hˈeæd>ɑjn
Head+N+Prop+Sem/Sur+Sg+Ill	Headii	hˈeæd>ij
Herefordshire+N+Prop+Der/laš+A+Sg+Com+PxSg3	Hereforshirelaččainis	hˈe.re.for#shˌi.re>lɑt.tʃɑj.nis
Herefordshire+N+Prop+Der/laš+A+AttrCmp+Der/ivnnat+A+Ess	Hereforshirelašivnnagin	hˈe.re.for#shˌi.re>lɑʃ»ˌivn.nɑ.gin
Herefordshire+N+Prop+Sg+Com	Hereforshiriin	hˈe.re.for#shˌi.ri>in
Herefordshire+N+Prop+Sg+Ill	Hereforshirii	hˈe.re.for#shˌi.ri>i
Hertfordshire+N+Prop+Sg+Loc	Hertforshires	hˈert.for#shˌi.re>s
Hertfordshire+N+Prop+Der/laš+A+Pl+Nom+PxPl1	Hertforshirelaččaideamet	hˈert.for#shˌi.re>lɑt.tʃɑj.dĕæ.meh
Hertfordshire+N+Prop+Sg+Com	Hertforshiriin	hˈert.for#shˌi.ri>in
Hertfordshire+N+Prop+Sg+Ill	Hertforshirii	hˈert.for#shˌi.ri>i
Lancashire+N+Prop+Ess	Lancashiren	lˈɑnː.n̥tsɑ#shˌi.re>n
Lancashire+N+Prop+Sg+Nom	Lancashire	lˈɑnː.n̥tsɑ#shˌi.re>
Lancashire+N+Prop+Sg+Loc	Lancashires	lˈɑnː.n̥tsɑ#shˌi.re>s
Lancashire+N+Prop+Der/laš+A+Pl+Acc	Lancashirelaččaid	lˈɑnː.n̥tsɑ#shˌi.re>lɑt.tʃɑjh
Lancashire+N+Prop+Der/laš+A+Pl+Gen+PxSg3	Lancashirelaččaidis	lˈɑnː.n̥tsɑ#shˌi.re>lɑt.tʃɑj.dis
Lancashire+N+Prop+Der/laš+A+AttrCmp+Der/olat+A+Attr	Lancashirelašolat	lˈɑnː.n̥tsɑ#shˌi.re>lɑʃ»ˌo.lɑh
Lancashire+N+Prop+Der/laš+A+AttrCmp+Der/šlájat+A+Pl+Nom	Lancashirelaššlájagat	lˈɑnː.n̥tsɑ#shˌi.re>lɑʃ»ʃlˌɑː.jɑ.gɑh
Lancashire+N+Prop+Der/laš+A+Sg+Nom	Lancashirelaš	lˈɑnː.n̥tsɑ#shˌi.re>lɑʃ
Lancashire+N+Prop+Der/laš+A+Sg+Acc+PxDu1	Lancashirelažžame	lˈɑnː.n̥tsɑ#shˌi.re>lɑdː.tʃɑ.me
Lancashire+N+Prop+Der/laš+A+Sg+Ill+PxDu2	Lancashirelažžaseatte	lˈɑnː.n̥tsɑ#shˌi.re>lɑdː.tʃɑ.sĕæt.te
Lancashire+N+Prop+Der/laš+A+Sg+Ill	Lancashirelažžii	lˈɑnː.n̥tsɑ#shˌi.re>lɑdː.tʃij
Lancashire+N+Prop+Sg+Com	Lancashiriin	lˈɑnː.n̥tsɑ#shˌi.ri>in
Lancashire+N+Prop+Sg+Ill	Lancashirii	lˈɑnː.n̥tsɑ#shˌi.ri>i
Leatherhead+N+Prop+Ess	Leatherheadan	lˈĕæt.her.heæd>ɑn
Leatherhead+N+Prop+Sg+Acc	Leatherhead	lˈĕæt.her.heæd>
Leatherhead+N+Prop+Sg+Gen	Leatherhead	lˈĕæt.her.heæd>
Leatherhead+N+Prop+Sg+Nom	Leatherhead	lˈĕæt.her.heæd>
Leatherhead+N+Prop+Sg+Acc	Leatherheada	lˈĕæt.her.heæd>ɑ
Leatherhead+N+Prop+Sg+Com	Leatherheadain	lˈĕæt.her.heæd>ɑjn
Leatherhead+N+Prop+Sg+Gen	Leatherheada	lˈĕæt.her.heæd>ɑ
Leatherhead+N+Prop+Sg+Loc	Leatherheadas	lˈĕæt.her.heæd>ɑs
Leatherhead+N+Prop+Sg+Ill	Leatherheadii	lˈĕæt.her.heæd>ij
Leatherhead+N+Prop+Der/laš+A+Pl+Ill+PxSg1	Leatherheadalaččaidasan	lˈĕæt.her.heæd>ɑ.lɑt.tʃɑj.dɑ.sɑn
Leatherhead+N+Prop+Der/laš+A+Pl+Loc+PxDu1	Leatherheadalaččaineame	lˈĕæt.her.heæd>ɑ.lɑt.tʃɑj.nĕæ.me
Leatherhead+N+Prop+Der/laš+A+Pl+Loc+PxDu3	Leatherheadalaččaineaskka	lˈĕæt.her.heæd>ɑ.lɑt.tʃɑj.neæs.kɑ
Leatherhead+N+Prop+Der/laš+A+Pl+Nom	Leatherheadalaččat	lˈĕæt.her.heæd>ɑ.lɑt.tʃɑh
Leatherhead+N+Prop+Der/laš+A+Attr	Leatherheadalaš	lˈĕæt.her.heæd>ɑ.lɑʃ
Leatherhead+N+Prop+Der/laš+A+Sg+Nom	Leatherheadalaš	lˈĕæt.her.heæd>ɑ.lɑʃ
Leatherhead+N+Prop+Der/laš+A+Ess+PxSg2	Leatherheadalažžanat	lˈĕæt.her.heæd>ɑ.lɑdː.tʃɑ.nɑh
Leatherhead+N+Prop+Der/laš+A+Sg+Ill	Leatherheadalažžii	lˈĕæt.her.heæd>ɑ.lɑdː.tʃij
Leicestershire+N+Prop+Sg+Nom	Leicestershire	lˈejː.çtses.ter#shˌi.re>
Leicestershire+N+Prop+Sg+Loc	Leicestershires	lˈejː.çtses.ter#shˌi.re>s
Leicestershire+N+Prop+Der/laš+A+Pl+Com	Leicestershirelaččaiguin	lˈejː.çtses.ter#shˌi.re>lɑt.tʃɑj.gujn
Leicestershire+N+Prop+Der/laš+A+Sg+Acc+PxDu2	Leicestershirelaččade	lˈejː.çtses.ter#shˌi.re>lɑt.tʃɑ.de
Leicestershire+N+Prop+Der/laš+A+Sg+Acc+PxSg3	Leicestershirelaččas	lˈejː.çtses.ter#shˌi.re>lɑt.tʃɑs
Leicestershire+N+Prop+Der/laš+A+Sg+Com+PxDu1	Leicestershirelaččaineame	lˈejː.çtses.ter#shˌi.re>lɑt.tʃɑj.nĕæ.me
Leicestershire+N+Prop+Der/laš+A+Attr	Leicestershirelaš	lˈejː.çtses.ter#shˌi.re>lɑʃ
Leicestershire+N+Prop+Der/laš+A+Attr+Der/vuohta+N+Sg+Ill	Leicestershirelašvuhtii	lˈejː.çtses.ter#shˌi.re>lɑʃ»vˌuh.tij
Leicestershire+N+Prop+Sg+Com	Leicestershiriin	lˈejː.çtses.ter#shˌi.ri>in
Leicestershire+N+Prop+Sg+Ill	Leicestershirii	lˈejː.çtses.ter#shˌi.ri>i
Maidenhead+N+Prop+Ess	Maidenheadan	mˈɑjː.ten.heæd>ɑn
Maidenhead+N+Prop+Sg+Acc	Maidenhead	mˈɑjː.ten.heæd>
Maidenhead+N+Prop+Sg+Gen	Maidenhead	mˈɑjː.ten.heæd>
Maidenhead+N+Prop+Sg+Nom	Maidenhead	mˈɑjː.ten.heæd>
Maidenhead+N+Prop+Sg+Acc	Maidenheada	mˈɑjː.ten.heæd>ɑ
Maidenhead+N+Prop+Sg+Com	Maidenheadain	mˈɑjː.ten.heæd>ɑjn
Maidenhead+N+Prop+Sg+Gen	Maidenheada	mˈɑjː.ten.heæd>ɑ
Maidenhead+N+Prop+Sg+Ill	Maidenheadii	mˈɑjː.ten.heæd>ij
Maidenhead+N+Prop+Der/laš+A+Pl+Ill	Maidenheadalaččaide	mˈɑjː.ten.heæd>ɑ.lɑt.tʃɑj.de
Maidenhead+N+Prop+Der/laš+A+Pl+Nom+PxDu1	Maidenheadalaččaideame	mˈɑjː.ten.heæd>ɑ.lɑt.tʃɑj.dĕæ.me
Maidenhead+N+Prop+Der/laš+A+Sg+Acc+PxDu2	Maidenheadalaččade	mˈɑjː.ten.heæd>ɑ.lɑt.tʃɑ.de
Maidenhead+N+Prop+Der/laš+A+Sg+Acc+PxSg2	Maidenheadalaččat	mˈɑjː.ten.heæd>ɑ.lɑt.tʃɑh
Maidenhead+N+Prop+Der/laš+A+Sg+Com+PxDu2	Maidenheadalaččaineatte	mˈɑjː.ten.heæd>ɑ.lɑt.tʃɑj.nĕæt.te
Maidenhead+N+Prop+Der/laš+A+Sg+Com+PxPl3	Maidenheadalaččaineaset	mˈɑjː.ten.heæd>ɑ.lɑt.tʃɑj.nĕæ.seh
Maidenhead+N+Prop+Der/laš+A+Sg+Com+PxSg1	Maidenheadalaččainan	mˈɑjː.ten.heæd>ɑ.lɑt.tʃɑj.nɑn
Maidenhead+N+Prop+Der/laš+A+Sg+Gen+PxPl2	Maidenheadalaččadet	mˈɑjː.ten.heæd>ɑ.lɑt.tʃɑ.deh
Maidenhead+N+Prop+Der/laš+A+Sg+Loc+PxPl2	Maidenheadalaččasteattet	mˈɑjː.ten.heæd>ɑ.lɑt.tʃɑs.tĕæt.teh
Maidenhead+N+Prop+Der/laš+A+Attr	Maidenheadalaš	mˈɑjː.ten.heæd>ɑ.lɑʃ
Maidenhead+N+Prop+Der/laš+A+Attr+Der/vuohta+N+Sg+Ill	Maidenheadalašvuhtii	mˈɑjː.ten.heæd>ɑ.lɑʃ»vˌuh.tij
Maidenhead+N+Prop+Der/laš+A+AttrCmp+Der/dábat+A+Sg+Gen	Maidenheadalašdábaga	mˈɑjː.ten.heæd>ɑ.lɑʃ»dˌɑː.bɑ.gɑ
Maidenhead+N+Prop+Der/laš+A+AttrCmp+Der/rattat+A+Sg+Nom	Maidenheadalašrattat	mˈɑjː.ten.heæd>ɑ.lɑʃ»rˌɑt.tɑh
Maidenhead+N+Prop+Der/laš+A+Sg+Nom	Maidenheadalaš	mˈɑjː.ten.heæd>ɑ.lɑʃ
Maidenhead+N+Prop+Der/laš+A+Sg+Nom+PxDu2	Maidenheadalažžade	mˈɑjː.ten.heæd>ɑ.lɑdː.tʃɑ.de
Maidenhead+N+Prop+Der/laš+A+Sg+Nom+PxSg3	Maidenheadalažžas	mˈɑjː.ten.heæd>ɑ.lɑdː.tʃɑs
Maidenhead+N+Prop+Der/laš+A+Ess+PxDu3	Maidenheadalažžaneaskka	mˈɑjː.ten.heæd>ɑ.lɑdː.tʃɑ.neæs.kɑ
Maidenhead+N+Prop+Der/laš+A+Ess+PxSg2	Maidenheadalažžanat	mˈɑjː.ten.heæd>ɑ.lɑdː.tʃɑ.nɑh
Maidenhead+N+Prop+Der/laš+A+Sg+Ill	Maidenheadalažžii	mˈɑjː.ten.heæd>ɑ.lɑdː.tʃij
Need+N+Prop+Ess	Needan	nˈe.ed>ɑn
Need+N+Prop+Sg+Gen	Need	nˈe.ed>
Need+N+Prop+Sg+Nom	Need	nˈe.ed>
Need+N+Prop+Sg+Acc	Needa	nˈe.ed>ɑ
Need+N+Prop+Sg+Com	Needain	nˈe.ed>ɑjn
Need+N+Prop+Sg+Gen	Needa	nˈe.ed>ɑ
Need+N+Prop+Sg+Loc	Needas	nˈe.ed>ɑs
Need+N+Prop+Sg+Ill	Needii	nˈe.ed>ij
Northamptonshire+N+Prop+Ess	Northamptonshiren	nˈorth.ɑmhp.ton#shˌi.re>n
Northamptonshire+N+Prop+Sg+Gen	Northamptonshire	nˈorth.ɑmhp.ton#shˌi.re>
Northamptonshire+N+Prop+Sg+Nom	Northamptonshire	nˈorth.ɑmhp.ton#shˌi.re>
Northamptonshire+N+Prop+Sg+Loc	Northamptonshires	nˈorth.ɑmhp.ton#shˌi.re>s
Northamptonshire+N+Prop+Der/laš+A+Pl+Ill+PxSg2	Northamptonshirelaččaidasat	nˈorth.ɑmhp.ton#shˌi.re>lɑt.tʃɑj.dɑ.sɑh
Northamptonshire+N+Prop+Der/laš+A+Pl+Nom	Northamptonshirelaččat	nˈorth.ɑmhp.ton#shˌi.re>lɑt.tʃɑh
Northamptonshire+N+Prop+Der/laš+A+Sg+Acc	Northamptonshirelačča	nˈorth.ɑmhp.ton#shˌi.re>lɑt.tʃɑ
Northamptonshire+N+Prop+Der/laš+A+Sg+Ill+PxSg2	Northamptonshirelažžasat	nˈorth.ɑmhp.ton#shˌi.re>lɑdː.tʃɑ.sɑh
Northamptonshire+N+Prop+Der/laš+A+Sg+Ill	Northamptonshirelažžii	nˈorth.ɑmhp.ton#shˌi.re>lɑdː.tʃij
Northamptonshire+N+Prop+Sg+Com	Northamptonshiriin	nˈorth.ɑmhp.ton#shˌi.ri>in
Northamptonshire+N+Prop+Sg+Ill	Northamptonshirii	nˈorth.ɑmhp.ton#shˌi.ri>i
Nottinghamshire+N+Prop+Ess	Nottinghanshiren	nˈotː.ting.hɑn#shˌi.re>n
Nottinghamshire+N+Prop+Sg+Gen	Nottinghanshire	nˈotː.ting.hɑn#shˌi.re>
Nottinghamshire+N+Prop+Sg+Loc	Nottinghanshires	nˈotː.ting.hɑn#shˌi.re>s
Nottinghamshire+N+Prop+Der/laš+A+Sg+Loc	Nottinghanshirelaččas	nˈotː.ting.hɑn#shˌi.re>lɑt.tʃɑs
Nottinghamshire+N+Prop+Der/laš+A+Sg+Loc+PxSg3	Nottinghanshirelaččastis	nˈotː.ting.hɑn#shˌi.re>lɑt.tʃɑs.tis
Nottinghamshire+N+Prop+Der/laš+A+Attr	Nottinghanshirelaš	nˈotː.ting.hɑn#shˌi.re>lɑʃ
Nottinghamshire+N+Prop+Der/laš+A+Sg+Nom	Nottinghanshirelaš	nˈotː.ting.hɑn#shˌi.re>lɑʃ
Nottinghamshire+N+Prop+Der/laš+A+Sg+Acc+PxDu1	Nottinghanshirelažžame	nˈotː.ting.hɑn#shˌi.re>lɑdː.tʃɑ.me
Nottinghamshire+N+Prop+Der/laš+A+Sg+Ill	Nottinghanshirelažžii	nˈotː.ting.hɑn#shˌi.re>lɑdː.tʃij
Nottinghamshire+N+Prop+Sg+Com	Nottinghanshiriin	nˈotː.ting.hɑn#shˌi.ri>in
Nottinghamshire+N+Prop+Sg+Ill	Nottinghanshirii	nˈotː.ting.hɑn#shˌi.ri>i
Oxfordshire+N+Prop+Ess	Oxforshiren	ˈoks.for#shˌi.re>n
Oxfordshire+N+Prop+Sg+Acc	Oxforshire	ˈoks.for#shˌi.re>
Oxfordshire+N+Prop+Sg+Gen	Oxforshire	ˈoks.for#shˌi.re>
Oxfordshire+N+Prop+Sg+Loc	Oxforshires	ˈoks.for#shˌi.re>s
Oxfordshire+N+Prop+Der/laš+A+Pl+Com+PxPl2	Oxforshirelaččaideattetguin	ˈoks.for#shˌi.re>lɑt.tʃɑj.dĕæt.tet.gujn
Oxfordshire+N+Prop+Der/laš+A+Pl+Nom	Oxforshirelaččat	ˈoks.for#shˌi.re>lɑt.tʃɑh
Oxfordshire+N+Prop+Der/laš+A+Sg+Com+PxPl2	Oxforshirelaččaineattet	ˈoks.for#shˌi.re>lɑt.tʃɑj.nĕæt.teh
Oxfordshire+N+Prop+Der/laš+A+Sg+Gen	Oxforshirelačča	ˈoks.for#shˌi.re>lɑt.tʃɑ
Oxfordshire+N+Prop+Der/laš+A+Sg+Loc	Oxforshirelaččas	ˈoks.for#shˌi.re>lɑt.tʃɑs
Oxfordshire+N+Prop+Der/laš+A+Sg+Loc+PxDu2	Oxforshirelaččasteatte	ˈoks.for#shˌi.re>lɑt.tʃɑs.tĕæt.te
Oxfordshire+N+Prop+Der/laš+A+Sg+Nom	Oxforshirelaš	ˈoks.for#shˌi.re>lɑʃ
Oxfordshire+N+Prop+Der/laš+A+Sg+Ill+PxDu2	Oxforshirelažžaseatte	ˈoks.for#shˌi.re>lɑdː.tʃɑ.sĕæt.te
Oxfordshire+N+Prop+Der/laš+A+Sg+Ill+PxPl1	Oxforshirelažžaseamet	ˈoks.for#shˌi.re>lɑdː.tʃɑ.sĕæ.meh
Oxfordshire+N+Prop+Der/laš+A+Ess+PxPl3	Oxforshirelažžaneaset	ˈoks.for#shˌi.re>lɑdː.tʃɑ.nĕæ.seh
Oxfordshire+N+Prop+Der/laš+A+Ess+PxSg1	Oxforshirelažžanan	ˈoks.for#shˌi.re>lɑdː.tʃɑ.nɑn
Oxfordshire+N+Prop+Der/laš+A+Ess	Oxforshirelažžan	ˈoks.for#shˌi.re>lɑdː.tʃɑn
Oxfordshire+N+Prop+Der/laš+A+Sg+Ill	Oxforshirelažžii	ˈoks.for#shˌi.re>lɑdː.tʃij
Oxfordshire+N+Prop+Sg+Com	Oxforshiriin	ˈoks.for#shˌi.ri>in
Oxfordshire+N+Prop+Sg+Ill	Oxforshirii	ˈoks.for#shˌi.ri>i
Paintbrush+N+Prop+Sem/Sur+Ess	Paintbrushan	phˈɑjnt.brush>ɑn
Paintbrush+N+Prop+Sem/Sur+Pl+Acc	Paintbrushaid	phˈɑjnt.brush>ɑjh
Paintbrush+N+Prop+Sem/Sur+Pl+Gen	Paintbrushaid	phˈɑjnt.brush>ɑjh
Paintbrush+N+Prop+Sem/Sur+Pl+Ill	Paintbrushaide	phˈɑjnt.brush>ɑj.de
Paintbrush+N+Prop+Sem/Sur+Pl+Loc	Paintbrushain	phˈɑjnt.brush>ɑjn
Paintbrush+N+Prop+Sem/Sur+Pl+Nom	Paintbrushat	phˈɑjnt.brush>ɑh
Paintbrush+N+Prop+Sem/Sur+Sg+Acc	Paintbrush	phˈɑjnt.brush>
Paintbrush+N+Prop+Sem/Sur+Sg+Gen	Paintbrush	phˈɑjnt.brush>
Paintbrush+N+Prop+Sem/Sur+Sg+Nom	Paintbrush	phˈɑjnt.brush>
Paintbrush+N+Prop+Sem/Sur+Sg+Acc	Paintbrusha	phˈɑjnt.brush>ɑ
Paintbrush+N+Prop+Sem/Sur+Sg+Com	Paintbrushain	phˈɑjnt.brush>ɑjn
Paintbrush+N+Prop+Sem/Sur+Sg+Gen	Paintbrusha	phˈɑjnt.brush>ɑ
Paintbrush+N+Prop+Sem/Sur+Sg+Loc	Paintbrushas	phˈɑjnt.brush>ɑs
Paintbrush+N+Prop+Sem/Sur+Sg+Ill	Paintbrushii	phˈɑjnt.brush>ij
Reed+N+Prop+Sem/Sur+Ess	Reedan	rˈe.ed>ɑn
Reed+N+Prop+Sem/Sur+Pl+Acc	Reedaid	rˈe.ed>ɑjh
Reed+N+Prop+Sem/Sur+Pl+Com	Reedaiguin	rˈe.ed>ɑj.gujn
Reed+N+Prop+Sem/Sur+Pl+Gen	Reedaid	rˈe.ed>ɑjh
Reed+N+Prop+Sem/Sur+Pl+Ill	Reedaide	rˈe.ed>ɑj.de
Reed+N+Prop+Sem/Sur+Pl+Loc	Reedain	rˈe.ed>ɑjn
Reed+N+Prop+Sem/Sur+Pl+Nom	Reedat	rˈe.ed>ɑh
Reed+N+Prop+Sem/Sur+Sg+Acc	Reed	rˈe.ed>
Reed+N+Prop+Sem/Sur+Sg+Gen	Reed	rˈe.ed>
Reed+N+Prop+Sem/Sur+Sg+Nom	Reed	rˈe.ed>
Reed+N+Prop+Sem/Sur+Sg+Acc	Reeda	rˈe.ed>ɑ
Reed+N+Prop+Sem/Sur+Sg+Com	Reedain	rˈe.ed>ɑjn
Reed+N+Prop+Sem/Sur+Sg+Gen	Reeda	rˈe.ed>ɑ
Reed+N+Prop+Sem/Sur+Sg+Loc	Reedas	rˈe.ed>ɑs
Reed+N+Prop+Sem/Sur+Sg+Ill	Reedii	rˈe.ed>ij
Shropshire+N+Prop+Ess	Shrotshiren	shrˈoh#shˌi.re>n
Shropshire+N+Prop+Sg+Gen	Shrotshire	shrˈoh#shˌi.re>
Shropshire+N+Prop+Sg+Loc	Shrotshires	shrˈoh#shˌi.re>s
Shropshire+N+Prop+Der/laš+A+Sg+Gen	Shrotshirelačča	shrˈoh#shˌi.re>lɑt.tʃɑ
Shropshire+N+Prop+Der/laš+A+Sg+Loc	Shrotshirelaččas	shrˈoh#shˌi.re>lɑt.tʃɑs
Shropshire+N+Prop+Der/laš+A+Attr	Shrotshirelaš	shrˈoh#shˌi.re>lɑʃ
Shropshire+N+Prop+Der/laš+A+AttrCmp+Der/asat+A+Sg+Acc	Shrotshirelašasaga	shrˈoh#shˌi.re>lɑʃ»ˌɑ.sɑ.gɑ
Shropshire+N+Prop+Der/laš+A+AttrCmp+Der/hámat+A+Attr	Shrotshirelašhámat	shrˈoh#shˌi.re>lɑʃ»hˌɑː.mɑh
Shropshire+N+Prop+Der/laš+A+Sg+Ill	Shrotshirelažžii	shrˈoh#shˌi.re>lɑdː.tʃij
Shropshire+N+Prop+Sg+Com	Shrotshiriin	shrˈoh#shˌi.ri>in
Shropshire+N+Prop+Sg+Ill	Shrotshirii	shrˈoh#shˌi.ri>i
Staffordshire+N+Prop+Ess	Stafforshiren	stˈɑf.for#shˌi.re>n
Staffordshire+N+Prop+Sg+Acc	Stafforshire	stˈɑf.for#shˌi.re>
Staffordshire+N+Prop+Sg+Gen	Stafforshire	stˈɑf.for#shˌi.re>
Staffordshire+N+Prop+Sg+Loc	Stafforshires	stˈɑf.for#shˌi.re>s
Staffordshire+N+Prop+Der/laš+A+Pl+Gen+PxPl2	Stafforshirelaččaideattet	stˈɑf.for#shˌi.re>lɑt.tʃɑj.dĕæt.teh
Staffordshire+N+Prop+Der/laš+A+Pl+Ill	Stafforshirelaččaide	stˈɑf.for#shˌi.re>lɑt.tʃɑj.de
Staffordshire+N+Prop+Der/laš+A+Pl+Loc+PxDu2	Stafforshirelaččaineatte	stˈɑf.for#shˌi.re>lɑt.tʃɑj.nĕæt.te
Staffordshire+N+Prop+Der/laš+A+Sg+Com+PxDu2	Stafforshirelaččaineatte	stˈɑf.for#shˌi.re>lɑt.tʃɑj.nĕæt.te
Staffordshire+N+Prop+Der/laš+A+AttrCmp+Der/vigat+A+Attr	Stafforshirelašvigat	stˈɑf.for#shˌi.re>lɑʃ»vˌi.gɑh
Staffordshire+N+Prop+Der/laš+A+Ess+PxPl3	Stafforshirelažžaneaset	stˈɑf.for#shˌi.re>lɑdː.tʃɑ.nĕæ.seh
Staffordshire+N+Prop+Der/laš+A+Ess+PxSg1	Stafforshirelažžanan	stˈɑf.for#shˌi.re>lɑdː.tʃɑ.nɑn
Staffordshire+N+Prop+Sg+Com	Stafforshiriin	stˈɑf.for#shˌi.ri>in
Staffordshire+N+Prop+Sg+Ill	Stafforshirii	stˈɑf.for#shˌi.ri>i
Tweed+N+Prop+Sem/Sur+Ess	Tweedan	tβˈe.ed>ɑn
Tweed+N+Prop+Sem/Sur+Pl+Acc	Tweedaid	tβˈe.ed>ɑjh
Tweed+N+Prop+Sem/Sur+Pl+Com	Tweedaiguin	tβˈe.ed>ɑj.gujn
Tweed+N+Prop+Sem/Sur+Pl+Gen	Tweedaid	tβˈe.ed>ɑjh
Tweed+N+Prop+Sem/Sur+Pl+Loc	Tweedain	tβˈe.ed>ɑjn
Tweed+N+Prop+Sem/Sur+Pl+Nom	Tweedat	tβˈe.ed>ɑh
Tweed+N+Prop+Sem/Sur+Sg+Acc	Tweed	tβˈe.ed>
Tweed+N+Prop+Sem/Sur+Sg+Gen	Tweed	tβˈe.ed>
Tweed+N+Prop+Sem/Sur+Sg+Nom	Tweed	tβˈe.ed>
Tweed+N+Prop+Sem/Sur+Sg+Acc	Tweeda	tβˈe.ed>ɑ
Tweed+N+Prop+Sem/Sur+Sg+Com	Tweedain	tβˈe.ed>ɑjn
Tweed+N+Prop+Sem/Sur+Sg+Gen	Tweeda	tβˈe.ed>ɑ
Tweed+N+Prop+Sem/Sur+Sg+Loc	Tweedas	tβˈe.ed>ɑs
Tweed+N+Prop+Sem/Sur+Sg+Ill	Tweedii	tβˈe.ed>ij
Warwickshire+N+Prop+Ess	Warwickshiren	βˈɑr.βitsk#shˌi.re>n
Warwickshire+N+Prop+Sg+Gen	Warwickshire	βˈɑr.βitsk#shˌi.re>
Warwickshire+N+Prop+Sg+Loc	Warwickshires	βˈɑr.βitsk#shˌi.re>s
Warwickshire+N+Prop+Der/laš+A+Pl+Ill	Warwickshirelaččaide	βˈɑr.βitsk#shˌi.re>lɑt.tʃɑj.de
Warwickshire+N+Prop+Sg+Com	Warwickshiriin	βˈɑr.βitsk#shˌi.ri>in
Warwickshire+N+Prop+Sg+Ill	Warwickshirii	βˈɑr.βitsk#shˌi.ri>i
Whateverland+N+Prop+Sg+Acc	Whateverlanda	βhˈɑt.e.ver#lɑnd>ɑ
Whateverland+N+Prop+Der/laš+A+Sg+Acc+PxSg2	Whateverlandalaččat	βhˈɑt.e.ver#lɑnd>ɑ.lɑt.tʃɑh
Whateverland+N+Prop+Der/laš+A+AttrCmp+Der/jagat+A+Pl+Nom	Whateverlandalašjagagat	βhˈɑt.e.ver#lɑnd>ɑ.lɑʃ»jˌɑ.gɑ.gɑh
Whateverland+N+Prop+Der/laš+A+Sg+Ill	Whateverlandalažžii	βhˈɑt.e.ver#lɑnd>ɑ.lɑdː.tʃij
Wheel+N+Prop+Sem/Sur+Pl+Acc	Wheelaid	βhˈe.el>ɑjh
WheelMouse+N+Prop+Sg+Gen	WheelMouse	βhˈe.elə.mˌou.se>
Whist+N+Prop+Sem/Sur+Sg+Gen	Whista	βhˈist>ɑ
Whist+N+Prop+Sem/Sur+Sg+Ill	Whistii	βhˈist>ij
Whitehorse+N+Prop+Sem/Sur+Pl+Com	Whitehorsiiguin	βhˈi.te.hˌorə.si>i.gujn
Whitesnake+N+Prop+Ess	Whitesnaken	βhˈi.te.snˌɑ.ke>n
White+N+Prop+Sem/Sur+Pl+Com	Whitiiguin	βhˈi.ti>i.gujn
White+N+Prop+Sem/Sur+Sg+Ill	Whitii	βhˈi.ti>i
Wiltshire+N+Prop+Ess	Wiltshiren	βˈilh#shˌi.re>n
Wiltshire+N+Prop+Sg+Acc	Wiltshire	βˈilh#shˌi.re>
Wiltshire+N+Prop+Sg+Loc	Wiltshires	βˈilh#shˌi.re>s
Wiltshire+N+Prop+Der/laš+A+AttrCmp+Der/ivnnat+A+Pl+Nom	Wiltshirelašivnnagat	βˈilh#shˌi.re>lɑʃ»ˌivn.nɑ.gɑh
Wiltshire+N+Prop+Der/laš+A+Sg+Nom+PxSg1	Wiltshirelažžan	βˈilh#shˌi.re>lɑdː.tʃɑn
Wiltshire+N+Prop+Der/laš+A+Ess+PxPl2	Wiltshirelažžaneattet	βˈilh#shˌi.re>lɑdː.tʃɑ.nĕæt.teh
Wiltshire+N+Prop+Sg+Com	Wiltshiriin	βˈilh#shˌi.ri>in
Wiltshire+N+Prop+Sg+Ill	Wiltshirii	βˈilh#shˌi.ri>i
Yorkshire+N+Prop+Ess	Yorkshiren	ˈyork#shˌi.re>n
Yorkshire+N+Prop+Sg+Acc	Yorkshire	ˈyork#shˌi.re>
Yorkshire+N+Prop+Sg+Gen	Yorkshire	ˈyork#shˌi.re>
Yorkshire+N+Prop+Sg+Nom	Yorkshire	ˈyork#shˌi.re>
Yorkshire+N+Prop+Sg+Loc	Yorkshires	ˈyork#shˌi.re>s
Yorkshire+N+Prop+Der/laš+A+Pl+Loc+PxSg2	Yorkshirelaččainat	ˈyork#shˌi.re>lɑt.tʃɑj.nɑh
Yorkshire+N+Prop+Der/laš+A+Pl+Loc+PxSg3	Yorkshirelaččainis	ˈyork#shˌi.re>lɑt.tʃɑj.nis
Yorkshire+N+Prop+Der/laš+A+Sg+Gen+PxPl2	Yorkshirelaččadet	ˈyork#shˌi.re>lɑt.tʃɑ.deh
Yorkshire+N+Prop+Der/laš+A+Attr+Der/vuohta+N+Sg+Loc	Yorkshirelašvuođas	ˈyork#shˌi.re>lɑʃ»vˌuo.ðɑs
Yorkshire+N+Prop+Der/laš+A+Sg+Nom	Yorkshirelaš	ˈyork#shˌi.re>lɑʃ
Yorkshire+N+Prop+Der/laš+A+Ess+PxDu1	Yorkshirelažžaneame	ˈyork#shˌi.re>lɑdː.tʃɑ.nĕæ.me
Yorkshire+N+Prop+Der/laš+A+Ess+PxDu3	Yorkshirelažžaneaskka	ˈyork#shˌi.re>lɑdː.tʃɑ.neæs.kɑ
Yorkshire+N+Prop+Der/laš+A+Sg+Ill	Yorkshirelažžii	ˈyork#shˌi.re>lɑdː.tʃij
Yorkshire+N+Prop+Sg+Com	Yorkshiriin	ˈyork#shˌi.ri>in
Yorkshire+N+Prop+Sg+Ill	Yorkshirii	ˈyork#shˌi.ri>i
actionpop+N+Sg+Nom	actionpop	ˈɑts.tion#pʰop>
actionpop+N+Ess+PxDu1	actionpopaneame	ˈɑts.tion#phˌo.pɑ>nĕæ.me
actionpop+N+Ess+PxDu2	actionpopaneatte	ˈɑts.tion#phˌo.pɑ>nĕæt.te
actionpop+N+Ess+PxDu3	actionpopaneaskka	ˈɑts.tion#phˌo.pɑ>neæs.kɑ
actionpop+N+Ess+PxPl1	actionpopaneamet	ˈɑts.tion#phˌo.pɑ>nĕæ.meh
actionpop+N+Ess+PxPl2	actionpopaneattet	ˈɑts.tion#phˌo.pɑ>nĕæt.teh
actionpop+N+Ess+PxPl3	actionpopaneaset	ˈɑts.tion#phˌo.pɑ>nĕæ.seh
actionpop+N+Ess+PxSg2	actionpopanat	ˈɑts.tion#phˌo.pɑ>nɑh
actionpop+N+Ess+PxSg3	actionpopanis	ˈɑts.tion#phˌo.pɑ>nis
actionpop+N+Pl+Acc+PxDu2	actionpopaideatte	ˈɑts.tion#phˌo.pɑ>i.dĕæt.te
actionpop+N+Pl+Acc+PxDu3	actionpopaideaskka	ˈɑts.tion#phˌo.pɑ>i.deæs.kɑ
actionpop+N+Pl+Acc+PxSg2	actionpopaidat	ˈɑts.tion#phˌo.pɑ>i.dɑh
actionpop+N+Pl+Acc+PxSg3	actionpopaidis	ˈɑts.tion#phˌo.pɑ>i.dis
actionpop+N+Pl+Com+PxSg1	actionpopaidanguin	ˈɑts.tion#phˌo.pɑ>i.dɑn.gujn
actionpop+N+Pl+Com	actionpopaiguin	ˈɑts.tion#phˌo.pɑ>i.gujn
actionpop+N+Pl+Gen+PxDu3	actionpopaideaskka	ˈɑts.tion#phˌo.pɑ>i.deæs.kɑ
actionpop+N+Pl+Gen+PxSg2	actionpopaidat	ˈɑts.tion#phˌo.pɑ>i.dɑh
actionpop+N+Pl+Ill+PxDu2	actionpopaidaseatte	ˈɑts.tion#phˌo.pɑ>i.dɑ.sĕæt.te
actionpop+N+Pl+Ill+PxPl3	actionpopaidaseaset	ˈɑts.tion#phˌo.pɑ>i.dɑ.sĕæ.seh
actionpop+N+Pl+Ill+PxSg3	actionpopaidasis	ˈɑts.tion#phˌo.pɑ>i.dɑ.sis
actionpop+N+Pl+Ill	actionpopaide	ˈɑts.tion#phˌo.pɑ>i.de
actionpop+N+Pl+Loc+PxDu3	actionpopaineaskka	ˈɑts.tion#phˌo.pɑ>i.neæs.kɑ
actionpop+N+Pl+Loc+PxSg2	actionpopainat	ˈɑts.tion#phˌo.pɑ>i.nɑh
actionpop+N+Pl+Nom+PxPl1	actionpopaideamet	ˈɑts.tion#phˌo.pɑ>i.dĕæ.meh
actionpop+N+Pl+Nom+PxSg1	actionpopaidan	ˈɑts.tion#phˌo.pɑ>i.dɑn
actionpop+N+Pl+Nom	actionpopat	ˈɑts.tion#phˌo.pɑ>h
actionpop+N+Sg+Acc+PxDu1	actionpopame	ˈɑts.tion#phˌo.pɑ>me
actionpop+N+Sg+Acc+PxPl3	actionpopaset	ˈɑts.tion#phˌo.pɑ>seh
actionpop+N+Sg+Acc+PxSg2	actionpopat	ˈɑts.tion#phˌo.pɑ>h
actionpop+N+Sg+Com+PxSg2	actionpopainat	ˈɑts.tion#phˌo.pɑ>i.nɑh
actionpop+N+Sg+Com+PxSg3	actionpopainis	ˈɑts.tion#phˌo.pɑ>i.nis
actionpop+N+Sg+Com	actionpopain	ˈɑts.tion#phˌo.pɑ>in
actionpop+N+Sg+Gen+PxPl2	actionpopadet	ˈɑts.tion#phˌo.pɑ>deh
actionpop+N+Sg+Ill+PxDu1	actionpopasame	ˈɑts.tion#phˌo.pɑ>sɑ.me
actionpop+N+Sg+Ill+PxDu3	actionpopasaskka	ˈɑts.tion#phˌo.pɑ>sɑs.kɑ
actionpop+N+Sg+Ill+PxPl3	actionpopasaset	ˈɑts.tion#phˌo.pɑ>sɑ.seh
actionpop+N+Sg+Loc	actionpopas	ˈɑts.tion#phˌo.pɑ>s
actionpop+N+Sg+Loc+PxSg1	actionpopastan	ˈɑts.tion#phˌo.pɑ>stɑn
actionpop+N+Sg+Nom+PxPl1	actionpopamet	ˈɑts.tion#phˌo.pɑ>meh
actionpop+N+Sg+Nom+PxPl2	actionpopadet	ˈɑts.tion#phˌo.pɑ>deh
actionpop+N+Sg+Nom+PxSg3	actionpopas	ˈɑts.tion#phˌo.pɑ>s
actionpop+N+Der/Dimin+N+Sg+Nom	actionpopaš	ˈɑts.tion#phˌo.pɑ>»ʃ
actionpop+N+Der/Dimin+N+Ess	actionpopažin	ˈɑts.tion#phˌo.pɑ>»žin
actionpop+N+Der/Dimin+N+Sg+Nom+PxPl1	actionpopažeamet	ˈɑts.tion#phˌo.pɑ>»žˌĕæ.meh
actionpop+N+Der/Dimin+N+Sg+Ill+PxPl3	actionpopažasaset	ˈɑts.tion#phˌo.pɑ>»žˌɑ.sɑ.seh
actionpop+N+Der/Dimin+N+Der/Dimin+N+Sg+Nom	actionpopažaš	ˈɑts.tion#phˌo.pɑ>»žɑʃ
actionpop+N+Der/heapmi+A+Comp+Sg+Nom	actionpopahat	ˈɑts.tion#phˌo.pɑ>»hɑh
actionpop+N+Der/heapmi+A+Ess	actionpopaheapmin	ˈɑts.tion#phˌo.pɑ>»hˌeæp.min
actionpop+N+Der/heapmi+A+Attr+Der/vuohta+N+Der/viđá+Adv	actionpopahisvuohtaviđá	ˈɑts.tion#phˌo.pɑ>»his»vˌuoh.tɑ»vˌi.ðɑː
actionpop+N+Der/huhtti+V+TV+Ind+Prs+ConNeg	actionpopahuhte	ˈɑts.tion#phˌo.pɑ>»hˌuh.te
actionpop+N+Der/huhtti+V+TV+VAbess	actionpopahuhtihaga	ˈɑts.tion#phˌo.pɑ>»hˌuh.ti.hˌɑ.gɑ
actionpop+N+Der/huhtti+V+TV+Cond+Prs+Sg2	actionpopahuhtášedjet	ˈɑts.tion#phˌo.pɑ>»hˌuhː.tɑː.ʃˌec.ceh
actionpop+N+Der/huhtti+V+TV+Ind+Prs+Sg2	actionpopahuhtát	ˈɑts.tion#phˌo.pɑ>»hˌuhː.tɑːh
actionpop+N+Der/huvva+V+IV+Cond+Prs+Sg3	actionpopahuvašii	ˈɑts.tion#phˌo.pɑ>»hˌu.vɑ.ʃij
actionpop+N+Der/huvva+V+IV+Ger+PxPl3	actionpopahuvadettiineaset	ˈɑts.tion#phˌo.pɑ>»hˌu.vɑ.dˌet.tij.nˌĕæ.seh
actionpop+N+Der/huvva+V+IV+Ind+Prt+Pl2	actionpopahuvaidet	ˈɑts.tion#phˌo.pɑ>»hˌu.vɑj.deh
actionpop+N+Der/huvva+V+IV+VAbess+A+Attr	actionpopahuvakeahtes	ˈɑts.tion#phˌo.pɑ>»hˌu.vɑ.kˌĕæh.tes
actionpop+N+Der/huvva+V+IV+VGen	actionpopahuva	ˈɑts.tion#phˌo.pɑ>»hˌu.vɑ
actionpop+N+Der/huvva+V+IV+Ind+Prs+Sg3	actionpopahuvvá	ˈɑts.tion#phˌo.pɑ>»hˌuvː.vɑː
actionpop+N+Sg+Ill	actionpopii	ˈɑts.tion#phˌo.pi>i
aerográmma+N+Ess+PxDu1	aerográmmaneame	ˈɑe.ro.grˌɑːm.mɑ>nĕæ.me
aerográmma+N+Ess+PxDu3	aerográmmaneaskka	ˈɑe.ro.grˌɑːm.mɑ>neæs.kɑ
aerográmma+N+Ess+PxSg1	aerográmmanan	ˈɑe.ro.grˌɑːm.mɑ>nɑn
aerográmma+N+Ess+PxSg2	aerográmmanat	ˈɑe.ro.grˌɑːm.mɑ>nɑh
aerográmma+N+Ess	aerográmman	ˈɑe.ro.grˌɑːm.mɑ>n
aerográmma+N+Pl+Acc+PxPl1	aerográmmaideamet	ˈɑe.ro.grˌɑːm.mɑ>i.dĕæ.meh
aerográmma+N+Pl+Acc+PxSg2	aerográmmaidat	ˈɑe.ro.grˌɑːm.mɑ>i.dɑh
aerográmma+N+Pl+Com+PxDu1	aerográmmaideameguin	ˈɑe.ro.grˌɑːm.mɑ>i.dĕæ.me.gujn
aerográmma+N+Pl+Com	aerográmmaiguin	ˈɑe.ro.grˌɑːm.mɑ>i.gujn
aerográmma+N+Pl+Loc+PxDu3	aerográmmaineaskka	ˈɑe.ro.grˌɑːm.mɑ>i.neæs.kɑ
aerográmma+N+Pl+Nom+PxPl2	aerográmmaideattet	ˈɑe.ro.grˌɑːm.mɑ>i.dĕæt.teh
aerográmma+N+Pl+Nom	aerográmmat	ˈɑe.ro.grˌɑːm.mɑ>h
aerográmma+N+Sg+Acc+PxPl1	aerográmmamet	ˈɑe.ro.grˌɑːm.mɑ>meh
aerográmma+N+Sg+Acc	aerográmma	ˈɑe.ro.grˌɑːm.mɑ>
aerográmma+N+Sg+Gen+PxPl1	aerográmmamet	ˈɑe.ro.grˌɑːm.mɑ>meh
aerográmma+N+Sg+Gen+PxSg1	aerográmman	ˈɑe.ro.grˌɑːm.mɑ>n
aerográmma+N+Sg+Gen+PxSg3	aerográmmas	ˈɑe.ro.grˌɑːm.mɑ>s
aerográmma+N+Sg+Ill+PxSg1	aerográmmasan	ˈɑe.ro.grˌɑːm.mɑ>sɑn
aerográmma+N+Sg+Nom+PxPl1	aerográmmamet	ˈɑe.ro.grˌɑːm.mɑ>meh
aerográmma+N+Sg+Com+PxDu1	aerográmmaineame	ˈɑe.ro.grˌɑːm.mɑ>i.nĕæ.me
aerográmma+N+Sg+Com+PxDu2	aerográmmaineatte	ˈɑe.ro.grˌɑːm.mɑ>i.nĕæt.te
aerográmma+N+Sg+Com+PxPl1	aerográmmaineamet	ˈɑe.ro.grˌɑːm.mɑ>i.nĕæ.meh
aerográmma+N+Sg+Com+PxSg1	aerográmmainan	ˈɑe.ro.grˌɑːm.mɑ>i.nɑn
aerográmma+N+Sg+Loc	aerográmmas	ˈɑe.ro.grˌɑːm.mɑ>s
aerográmma+N+Sg+Loc+PxDu2	aerográmmasteatte	ˈɑe.ro.grˌɑːm.mɑ>stĕæt.te
aerográmma+N+Sg+Loc+PxPl1	aerográmmasteamet	ˈɑe.ro.grˌɑːm.mɑ>stĕæ.meh
aerográmma+N+Sg+Loc+PxPl3	aerográmmasteaset	ˈɑe.ro.grˌɑːm.mɑ>stĕæ.seh
aerográmma+N+Sg+Loc+PxSg2	aerográmmastat	ˈɑe.ro.grˌɑːm.mɑ>stɑh
aerográmma+N+Der/Dimin+N+Sg+Nom	aerográmmaš	ˈɑe.ro.grˌɑːm.mɑ»ʃ
aerográmma+N+Der/Dimin+N+Ess	aerográmmažin	ˈɑe.ro.grˌɑːm.mɑ»dʃin
aerográmma+N+Der/Dimin+N+Sg+Gen+PxPl3	aerográmmažeaset	ˈɑe.ro.grˌɑːm.mɑ»dʃˌĕæ.seh
aerográmma+N+Der/Dimin+N+Der/Dimin+N+Sg+Gen	aerográmmažačča	ˈɑe.ro.grˌɑːm.mɑ»dʃˌɑt.tʃɑ>
aerográmma+N+Der/heapmi+A+Comp+Attr	aerográmmahut	ˈɑe.ro.grˌɑːm.mɑ»hut>
aerográmma+N+Der/heapmi+A+Pl+Ill	aerográmmahemiide	ˈɑe.ro.grˌɑːm.mɑ»hˌe.mi>i.de
aerográmma+N+Der/heapmi+A+Sg+Com	aerográmmahemiin	ˈɑe.ro.grˌɑːm.mɑ»hˌe.mi>in
aerográmma+N+Der/huhtti+V+TV+Ger+PxPl1	aerográmmahuhtedettiineamet	ˈɑe.ro.grˌɑːm.mɑ»hˌuh.te>det.tij.nĕæ.meh
aerográmma+N+Der/huhtti+V+TV+Ger	aerográmmahuhtedin	ˈɑe.ro.grˌɑːm.mɑ»hˌuh.te>din
aerográmma+N+Der/huhtti+V+TV+VAbess	aerográmmahuhtehaga	ˈɑe.ro.grˌɑːm.mɑ»hˌuh.te>hɑ.gɑ
aerográmma+N+Der/huhtti+V+TV+Ger+PxDu3	aerográmmahuhtidettiineaskka	ˈɑe.ro.grˌɑːm.mɑ»hˌuh.ti>det.tij.neæs.kɑ
aerográmma+N+Der/huhtti+V+TV+Imprt+Du1	aerográmmahuhttu	ˈɑe.ro.grˌɑːm.mɑ»hˌuhː.tu>
aerográmma+N+Der/huhtti+V+TV+Imprt+Pl1	aerográmmahuhttut	ˈɑe.ro.grˌɑːm.mɑ»hˌuhː.tu>h
aerográmma+N+Der/huhtti+V+TV+Der/muš+N+Der/viđá+Adv	aerográmmahuhttámoššviđá	ˈɑe.ro.grˌɑːm.mɑ»hˌuhː.tɑː>»moʃː»vˌi.ðɑː
aerográmma+N+Der/huhtti+V+TV+Cond+Prs+ConNeg	aerográmmahuhtále	ˈɑe.ro.grˌɑːm.mɑ»hˌuhː.tɑː>le
aerográmma+N+Der/huhtti+V+TV+Cond+Prs+Sg2	aerográmmahuhtášedjet	ˈɑe.ro.grˌɑːm.mɑ»hˌuhː.tɑː>ʃec.ceh
aerográmma+N+Der/huvva+V+IV+Imprt+Sg2	aerográmmahuva	ˈɑe.ro.grˌɑːm.mɑ»hˌu.vɑ>
aerográmma+N+Der/huvva+V+IV+Inf	aerográmmahuvvat	ˈɑe.ro.grˌɑːm.mɑ»hˌuv.vɑ>h
aerográmma+N+Der/laš+A+Comp+Attr	aerográmmalet	ˈɑe.ro.grˌɑːm.mɑ»let>
aerográmma+N+Der/laš+A+Sg+Nom	aerográmmalaš	ˈɑe.ro.grˌɑːm.mɑ»lɑʃ>
aerográmma+N+Der/laš+A+Der/vuohta+N+Sg+Ill	aerográmmalašvuhtii	ˈɑe.ro.grˌɑːm.mɑ»lɑʃ»vˌuh.ti>i
aerográmma+N+Der/laš+A+Der/vuohta+N+Der/viđá+Adv	aerográmmalašvuohtaviđá	ˈɑe.ro.grˌɑːm.mɑ»lɑʃ»vˌuoh.tɑ»vˌi.ðɑː
aerográmma+N+Der/viđá+Adv	aerográmmaviđá	ˈɑe.ro.grˌɑːm.mɑ»vˌi.ðɑː
aerográmma+N+Sg+Ill	aerográmmii	ˈɑe.ro.grˌɑːm.mi>i
afterskiparty+N+Ess+PxDu1	afterskipartyneame	ˈɑf.terə.ski#phˌɑrə.hty>nĕæ.me
afterskiparty+N+Ess+PxDu2	afterskipartyneatte	ˈɑf.terə.ski#phˌɑrə.hty>nĕæt.te
afterskiparty+N+Ess+PxDu3	afterskipartyneaskka	ˈɑf.terə.ski#phˌɑrə.hty>neæs.kɑ
afterskiparty+N+Ess+PxPl2	afterskipartyneattet	ˈɑf.terə.ski#phˌɑrə.hty>nĕæt.teh
afterskiparty+N+Ess+PxPl3	afterskipartyneaset	ˈɑf.terə.ski#phˌɑrə.hty>nĕæ.seh
afterskiparty+N+Ess+PxSg2	afterskipartynat	ˈɑf.terə.ski#phˌɑrə.hty>nɑh
afterskiparty+N+Ess+PxSg3	afterskipartynis	ˈɑf.terə.ski#phˌɑrə.hty>nis
afterskiparty+N+Ess	afterskipartyn	ˈɑf.terə.ski#phˌɑrə.hty>n
afterskiparty+N+Pl+Acc+PxPl2	afterskipartyideattet	ˈɑf.terə.ski#phˌɑrə.hty>i.dĕæt.teh
afterskiparty+N+Pl+Acc+PxSg1	afterskipartyidan	ˈɑf.terə.ski#phˌɑrə.hty>i.dɑn
afterskiparty+N+Pl+Com+PxDu1	afterskipartyideameguin	ˈɑf.terə.ski#phˌɑrə.hty>i.dĕæ.me.gujn
afterskiparty+N+Pl+Com+PxSg3	afterskipartyidisguin	ˈɑf.terə.ski#phˌɑrə.hty>i.dis.gujn
afterskiparty+N+Pl+Gen+PxSg1	afterskipartyidan	ˈɑf.terə.ski#phˌɑrə.hty>i.dɑn
afterskiparty+N+Pl+Gen+PxSg2	afterskipartyidat	ˈɑf.terə.ski#phˌɑrə.hty>i.dɑh
afterskiparty+N+Pl+Ill+PxPl3	afterskipartyidasaset	ˈɑf.terə.ski#phˌɑrə.hty>i.dɑ.sɑ.seh
afterskiparty+N+Pl+Ill+PxSg1	afterskipartyidasan	ˈɑf.terə.ski#phˌɑrə.hty>i.dɑ.sɑn
afterskiparty+N+Pl+Ill	afterskipartyide	ˈɑf.terə.ski#phˌɑrə.hty>i.de
afterskiparty+N+Pl+Nom+PxPl1	afterskipartyideamet	ˈɑf.terə.ski#phˌɑrə.hty>i.dĕæ.meh
afterskiparty+N+Pl+Nom+PxPl2	afterskipartyideattet	ˈɑf.terə.ski#phˌɑrə.hty>i.dĕæt.teh
afterskiparty+N+Pl+Nom+PxPl3	afterskipartyideaset	ˈɑf.terə.ski#phˌɑrə.hty>i.dĕæ.seh
afterskiparty+N+Pl+Nom	afterskipartyt	ˈɑf.terə.ski#phˌɑrə.hty>h
afterskiparty+N+Sg+Acc+PxDu2	afterskipartyde	ˈɑf.terə.ski#phˌɑrə.hty>de
afterskiparty+N+Sg+Acc+PxDu3	afterskipartyska	ˈɑf.terə.ski#phˌɑrə.hty>skɑ
afterskiparty+N+Sg+Acc+PxSg1	afterskipartyn	ˈɑf.terə.ski#phˌɑrə.hty>n
afterskiparty+N+Sg+Acc	afterskiparty	ˈɑf.terə.ski#phˌɑrə.hty>
afterskiparty+N+Sg+Gen+PxDu2	afterskipartyde	ˈɑf.terə.ski#phˌɑrə.hty>de
afterskiparty+N+Sg+Gen+PxDu3	afterskipartyska	ˈɑf.terə.ski#phˌɑrə.hty>skɑ
afterskiparty+N+Sg+Gen+PxSg3	afterskipartys	ˈɑf.terə.ski#phˌɑrə.hty>s
afterskiparty+N+Sg+Gen	afterskiparty	ˈɑf.terə.ski#phˌɑrə.hty>
afterskiparty+N+Sg+Nom+PxPl1	afterskipartymet	ˈɑf.terə.ski#phˌɑrə.hty>meh
afterskiparty+N+Sg+Nom+PxPl2	afterskipartydet	ˈɑf.terə.ski#phˌɑrə.hty>deh
afterskiparty+N+Sg+Nom+PxPl3	afterskipartyset	ˈɑf.terə.ski#phˌɑrə.hty>seh
afterskiparty+N+Sg+Nom+PxSg1	afterskipartyn	ˈɑf.terə.ski#phˌɑrə.hty>n
afterskiparty+N+Sg+Nom+PxSg2	afterskipartyt	ˈɑf.terə.ski#phˌɑrə.hty>h
afterskiparty+N+Sg+Nom+PxSg3	afterskipartys	ˈɑf.terə.ski#phˌɑrə.hty>s
afterskiparty+N+Sg+Nom	afterskiparty	ˈɑf.terə.ski#phˌɑrə.hty>
afterskiparty+N+Sg+Com+PxDu1	afterskipartyineame	ˈɑf.terə.ski#phˌɑrə.hty>i.nĕæ.me
afterskiparty+N+Sg+Com+PxDu3	afterskipartyineaskka	ˈɑf.terə.ski#phˌɑrə.hty>i.neæs.kɑ
afterskiparty+N+Sg+Com+PxPl2	afterskipartyineattet	ˈɑf.terə.ski#phˌɑrə.hty>i.nĕæt.teh
afterskiparty+N+Sg+Com+PxSg3	afterskipartyinis	ˈɑf.terə.ski#phˌɑrə.hty>i.nis
afterskiparty+N+Sg+Com	afterskipartyin	ˈɑf.terə.ski#phˌɑrə.hty>in
afterskiparty+N+Sg+Ill	afterskipartyi	ˈɑf.terə.ski#phˌɑrə.hty>i
afterskiparty+N+Sg+Ill+PxDu1	afterskipartyseame	ˈɑf.terə.ski#phˌɑrə.hty>sĕæ.me
afterskiparty+N+Sg+Ill+PxDu2	afterskipartyseatte	ˈɑf.terə.ski#phˌɑrə.hty>sĕæt.te
afterskiparty+N+Sg+Ill+PxDu3	afterskipartyseaskka	ˈɑf.terə.ski#phˌɑrə.hty>seæs.kɑ
afterskiparty+N+Sg+Ill+PxPl1	afterskipartyseamet	ˈɑf.terə.ski#phˌɑrə.hty>sĕæ.meh
afterskiparty+N+Sg+Ill+PxSg2	afterskipartysat	ˈɑf.terə.ski#phˌɑrə.hty>sɑh
afterskiparty+N+Sg+Loc	afterskipartys	ˈɑf.terə.ski#phˌɑrə.hty>s
afterskiparty+N+Sg+Loc+PxDu2	afterskipartysteatte	ˈɑf.terə.ski#phˌɑrə.hty>stĕæt.te
afterskiparty+N+Sg+Loc+PxDu3	afterskipartysteaskka	ˈɑf.terə.ski#phˌɑrə.hty>steæs.kɑ
afterskiparty+N+Sg+Loc+PxPl2	afterskipartysteattet	ˈɑf.terə.ski#phˌɑrə.hty>stĕæt.teh
afterskiparty+N+Sg+Loc+PxSg1	afterskipartystan	ˈɑf.terə.ski#phˌɑrə.hty>stɑn
afterskiparty+N+Der/viđá+Adv	afterskipartyviđá	ˈɑf.terə.ski#phˌɑrə.hty>»vˌi.ðɑː
afterskiparty+N+Der/Dimin+N+Sg+Nom	afterskipartyš	ˈɑf.terə.ski#phˌɑrə.hty»ʃ
afterskiparty+N+Der/Dimin+N+Der/viđá+Adv	afterskipartyšviđá	ˈɑf.terə.ski#phˌɑrə.hty»ʃ»vˌi.ðɑː
afterskiparty+N+Der/Dimin+N+Pl+Nom	afterskipartyžat	ˈɑf.terə.ski#phˌɑrə.hty»dʃɑh
afterskiparty+N+Der/Dimin+N+Sg+Gen+PxDu2	afterskipartyžeatte	ˈɑf.terə.ski#phˌɑrə.hty»dʃˌĕæt.te
afterskiparty+N+Der/Dimin+N+Sg+Acc	afterskipartyža	ˈɑf.terə.ski#phˌɑrə.hty»dʃɑ
afterskiparty+N+Der/Dimin+N+Der/Dimin+N+Sg+Ill	afterskipartyžažžii	ˈɑf.terə.ski#phˌɑrə.hty»dʃˌɑdː.tʃi>i
afterskiparty+N+Der/heapmi+A+Comp+Ess	afterskipartyhabbon	ˈɑf.terə.ski#phˌɑrə.hty»hˌɑbː.po>n
afterskiparty+N+Der/heapmi+A+Comp+Sg+Ill	afterskipartyhabbui	ˈɑf.terə.ski#phˌɑrə.hty»hˌɑbː.pu>i
afterskiparty+N+Der/heapmi+A+Comp+Ess	afterskipartyheabbon	ˈɑf.terə.ski#phˌɑrə.hty»hˌĕæbː.po>n
afterskiparty+N+Der/heapmi+A+Comp+Sg+Ill	afterskipartyhebbui	ˈɑf.terə.ski#phˌɑrə.hty»hˌebː.pu>i
afterskiparty+N+Der/heapmi+A+Comp+Attr	afterskipartyhit	ˈɑf.terə.ski#phˌɑrə.hty»hit>
afterskiparty+N+Der/heapmi+A+Comp+Attr	afterskipartyhut	ˈɑf.terə.ski#phˌɑrə.hty»hut>
afterskiparty+N+Der/heapmi+A+Comp+Sg+Nom	afterskipartyhut	ˈɑf.terə.ski#phˌɑrə.hty»hut>
afterskiparty+N+Der/heapmi+A+Superl+Ess	afterskipartyheamosin	ˈɑf.terə.ski#phˌɑrə.hty»hˌĕæ.mos>in
afterskiparty+N+Der/heapmi+A+Superl+Pl+Gen	afterskipartyhepmosiid	ˈɑf.terə.ski#phˌɑrə.hty»hˌep.mos>ijh
afterskiparty+N+Der/heapmi+A+Sg+Nom	afterskipartyheapme	ˈɑf.terə.ski#phˌɑrə.hty»hˌĕæp.me>
afterskiparty+N+Der/heapmi+A+Sg+Ill	afterskipartyheapmái	ˈɑf.terə.ski#phˌɑrə.hty»hˌeæp.mɑː>i
afterskiparty+N+Der/heapmi+A+Pl+Acc	afterskipartyhemiid	ˈɑf.terə.ski#phˌɑrə.hty»hˌe.mi>id
afterskiparty+N+Der/heapmi+A+Pl+Gen	afterskipartyhemiid	ˈɑf.terə.ski#phˌɑrə.hty»hˌe.mi>id
afterskiparty+N+Der/heapmi+A+Pl+Loc	afterskipartyhemiin	ˈɑf.terə.ski#phˌɑrə.hty»hˌe.mi>in
afterskiparty+N+Der/heapmi+A+Sg+Com	afterskipartyhemiin	ˈɑf.terə.ski#phˌɑrə.hty»hˌe.mi>in
afterskiparty+N+Der/heapmi+A+Attr	afterskipartyhis	ˈɑf.terə.ski#phˌɑrə.hty»his>
afterskiparty+N+Der/heapmi+A+Attr+Der/vuohta+N+Sg+Ill	afterskipartyhisvuhtii	ˈɑf.terə.ski#phˌɑrə.hty»his>»vˌuh.tij
afterskiparty+N+Der/heapmi+A+Attr+Der/vuohta+N+Der/viđá+Adv	afterskipartyhisvuohtaviđá	ˈɑf.terə.ski#phˌɑrə.hty»his>»vˌuoh.tɑ»vˌi.ðɑː
afterskiparty+N+Der/huhtti+V+TV+VAbess	afterskipartyhuhtehaga	ˈɑf.terə.ski#phˌɑrə.hty»hˌuh.te>hɑ.gɑ
afterskiparty+N+Der/huhtti+V+TV+VAbess+A+Attr	afterskipartyhuhtekeahtes	ˈɑf.terə.ski#phˌɑrə.hty»hˌuh.te>kĕæh.tes
afterskiparty+N+Der/huhtti+V+TV+VAbess	afterskipartyhuhtekeahttájin	ˈɑf.terə.ski#phˌɑrə.hty»hˌuh.te>kĕæhː.tɑː.jin
afterskiparty+N+Der/huhtti+V+TV+VAbess	afterskipartyhuhtihaga	ˈɑf.terə.ski#phˌɑrə.hty»hˌuh.ti>hɑ.gɑ
afterskiparty+N+Der/huhtti+V+TV+VAbess	afterskipartyhuhtikeahttájin	ˈɑf.terə.ski#phˌɑrə.hty»hˌuh.ti>kĕæhː.tɑː.jin
afterskiparty+N+Der/huhtti+V+TV+Imprt+Pl2	afterskipartyhuhttit	ˈɑf.terə.ski#phˌɑrə.hty»hˌuhː.ti>h
afterskiparty+N+Der/huhtti+V+TV+Imprt+Du1	afterskipartyhuhttu	ˈɑf.terə.ski#phˌɑrə.hty»hˌuhː.tu>
afterskiparty+N+Der/huhtti+V+TV+Der/NomAg+N+Sg+Ill+PxDu1	afterskipartyhuhttáseame	ˈɑf.terə.ski#phˌɑrə.hty»hˌuhː.tɑː>»sˌĕæ.me
afterskiparty+N+Der/huhtti+V+TV+Ind+Prs+Sg3	afterskipartyhuhttá	ˈɑf.terə.ski#phˌɑrə.hty»hˌuhː.tɑː>
afterskiparty+N+Der/huhtti+V+TV+Cond+Prs+Pl2	afterskipartyhuhtáleiddet	ˈɑf.terə.ski#phˌɑrə.hty»hˌuhː.tɑː>lejt.teh
afterskiparty+N+Der/huhtti+V+TV+Cond+Prs+Du1	afterskipartyhuhtášeimme	ˈɑf.terə.ski#phˌɑrə.hty»hˌuhː.tɑː>ʃejm.me
afterskiparty+N+Der/huhtti+V+TV+Cond+Prs+Sg1	afterskipartyhuhtášin	ˈɑf.terə.ski#phˌɑrə.hty»hˌuhː.tɑː>ʃin
afterskiparty+N+Der/huhtti+V+TV+Ind+Prs+Sg2	afterskipartyhuhtát	ˈɑf.terə.ski#phˌɑrə.hty»hˌuhː.tɑː>h
afterskiparty+N+Der/huhtti+V+TV+Sup	afterskipartyhuhtážit	ˈɑf.terə.ski#phˌɑrə.hty»hˌuhː.tɑː>žih
afterskiparty+N+Der/huvva+V+IV+Cond+Prs+Du2	afterskipartyhuvašeidde	ˈɑf.terə.ski#phˌɑrə.hty»hˌu.vɑ>ʃejt.te
afterskiparty+N+Der/huvva+V+IV+Cond+Prs+Sg1	afterskipartyhuvašedjen	ˈɑf.terə.ski#phˌɑrə.hty»hˌu.vɑ>ʃec.cen
afterskiparty+N+Der/huvva+V+IV+Pot+Prs+Sg3	afterskipartyhuvaš	ˈɑf.terə.ski#phˌɑrə.hty»hˌu.vɑ>ʃ
afterskiparty+N+Der/huvva+V+IV+Pot+Prs+Du3	afterskipartyhuvažeaba	ˈɑf.terə.ski#phˌɑrə.hty»hˌu.vɑ>žeæ.bɑ
afterskiparty+N+Der/huvva+V+IV+VAbess	afterskipartyhuvahaga	ˈɑf.terə.ski#phˌɑrə.hty»hˌu.vɑ>hɑ.gɑ
afterskiparty+N+Der/huvva+V+IV+VAbess	afterskipartyhuvakeahttájin	ˈɑf.terə.ski#phˌɑrə.hty»hˌu.vɑ>kĕæhː.tɑː.jin
afterskiparty+N+Der/huvva+V+IV+Ind+Prs+Du2	afterskipartyhuvvabeahtti	ˈɑf.terə.ski#phˌɑrə.hty»hˌuv.vɑ>bĕæhː.ti
afterskiparty+N+Der/huvva+V+IV+Ind+Prt+ConNeg	afterskipartyhuvvan	ˈɑf.terə.ski#phˌɑrə.hty»hˌuv.vɑ>n
afterskiparty+N+Der/huvva+V+IV+PrfPrc	afterskipartyhuvvan	ˈɑf.terə.ski#phˌɑrə.hty»hˌuv.vɑ>n
afterskiparty+N+Der/huvva+V+IV+Der/NomAct+N+Sg+Ill+PxSg3	afterskipartyhuvvamasas	ˈɑf.terə.ski#phˌɑrə.hty»hˌuv.vɑ>»mˌɑ.sɑs
afterskiparty+N+Der/huvva+V+IV+Imprt+Du2	afterskipartyhuvvi	ˈɑf.terə.ski#phˌɑrə.hty»hˌuv.vi>
afterskiparty+N+Der/huvva+V+IV+Ind+Prs+Sg3	afterskipartyhuvvá	ˈɑf.terə.ski#phˌɑrə.hty»hˌuvː.vɑː>
afterskiparty+N+Der/laš+A+Comp+Sg+Acc	afterskipartylabbo	ˈɑf.terə.ski#phˌɑrə.hty»lˌɑbː.po>
afterskiparty+N+Der/laš+A+Comp+Der/at+Adv	afterskipartyleappot	ˈɑf.terə.ski#phˌɑrə.hty»lˌĕæp.po>h
afterskiparty+N+Der/laš+A+Comp+Sg+Loc	afterskipartyleappos	ˈɑf.terə.ski#phˌɑrə.hty»lˌĕæp.po>s
afterskiparty+N+Der/laš+A+Comp+Sg+Nom	afterskipartylit	ˈɑf.terə.ski#phˌɑrə.hty»lit>
afterskiparty+N+Der/laš+A+Comp+Attr	afterskipartylut	ˈɑf.terə.ski#phˌɑrə.hty»lut>
afterskiparty+N+Der/laš+A+Ess	afterskipartylažžan	ˈɑf.terə.ski#phˌɑrə.hty»lˌɑdː.tʃɑ>n
afterskiparty+N+Der/laš+A+Superl+Ess	afterskipartylamosin	ˈɑf.terə.ski#phˌɑrə.hty»lˌɑ.mos>in
afterskiparty+N+Der/laš+A+Superl+Pl+Ill	afterskipartylamosiidda	ˈɑf.terə.ski#phˌɑrə.hty»lˌɑ.mos>ijt.tɑ
afterskiparty+N+Der/laš+A+Superl+Pl+Loc	afterskipartylamosiin	ˈɑf.terə.ski#phˌɑrə.hty»lˌɑ.mos>ijn
afterskiparty+N+Der/laš+A+Superl+Pl+Nom	afterskipartylamosat	ˈɑf.terə.ski#phˌɑrə.hty»lˌɑ.mos>ɑh
afterskiparty+N+Der/laš+A+Superl+Sg+Gen	afterskipartylamosa	ˈɑf.terə.ski#phˌɑrə.hty»lˌɑ.mos>ɑ
afterskiparty+N+Der/laš+A+Superl+Sg+Loc	afterskipartylamosis	ˈɑf.terə.ski#phˌɑrə.hty»lˌɑ.mos>is
afterskiparty+N+Der/laš+A+Superl+Pl+Com	afterskipartylepmosiiguin	ˈɑf.terə.ski#phˌɑrə.hty»lˌep.mos>ij.gujn
afterskiparty+N+Der/laš+A+Attr+Der/vuohta+N+Sg+Ill	afterskipartylašvuhtii	ˈɑf.terə.ski#phˌɑrə.hty»lɑʃ>»vˌuh.tij
afterskiparty+N+Der/laš+A+AttrCmp+Der/agat+A+Pl+Nom	afterskipartylašagagat	ˈɑf.terə.ski#phˌɑrə.hty»lɑʃ>»ˌɑ.gɑ.gɑh
afterskiparty+N+Der/laš+A+AttrCmp+Der/ávjjot+A+Sg+Nom	afterskipartylašávjjot	ˈɑf.terə.ski#phˌɑrə.hty»lɑʃ>»ˌɑːvj.joh
afterskiparty+N+Der/laš+A+Sg+Nom	afterskipartylaš	ˈɑf.terə.ski#phˌɑrə.hty»lɑʃ>
afterskiparty+N+Der/laš+A+Der/vuohta+N+Sg+Gen+PxSg1	afterskipartylašvuohtan	ˈɑf.terə.ski#phˌɑrə.hty»lɑʃ»vˌuoh.tɑ>n
afterskiparty+N+Der/laš+A+Der/vuohta+N+Der/viđá+Adv	afterskipartylašvuohtaviđá	ˈɑf.terə.ski#phˌɑrə.hty»lɑʃ»vˌuoh.tɑ»vˌi.ðɑː
aids+N+Sg+Nom	aids	ˈɑjds>
aids+N+Ess+PxDu2	aidsaneatte	ˈɑjd.sɑː>nĕæt.te
aids+N+Ess+PxPl3	aidsaneaset	ˈɑjd.sɑː>nĕæ.seh
aids+N+Ess+PxSg2	aidsanat	ˈɑjd.sɑː>nɑh
aids+N+Pl+Acc+PxSg2	aidsaidat	ˈɑjd.sɑː>i.dɑh
aids+N+Pl+Gen+PxDu2	aidsaideatte	ˈɑjd.sɑː>i.dĕæt.te
aids+N+Pl+Gen+PxSg3	aidsaidis	ˈɑjd.sɑː>i.dis
aids+N+Pl+Loc+PxSg3	aidsainis	ˈɑjd.sɑː>i.nis
aids+N+Pl+Nom	aidsat	ˈɑjd.sɑː>h
aids+N+Sg+Acc+PxPl1	aidsamet	ˈɑjd.sɑː>meh
aids+N+Sg+Acc+PxSg2	aidsat	ˈɑjd.sɑː>h
aids+N+Sg+Gen+PxPl3	aidsaset	ˈɑjd.sɑː>seh
aids+N+Sg+Ill+PxDu3	aidsasaskka	ˈɑjd.sɑː>sɑs.kɑ
aids+N+Sg+Loc	aidsas	ˈɑjd.sɑː>s
aids+N+Sg+Loc+PxDu3	aidsasteaskka	ˈɑjd.sɑː>steæs.kɑ
aids+N+Sg+Loc+PxSg1	aidsastan	ˈɑjd.sɑː>stɑn
aids+N+Der/Dimin+N+Sg+Nom	aidsaš	ˈɑjd.sɑː>»ʃ
aids+N+Der/heapmi+A+Comp+Sg+Nom	aidsahit	ˈɑjd.sɑː>»hih
aids+N+Der/heapmi+A+Pl+Acc	aidsahemiid	ˈɑjd.sɑː>»hˌe.mijh
aids+N+Der/huhtti+V+TV+VAbess	aidsahuhtehaga	ˈɑjd.sɑː>»hˌuh.te.hˌɑ.gɑ
aids+N+Der/huhtti+V+TV+VAbess	aidsahuhtekeahttájin	ˈɑjd.sɑː>»hˌuh.te.kˌĕæhː.tɑː.jin
aids+N+Der/huhtti+V+TV+Ind+Prs+Pl1	aidsahuhttit	ˈɑjd.sɑː>»hˌuhː.tih
aids+N+Der/huhtti+V+TV+Ind+Prs+Sg1	aidsahuhtán	ˈɑjd.sɑː>»hˌuhː.tɑːn
aids+N+Der/huhtti+V+TV+Ind+Prs+Sg2	aidsahuhtát	ˈɑjd.sɑː>»hˌuhː.tɑːh
aids+N+Sg+Ill	aidsii	ˈɑjd.si>i
aidsvaksiidna+N+Sg+Nom+PxDu3	aidsvaksiidnaska	ˈɑjds#vˌɑkː.sij.tnɑ>skɑ
aidsvaksiidna+N+Sg+Nom+PxPl3	aidsvaksiidnaset	ˈɑjds#vˌɑkː.sij.tnɑ>seh
aidsvaksiidna+N+Sg+Nom+PxSg3	aidsvaksiidnas	ˈɑjds#vˌɑkː.sij.tnɑ>s
aidsvaksiidna+N+Sg+Nom	aidsvaksiidna	ˈɑjds#vˌɑkː.sij.tnɑ>
aidsvaksiidna+N+Sg+Ill+PxSg2	aidsvaksiidnasat	ˈɑjds#vˌɑkː.sij.tnɑ>sɑh
aidsvaksiidna+N+Sg+Ill	aidsvaksiidnii	ˈɑjds#vˌɑkː.sij.tni>i
aidsvaksiidna+N+Pl+Com+PxPl2	aidsvaksiinnaideattetguin	ˈɑjds#vˌɑkː.sijn.nɑ>i.dĕæt.tet.gujn
aidsvaksiidna+N+Pl+Com	aidsvaksiinnaiguin	ˈɑjds#vˌɑkː.sijn.nɑ>i.gujn
aidsvaksiidna+N+Pl+Nom	aidsvaksiinnat	ˈɑjds#vˌɑkː.sijn.nɑ>h
aidsvaksiidna+N+Sg+Loc	aidsvaksiinnas	ˈɑjds#vˌɑkː.sijn.nɑ>s
aidsvaksiidna+N+Sg+Loc+PxPl3	aidsvaksiinnasteaset	ˈɑjds#vˌɑkː.sijn.nɑ>stĕæ.seh
aidsvaksiidna+N+Der/Dimin+N+Der/viđá+Adv	aidsvaksiinnašviđá	ˈɑjds#vˌɑkː.sijn.nɑ»ʃ»vˌi.ðɑː
aidsvaksiidna+N+Der/Dimin+N+Pl+Nom	aidsvaksiinnažat	ˈɑjds#vˌɑkː.sijn.nɑ»dʃɑh
aidsvaksiidna+N+Der/Dimin+N+Der/Dimin+N+Sg+Ill	aidsvaksiinnažažžii	ˈɑjds#vˌɑkː.sijn.nɑ»dʃˌɑdː.tʃi>i
aidsvaksiidna+N+Der/heapmi+A+Comp+Attr	aidsvaksiinnahit	ˈɑjds#vˌɑkː.sijn.nɑ»hit>
aidsvaksiidna+N+Der/huhtti+V+TV+Pot+Prs+Sg3	aidsvaksiinnahuhteža	ˈɑjds#vˌɑkː.sijn.nɑ»hˌuh.te>žɑ
aidsvaksiidna+N+Der/huhtti+V+TV+VAbess+A+Attr	aidsvaksiinnahuhtikeahtes	ˈɑjds#vˌɑkː.sijn.nɑ»hˌuh.ti>kĕæh.tes
aidsvaksiidna+N+Der/laš+A+Der/vuohta+N+Sg+Ill	aidsvaksiinnalašvuhtii	ˈɑjds#vˌɑkː.sijn.nɑ»lɑʃ»vˌuh.ti>i
airbag+N+Sg+Nom	airbag	ˈɑjr#pɑg>
airbag+N+Ess+PxDu1	airbaganeame	ˈɑjr#pˌɑ.gɑ>nĕæ.me
airbag+N+Ess+PxDu2	airbaganeatte	ˈɑjr#pˌɑ.gɑ>nĕæt.te
airbag+N+Ess+PxPl1	airbaganeamet	ˈɑjr#pˌɑ.gɑ>nĕæ.meh
airbag+N+Ess+PxPl2	airbaganeattet	ˈɑjr#pˌɑ.gɑ>nĕæt.teh
airbag+N+Ess+PxPl3	airbaganeaset	ˈɑjr#pˌɑ.gɑ>nĕæ.seh
airbag+N+Ess	airbagan	ˈɑjr#pˌɑ.gɑ>n
airbag+N+Pl+Acc+PxDu2	airbagaideatte	ˈɑjr#pˌɑ.gɑ>i.dĕæt.te
airbag+N+Pl+Gen+PxDu1	airbagaideame	ˈɑjr#pˌɑ.gɑ>i.dĕæ.me
airbag+N+Pl+Gen+PxPl2	airbagaideattet	ˈɑjr#pˌɑ.gɑ>i.dĕæt.teh
airbag+N+Pl+Gen+PxSg3	airbagaidis	ˈɑjr#pˌɑ.gɑ>i.dis
airbag+N+Pl+Ill+PxSg3	airbagaidasis	ˈɑjr#pˌɑ.gɑ>i.dɑ.sis
airbag+N+Pl+Loc+PxDu3	airbagaineaskka	ˈɑjr#pˌɑ.gɑ>i.neæs.kɑ
airbag+N+Pl+Loc+PxPl1	airbagaineamet	ˈɑjr#pˌɑ.gɑ>i.nĕæ.meh
airbag+N+Pl+Loc+PxSg2	airbagainat	ˈɑjr#pˌɑ.gɑ>i.nɑh
airbag+N+Pl+Nom+PxPl1	airbagaideamet	ˈɑjr#pˌɑ.gɑ>i.dĕæ.meh
airbag+N+Pl+Nom	airbagat	ˈɑjr#pˌɑ.gɑ>h
airbag+N+Sg+Com+PxDu2	airbagaineatte	ˈɑjr#pˌɑ.gɑ>i.nĕæt.te
airbag+N+Sg+Gen+PxSg3	airbagas	ˈɑjr#pˌɑ.gɑ>s
airbag+N+Sg+Ill+PxPl1	airbagasamet	ˈɑjr#pˌɑ.gɑ>sɑ.meh
airbag+N+Sg+Ill+PxPl3	airbagasaset	ˈɑjr#pˌɑ.gɑ>sɑ.seh
airbag+N+Sg+Ill+PxSg1	airbagasan	ˈɑjr#pˌɑ.gɑ>sɑn
airbag+N+Sg+Loc	airbagas	ˈɑjr#pˌɑ.gɑ>s
airbag+N+Der/Dimin+N+Der/viđá+Adv	airbagašviđá	ˈɑjr#pˌɑ.gɑ>»ʃ»vˌi.ðɑː
airbag+N+Der/Dimin+N+Sg+Acc+PxDu1	airbagažeame	ˈɑjr#pˌɑ.gɑ>»žˌĕæ.me
airbag+N+Der/heapmi+A+Pl+Com	airbagahemiiguin	ˈɑjr#pˌɑ.gɑ>»hˌe.mij.gujn
airbag+N+Der/heapmi+A+Attr	airbagahis	ˈɑjr#pˌɑ.gɑ>»his
airbag+N+Der/huhtti+V+TV+Ind+Prs+Sg1	airbagahuhtán	ˈɑjr#pˌɑ.gɑ>»hˌuhː.tɑːn
airbag+N+Der/huhtti+V+TV+Sup	airbagahuhtážit	ˈɑjr#pˌɑ.gɑ>»hˌuhː.tɑː.dʃih
airbag+N+Der/huvva+V+IV+Sup	airbagahuvažit	ˈɑjr#pˌɑ.gɑ>»hˌu.vɑ.dʃih
airbag+N+Der/huvva+V+IV+Ind+Prt+Pl3	airbagahuvve	ˈɑjr#pˌɑ.gɑ>»hˌuv.ve
airbag+N+Der/huvva+V+IV+Imprt+Pl2	airbagahuvvit	ˈɑjr#pˌɑ.gɑ>»hˌuvː.vih
airbag+N+Sg+Ill	airbagii	ˈɑjr#pˌɑ.gi>i
bachelor+N+Sg+Nom	bachelor	pˈɑts.he.lor>
bachelor+N+Pl+Com	bacheloraiguin	pˈɑts.he.lˌo.rɑ>i.gujn
bachelor+N+Sg+Com	bachelorain	pˈɑts.he.lˌo.rɑ>in
bachelor+N+Sg+Ill+PxSg1	bachelorasan	pˈɑts.he.lˌo.rɑ>sɑn
bachelor+N+Sg+Ill+PxSg2	bachelorasat	pˈɑts.he.lˌo.rɑ>sɑh
bachelor+N+Der/Dimin+N+Der/viđá+Adv	bachelorašviđá	pˈɑts.he.lˌo.rɑ»ʃ»vˌi.ðɑː
bachelor+N+Der/Dimin+N+Sg+Acc+PxPl2	bacheloražeattet	pˈɑts.he.lˌo.rɑ»dʃˌĕæt.teh
bachelor+N+Der/Dimin+N+Sg+Acc	bacheloraža	pˈɑts.he.lˌo.rɑ»dʃɑ
bachelor+N+Sg+Ill	bachelorii	pˈɑts.he.lˌo.ri>i
bachelorbargu+N+Sg+Gen+PxPl1	bachelorbargomet	pˈɑts.he.lor#pˌɑrə.ko>meh
bachelorbargu+N+Sg+Gen+PxSg1	bachelorbargon	pˈɑts.he.lor#pˌɑrə.ko>n
bachelorbargu+N+Sg+Ill+PxSg2	bachelorbargosat	pˈɑts.he.lor#pˌɑrə.ko>sɑh
bachelorbargu+N+Sg+Nom+PxSg1	bachelorbargon	pˈɑts.he.lor#pˌɑrə.ko>n
bachelorbargu+N+Der/viđá+Adv	bachelorbargoviđá	pˈɑts.he.lor#pˌɑrə.ko»vˌi.ðɑː
bachelorbargu+N+Ess	bachelorbargun	pˈɑts.he.lor#pˌɑrə.ku>n
bachelorbargu+N+Sg+Nom	bachelorbargu	pˈɑts.he.lor#pˌɑrə.ku>
bachelorbargu+N+Sg+Ill	bachelorbargui	pˈɑts.he.lor#pˌɑrə.ku>i
bachelorbargu+N+Sg+Acc+PxPl2	bachelorbarggodet	pˈɑts.he.lor#pˌɑrk.ko>deh
bachelorbargu+N+Sg+Acc+PxSg2	bachelorbarggot	pˈɑts.he.lor#pˌɑrk.ko>h
bachelorbargu+N+Sg+Gen+PxPl2	bachelorbarggodet	pˈɑts.he.lor#pˌɑrk.ko>deh
bachelorbargu+N+Der/Dimin+N+Ess	bachelorbarggožin	pˈɑts.he.lor#pˌɑrk.ko»dʃin
bachelorbargu+N+Der/laš+A+AttrCmp+Der/borat+A+Ess	bachelorbarggolašboragin	pˈɑts.he.lor#pˌɑrk.ko»lɑʃ>»bˌo.rɑ.gin
bachelorbargu+N+Sg+Com+PxDu1	bachelorbargguineame	pˈɑts.he.lor#pˌɑrk.ku>i.nĕæ.me
bachelorbargu+N+Sg+Com+PxPl2	bachelorbargguineattet	pˈɑts.he.lor#pˌɑrk.ku>i.nĕæt.teh
bachelorbargu+N+Der/huhtti+V+TV+VAbess	bachelorbargguhuhtehaga	pˈɑts.he.lor#pˌɑrk.ku»hˌuh.te>hɑ.gɑ
bachelorbargu+N+Der/huhtti+V+TV+Imprt+Du1	bachelorbargguhuhttu	pˈɑts.he.lor#pˌɑrk.ku»hˌuhː.tu>
bachelorbargu+N+Der/huvva+V+IV+Inf	bachelorbargguhuvvat	pˈɑts.he.lor#pˌɑrk.ku»hˌuv.vɑ>h
bachelorbargu+N+Der/huvva+V+IV+ConNegII	bachelorbargguhuvvo	pˈɑts.he.lor#pˌɑrk.ku»hˌuv.vo>
bachelordássi+N+Sg+Gen+Allegro	bachelordáse	pˈɑts.he.lor#tˌɑː.se>
bachelordássi+N+Der/huhtti+V+TV+Cond+Prs+ConNeg	bachelordásehuhtále	pˈɑts.he.lor#tˌɑː.se»hˌuhː.tɑː>le
bachelordássi+N+Pl+Nom	bachelordásit	pˈɑts.he.lor#tˌɑː.si>h
bachelordássi+N+Sg+Loc+PxDu1	bachelordásisteame	pˈɑts.he.lor#tˌɑː.si>stĕæ.me
bachelordássi+N+Sg+Com+PxDu1	bachelordásiineame	pˈɑts.he.lor#tˌɑː.si>i.nĕæ.me
bachelordássi+N+Sg+Com+PxPl1	bachelordásiineamet	pˈɑts.he.lor#tˌɑː.si>i.nĕæ.meh
bachelordássi+N+Sg+Com+PxSg3	bachelordásiinis	pˈɑts.he.lor#tˌɑː.si>i.nis
bachelordássi+N+Sg+Acc+PxDu2	bachelordásáde	pˈɑts.he.lor#tˌɑː.sɑː>de
bachelordássi+N+Sg+Acc+PxPl2	bachelordásádet	pˈɑts.he.lor#tˌɑː.sɑː>deh
bachelordássi+N+Sg+Acc+PxSg2	bachelordását	pˈɑts.he.lor#tˌɑː.sɑː>h
bachelordássi+N+Sg+Gen+PxDu2	bachelordásáde	pˈɑts.he.lor#tˌɑː.sɑː>de
bachelordássi+N+Der/Dimin+N+Der/viđá+Adv	bachelordásášviđá	pˈɑts.he.lor#tˌɑː.sɑː»ʃ»vˌi.ðɑː
bachelordássi+N+Der/Dimin+N+Ess	bachelordásážin	pˈɑts.he.lor#tˌɑː.sɑː»dʃin
bachelordássi+N+Der/laš+A+Superl+Attr	bachelordásálamos	pˈɑts.he.lor#tˌɑː.sɑː»lˌɑ.mos>
bachelordássi+N+Der/laš+A+Der/vuohta+N+Sg+Ill+PxDu1	bachelordásálašvuohtaseame	pˈɑts.he.lor#tˌɑː.sɑː»lɑʃ»vˌuoh.tɑ>sĕæ.me
bachelordássi+N+Der/viđá+Adv	bachelordásseviđá	pˈɑts.he.lor#tˌɑːs.se»vˌi.ðɑː
bachelordássi+N+Sg+Nom	bachelordássi	pˈɑts.he.lor#tˌɑːs.si>
bachelordássi+N+Sg+Ill+PxSg2	bachelordássásat	pˈɑts.he.lor#tˌɑːs.sɑː>sɑh
bachelordássi+N+Sg+Ill	bachelordássái	pˈɑts.he.lor#tˌɑːs.sɑː>i
bachelorgráda+N+Pl+Nom	bachelorgrádat	pˈɑts.he.lor#grˌɑː.dɑ>h
bachelorgráda+N+Sg+Loc	bachelorgrádas	pˈɑts.he.lor#grˌɑː.dɑ>s
bachelorgráda+N+Der/laš+A+Der/vuohta+N+Sg+Ill	bachelorgrádalašvuhtii	pˈɑts.he.lor#grˌɑː.dɑ»lɑʃ»vˌuh.ti>i
bachelorgráda+N+Der/viđá+Adv	bachelorgrádaviđá	pˈɑts.he.lor#grˌɑː.dɑ»vˌi.ðɑː
bachelorgráda+N+Sg+Ill	bachelorgrádii	pˈɑts.he.lor#grˌɑː.di>i
bachelorgrádaprográmma+N+Sg+Ill	bachelorgrádaprográmmii	pˈɑts.he.lor#grˌɑː.dɑ#prˌo.grɑːm.mi>i
bachelorgráhta+N+Pl+Nom	bachelorgráđat	pˈɑts.he.lor#grˌɑː.ðɑ>h
bachelorgráhta+N+Der/Dimin+N+Der/viđá+Adv	bachelorgráđašviđá	pˈɑts.he.lor#grˌɑː.ðɑ»ʃ»vˌi.ðɑː
bachelorgráhta+N+Der/heapmi+A+Comp+Sg+Acc	bachelorgráđaheappo	pˈɑts.he.lor#grˌɑː.ðɑ»hˌĕæp.po>
bachelorgráhta+N+Der/laš+A+Der/vuohta+N+Sg+Gen+PxSg2	bachelorgráđalašvuođat	pˈɑts.he.lor#grˌɑː.ðɑ»lɑʃ»vˌuo.ðɑ>h
bachelorgráđđa+N+Pl+Acc	bachelorgráđaid	pˈɑts.he.lor#grˌɑː.ðɑ>id
bachelorgráđđa+N+Pl+Com	bachelorgráđaiguin	pˈɑts.he.lor#grˌɑː.ðɑ>i.gujn
bachelorgráđđa+N+Pl+Ill+PxSg2	bachelorgráđaidasat	pˈɑts.he.lor#grˌɑː.ðɑ>i.dɑ.sɑh
bachelorgráđđa+N+Pl+Loc+PxPl2	bachelorgráđaineattet	pˈɑts.he.lor#grˌɑː.ðɑ>i.nĕæt.teh
bachelorgráđđa+N+Sg+Gen+PxPl2	bachelorgráđadet	pˈɑts.he.lor#grˌɑː.ðɑ>deh
bachelorgráđđa+N+Sg+Com+PxDu2	bachelorgráđaineatte	pˈɑts.he.lor#grˌɑː.ðɑ>i.nĕæt.te
bachelorgráđđa+N+Sg+Loc+PxSg3	bachelorgráđastis	pˈɑts.he.lor#grˌɑː.ðɑ>stis
bachelorgráđđa+N+Der/Dimin+N+Pl+Nom	bachelorgráđažat	pˈɑts.he.lor#grˌɑː.ðɑ»dʃɑh
bachelorgráđđa+N+Der/huvva+V+IV+Ind+Prs+ConNeg	bachelorgráđahuva	pˈɑts.he.lor#grˌɑː.ðɑ»hˌu.vɑ>
bachelorgráđđa+N+Der/laš+A+Superl+Attr	bachelorgráđaleamos	pˈɑts.he.lor#grˌɑː.ðɑ»lˌĕæ.mos>
bachelorgráđđa+N+Sg+Ill	bachelorgráđđii	pˈɑts.he.lor#grˌɑːð.ði>i
bacheloroahppu+N+Sg+Acc+PxDu2	bachelorohpode	pˈɑts.he.lor#ˌoh.po>de
bacheloroahppu+N+Sg+Acc+PxSg2	bachelorohpot	pˈɑts.he.lor#ˌoh.po>h
bacheloroahppu+N+Sg+Gen+PxDu2	bachelorohpode	pˈɑts.he.lor#ˌoh.po>de
bacheloroahppu+N+Sg+Gen+PxPl2	bachelorohpodet	pˈɑts.he.lor#ˌoh.po>deh
bacheloroahppu+N+Der/Dimin+N+Der/viđá+Adv	bachelorohpošviđá	pˈɑts.he.lor#ˌoh.po»ʃ»vˌi.ðɑː
bacheloroahppu+N+Der/laš+A+Ess	bachelorohpolažžan	pˈɑts.he.lor#ˌoh.po»lˌɑdː.tʃɑ>n
bacheloroahppu+N+Der/laš+A+Der/vuohta+N+Sg+Ill	bachelorohpolašvuhtii	pˈɑts.he.lor#ˌoh.po»lɑʃ»vˌuh.ti>i
bacheloroahppu+N+Sg+Acc+PxPl1	bachelorohppomet	pˈɑts.he.lor#ˌohː.po>meh
bacheloroahppu+N+Sg+Nom+PxDu2	bachelorohppode	pˈɑts.he.lor#ˌohː.po>de
bacheloroahppu+N+Sg+Nom+PxSg2	bachelorohppot	pˈɑts.he.lor#ˌohː.po>h
bacheloroahppu+N+Sg+Ill	bachelorohppui	pˈɑts.he.lor#ˌohː.pu>i
bacheloroahppu+N+Sg+Gen+Allegro	bacheloroahpo	pˈɑts.he.lor#ˌŏɑh.po>
bacheloroahppu+N+Der/heapmi+A+Superl+Pl+Acc	bacheloroahpohamosiid	pˈɑts.he.lor#ˌŏɑh.po»hˌɑ.mos>ijh
bacheloroahppu+N+Der/heapmi+A+Pl+Gen	bacheloroahpohemiid	pˈɑts.he.lor#ˌŏɑh.po»hˌe.mi>id
bacheloroahppu+N+Pl+Nom	bacheloroahput	pˈɑts.he.lor#ˌoɑh.pu>h
bacheloroahppu+N+Der/viđá+Adv	bacheloroahppoviđá	pˈɑts.he.lor#ˌŏɑhː.po»vˌi.ðɑː
bacheloroahppu+N+Ess+PxPl3	bacheloroahppuneaset	pˈɑts.he.lor#ˌŏɑhː.pu>nĕæ.seh
bacheloroahppu+N+Ess+PxSg1	bacheloroahppunan	pˈɑts.he.lor#ˌŏɑhː.pu>nɑn
bacheloroahppu+N+Ess+PxSg2	bacheloroahppunat	pˈɑts.he.lor#ˌŏɑhː.pu>nɑh
bacheloroahppu+N+Ess+PxSg3	bacheloroahppunis	pˈɑts.he.lor#ˌŏɑhː.pu>nis
bachelorprográmma+N+Ess+PxDu3	bachelorprográmmaneaskka	pˈɑts.he.lor#prˌo.grɑːm.mɑ>neæs.kɑ
bachelorprográmma+N+Pl+Com+PxSg3	bachelorprográmmaidisguin	pˈɑts.he.lor#prˌo.grɑːm.mɑ>i.dis.gujn
bachelorprográmma+N+Pl+Nom+PxSg2	bachelorprográmmaidat	pˈɑts.he.lor#prˌo.grɑːm.mɑ>i.dɑh
bachelorprográmma+N+Sg+Com+PxSg2	bachelorprográmmainat	pˈɑts.he.lor#prˌo.grɑːm.mɑ>i.nɑh
bachelorprográmma+N+Der/heapmi+A+Attr	bachelorprográmmahis	pˈɑts.he.lor#prˌo.grɑːm.mɑ»his>
bachelorprográmma+N+Der/huhtti+V+TV+Ind+Prs+Pl1	bachelorprográmmahuhttit	pˈɑts.he.lor#prˌo.grɑːm.mɑ»hˌuhː.ti>h
bachelorprográmma+N+Der/viđá+Adv	bachelorprográmmaviđá	pˈɑts.he.lor#prˌo.grɑːm.mɑ»vˌi.ðɑː
bachelorprográmma+N+Sg+Ill	bachelorprográmmii	pˈɑts.he.lor#prˌo.grɑːm.mi>i
bachelorráđđa+N+Pl+Ill	bachelorráđaide	pˈɑts.he.lor#rˌɑː.ðɑ>i.de
bachelorráđđa+N+Pl+Nom	bachelorráđat	pˈɑts.he.lor#rˌɑː.ðɑ>h
bachelorráđđa+N+Sg+Acc+PxPl2	bachelorráđadet	pˈɑts.he.lor#rˌɑː.ðɑ>deh
bachelorráđđa+N+Sg+Gen+PxDu2	bachelorráđade	pˈɑts.he.lor#rˌɑː.ðɑ>de
bachelorráđđa+N+Sg+Gen+PxPl3	bachelorráđaset	pˈɑts.he.lor#rˌɑː.ðɑ>seh
bachelorráđđa+N+Sg+Loc+PxDu2	bachelorráđasteatte	pˈɑts.he.lor#rˌɑː.ðɑ>stĕæt.te
bachelorráđđa+N+Sg+Loc+PxDu3	bachelorráđasteaskka	pˈɑts.he.lor#rˌɑː.ðɑ>steæs.kɑ
bachelorráđđa+N+Sg+Loc+PxPl2	bachelorráđasteattet	pˈɑts.he.lor#rˌɑː.ðɑ>stĕæt.teh
bachelorráđđa+N+Der/Dimin+N+Sg+Nom	bachelorráđaš	pˈɑts.he.lor#rˌɑː.ðɑ»ʃ
bachelorráđđa+N+Der/Dimin+N+Der/viđá+Adv	bachelorráđašviđá	pˈɑts.he.lor#rˌɑː.ðɑ»ʃ»vˌi.ðɑː
bachelorráđđa+N+Der/Dimin+N+Der/Dimin+N+Sg+Loc+PxSg1	bachelorráđažaččastan	pˈɑts.he.lor#rˌɑː.ðɑ»dʃˌɑt.tʃɑ>stɑn
bachelorráđđa+N+Der/heapmi+A+Attr+Der/vuohta+N+Sg+Gen+PxSg2	bachelorráđahisvuođat	pˈɑts.he.lor#rˌɑː.ðɑ»his>»vˌuo.ðɑh
bachelorráđđa+N+Der/huvva+V+IV+Ind+Prt+Du1	bachelorráđahuvaime	pˈɑts.he.lor#rˌɑː.ðɑ»hˌu.vɑ>i.me
bachelorráđđa+N+Der/laš+A+Superl+Ess	bachelorráđalamosin	pˈɑts.he.lor#rˌɑː.ðɑ»lˌɑ.mos>in
bachelorráđđa+N+Sg+Acc+PxPl1	bachelorráđđamet	pˈɑts.he.lor#rˌɑːð.ðɑ>meh
bachelorráđđa+N+Der/viđá+Adv	bachelorráđđaviđá	pˈɑts.he.lor#rˌɑːð.ðɑ»vˌi.ðɑː
bachelorráđđa+N+Sg+Ill	bachelorráđđii	pˈɑts.he.lor#rˌɑːð.ði>i
bachelorráđđaprográmma+N+Sg+Ill+PxSg2	bachelorráđđaprográmmasat	pˈɑts.he.lor#rˌɑːð.ðɑ#prˌo.grɑːm.mɑ>sɑh
bachelorráđđaprográmma+N+Sg+Com	bachelorráđđaprográmmain	pˈɑts.he.lor#rˌɑːð.ðɑ#prˌo.grɑːm.mɑ>in
bachelorráđđaprográmma+N+Der/huhtti+V+TV+Ger+PxPl3	bachelorráđđaprográmmahuhtidettiineaset	pˈɑts.he.lor#rˌɑːð.ðɑ#prˌo.grɑːm.mɑ»hˌuh.ti>det.tij.nĕæ.seh
bachelorráđđaprográmma+N+Der/viđá+Adv	bachelorráđđaprográmmaviđá	pˈɑts.he.lor#rˌɑːð.ðɑ#prˌo.grɑːm.mɑ»vˌi.ðɑː
bachelorráđđaprográmma+N+Sg+Ill	bachelorráđđaprográmmii	pˈɑts.he.lor#rˌɑːð.ðɑ#prˌo.grɑːm.mi>i
bachelorčálus+N+Ess	bachelorčálusin	pˈɑts.he.lor#tʃˌɑː.lus>in
bachelorčálus+N+Sg+Nom	bachelorčálus	pˈɑts.he.lor#tʃˌɑː.lus>
bachelorčálus+N+Der/laš+A+Attr	bachelorčáluslaš	pˈɑts.he.lor#tʃˌɑː.lus>»lɑʃ
bachelorčálus+N+Der/viđá+Adv	bachelorčálusviđá	pˈɑts.he.lor#tʃˌɑː.lus»vˌi.ðɑː
bachelorčálus+N+Pl+Nom	bachelorčállosat	pˈɑts.he.lor#tʃˌɑːl.los>ɑh
bachelorčálus+N+Sg+Acc+PxSg1	bachelorčállosan	pˈɑts.he.lor#tʃˌɑːl.los>ɑn
bachelorčálus+N+Sg+Acc+PxSg2	bachelorčállosat	pˈɑts.he.lor#tʃˌɑːl.los>ɑh
bachelorčálus+N+Sg+Nom+PxPl2	bachelorčálloseattet	pˈɑts.he.lor#tʃˌɑːl.los>ĕæt.teh
bachelorčálus+N+Pl+Com	bachelorčállosiiguin	pˈɑts.he.lor#tʃˌɑːl.los>ij.gujn
bachelorčálus+N+Sg+Com+PxPl3	bachelorčállosiinniset	pˈɑts.he.lor#tʃˌɑːl.los>ijn.ni.seh
bachelorčálus+N+Sg+Com+PxDu1	bachelorčállosiinnáme	pˈɑts.he.lor#tʃˌɑːl.los>ijn.nɑː.me
bachelorčálus+N+Der/Dimin+N+Sg+Nom	bachelorčállosaš	pˈɑts.he.lor#tʃˌɑːl.los>»ɑʃ
bachelorčálus+N+Der/Dimin+N+Ess+PxDu3	bachelorčállosažžaneaskka	pˈɑts.he.lor#tʃˌɑːl.los>»ˌɑdː.tʃɑ.nˌeæs.kɑ
backflip+N+Sg+Nom	backflip	pˈɑtsk.flip>
backflip+N+Ess+PxDu2	backflipaneatte	pˈɑtsk.fli.pɑ>nĕæt.te
backflip+N+Ess+PxPl1	backflipaneamet	pˈɑtsk.fli.pɑ>nĕæ.meh
backflip+N+Ess+PxPl2	backflipaneattet	pˈɑtsk.fli.pɑ>nĕæt.teh
backflip+N+Ess+PxSg2	backflipanat	pˈɑtsk.fli.pɑ>nɑh
backflip+N+Ess	backflipan	pˈɑtsk.fli.pɑ>n
backflip+N+Pl+Acc+PxSg1	backflipaidan	pˈɑtsk.fli.pɑ>i.dɑn
backflip+N+Pl+Com	backflipaiguin	pˈɑtsk.fli.pɑ>i.gujn
backflip+N+Pl+Gen+PxDu1	backflipaideame	pˈɑtsk.fli.pɑ>i.dĕæ.me
backflip+N+Pl+Ill+PxPl3	backflipaidaseaset	pˈɑtsk.fli.pɑ>i.dɑ.sĕæ.seh
backflip+N+Pl+Loc+PxDu3	backflipaineaskka	pˈɑtsk.fli.pɑ>i.neæs.kɑ
backflip+N+Pl+Loc+PxSg2	backflipainat	pˈɑtsk.fli.pɑ>i.nɑh
backflip+N+Pl+Nom+PxDu1	backflipaideame	pˈɑtsk.fli.pɑ>i.dĕæ.me
backflip+N+Pl+Nom+PxPl1	backflipaideamet	pˈɑtsk.fli.pɑ>i.dĕæ.meh
backflip+N+Pl+Nom	backflipat	pˈɑtsk.fli.pɑ>h
backflip+N+Sg+Com+PxPl2	backflipaineattet	pˈɑtsk.fli.pɑ>i.nĕæt.teh
backflip+N+Sg+Com+PxPl3	backflipaineaset	pˈɑtsk.fli.pɑ>i.nĕæ.seh
backflip+N+Sg+Com+PxSg1	backflipainan	pˈɑtsk.fli.pɑ>i.nɑn
backflip+N+Sg+Com+PxSg3	backflipainis	pˈɑtsk.fli.pɑ>i.nis
backflip+N+Sg+Gen+PxSg1	backflipan	pˈɑtsk.fli.pɑ>n
backflip+N+Sg+Gen+PxSg3	backflipas	pˈɑtsk.fli.pɑ>s
backflip+N+Sg+Ill+PxDu1	backflipasame	pˈɑtsk.fli.pɑ>sɑ.me
backflip+N+Sg+Ill+PxSg3	backflipasas	pˈɑtsk.fli.pɑ>sɑs
backflip+N+Sg+Loc+PxSg1	backflipastan	pˈɑtsk.fli.pɑ>stɑn
backflip+N+Sg+Nom+PxDu1	backflipame	pˈɑtsk.fli.pɑ>me
backflip+N+Der/Dimin+N+Der/viđá+Adv	backflipašviđá	pˈɑtsk.fli.pɑ>»ʃ»vˌi.ðɑː
backflip+N+Der/Dimin+N+Ess	backflipažin	pˈɑtsk.fli.pɑ>»žin
backflip+N+Der/heapmi+A+Comp+Sg+Nom	backflipahut	pˈɑtsk.fli.pɑ>»huh
backflip+N+Der/heapmi+A+Pl+Acc	backflipahemiid	pˈɑtsk.fli.pɑ>»hˌe.mijh
backflip+N+Der/heapmi+A+Attr	backflipahis	pˈɑtsk.fli.pɑ>»his
backflip+N+Der/huhtti+V+TV+PrfPrc	backflipahuhttán	pˈɑtsk.fli.pɑ>»hˌuhː.tɑːn
backflip+N+Der/huvva+V+IV+Imprt+Sg3	backflipahuvvos	pˈɑtsk.fli.pɑ>»hˌuv.vos
backflip+N+Sg+Ill	backflipii	pˈɑtsk.fli.pi>i
backflippa+N+Ess+PxDu3	backflippaneaskka	pˈɑtsk.flip.pɑ>neæs.kɑ
backflippa+N+Ess+PxPl1	backflippaneamet	pˈɑtsk.flip.pɑ>nĕæ.meh
backflippa+N+Ess+PxSg3	backflippanis	pˈɑtsk.flip.pɑ>nis
backflippa+N+Pl+Acc+PxPl3	backflippaideaset	pˈɑtsk.flip.pɑ>i.dĕæ.seh
backflippa+N+Pl+Acc+PxSg2	backflippaidat	pˈɑtsk.flip.pɑ>i.dɑh
backflippa+N+Pl+Com	backflippaiguin	pˈɑtsk.flip.pɑ>i.gujn
backflippa+N+Pl+Loc+PxDu3	backflippaineaskka	pˈɑtsk.flip.pɑ>i.neæs.kɑ
backflippa+N+Pl+Nom	backflippat	pˈɑtsk.flip.pɑ>h
backflippa+N+Sg+Gen+PxDu3	backflippaska	pˈɑtsk.flip.pɑ>skɑ
backflippa+N+Sg+Nom+PxPl1	backflippamet	pˈɑtsk.flip.pɑ>meh
backflippa+N+Sg+Com+PxPl2	backflippaineattet	pˈɑtsk.flip.pɑ>i.nĕæt.teh
backflippa+N+Sg+Com+PxSg3	backflippainis	pˈɑtsk.flip.pɑ>i.nis
backflippa+N+Sg+Loc	backflippas	pˈɑtsk.flip.pɑ>s
backflippa+N+Der/Dimin+N+Sg+Loc+PxPl2	backflippažisttádet	pˈɑtsk.flip.pɑ»dʃˌis.tɑː>deh
backflippa+N+Der/heapmi+A+Sg+Ill	backflippaheapmái	pˈɑtsk.flip.pɑ»hˌeæp.mɑː>i
backflippa+N+Der/heapmi+A+Pl+Com	backflippahemiiguin	pˈɑtsk.flip.pɑ»hˌe.mi>i.gujn
backflippa+N+Der/heapmi+A+Sg+Com	backflippahemiin	pˈɑtsk.flip.pɑ»hˌe.mi>in
backflippa+N+Der/huhtti+V+TV+Imprt+ConNeg	backflippahuhte	pˈɑtsk.flip.pɑ»hˌuh.te>
backflippa+N+Der/huhtti+V+TV+VAbess+A+Attr	backflippahuhtekeahtes	pˈɑtsk.flip.pɑ»hˌuh.te>kĕæh.tes
backflippa+N+Der/huvva+V+IV+VAbess	backflippahuvakeahttá	pˈɑtsk.flip.pɑ»hˌu.vɑ>kĕæhː.tɑː
backflippa+N+Der/huvva+V+IV+VGen	backflippahuva	pˈɑtsk.flip.pɑ»hˌu.vɑ>
backflippa+N+Der/huvva+V+IV+ConNegII	backflippahuvvo	pˈɑtsk.flip.pɑ»hˌuv.vo>
backflippa+N+Der/huvva+V+IV+Imprt+Pl1	backflippahuvvut	pˈɑtsk.flip.pɑ»hˌuv.vu>h
backflippa+N+Der/laš+A+Comp+Attr	backflippalit	pˈɑtsk.flip.pɑ»lit>
backflippa+N+Der/laš+A+Comp+Sg+Nom	backflippalit	pˈɑtsk.flip.pɑ»lit>
backflippa+N+Der/laš+A+Superl+Pl+Acc	backflippalamosiid	pˈɑtsk.flip.pɑ»lˌɑ.mos>ijh
backflippa+N+Der/laš+A+Superl+Sg+Nom	backflippaleamos	pˈɑtsk.flip.pɑ»lˌĕæ.mos>
backflippa+N+Der/laš+A+Attr	backflippalaš	pˈɑtsk.flip.pɑ»lɑʃ>
backflippa+N+Der/laš+A+Der/vuohta+N+Sg+Ill	backflippalašvuhtii	pˈɑtsk.flip.pɑ»lɑʃ»vˌuh.ti>i
backflippa+N+Der/laš+A+Der/vuohta+N+Pl+Nom	backflippalašvuođat	pˈɑtsk.flip.pɑ»lɑʃ»vˌuo.ðɑ>h
backflippa+N+Der/viđá+Adv	backflippaviđá	pˈɑtsk.flip.pɑ»vˌi.ðɑː
backflippa+N+Sg+Ill	backflippii	pˈɑtsk.flip.pi>i
bluesrohkka+N+Pl+Acc+PxDu2	bluesrohkaideatte	blˈu.es#rˌoh.kɑ>i.dĕæt.te
bluesrohkka+N+Pl+Com+PxDu1	bluesrohkaideameguin	blˈu.es#rˌoh.kɑ>i.dĕæ.me.gujn
bluesrohkka+N+Pl+Com+PxPl3	bluesrohkaideasetguin	blˈu.es#rˌoh.kɑ>i.dĕæ.set.gujn
bluesrohkka+N+Pl+Com	bluesrohkaiguin	blˈu.es#rˌoh.kɑ>i.gujn
bluesrohkka+N+Pl+Gen+PxDu2	bluesrohkaideatte	blˈu.es#rˌoh.kɑ>i.dĕæt.te
bluesrohkka+N+Pl+Gen+PxPl3	bluesrohkaideaset	blˈu.es#rˌoh.kɑ>i.dĕæ.seh
bluesrohkka+N+Pl+Gen+PxSg1	bluesrohkaidan	blˈu.es#rˌoh.kɑ>i.dɑn
bluesrohkka+N+Pl+Ill+PxDu3	bluesrohkaidasaska	blˈu.es#rˌoh.kɑ>i.dɑ.sɑs.kɑ
bluesrohkka+N+Pl+Ill+PxPl2	bluesrohkaidasadet	blˈu.es#rˌoh.kɑ>i.dɑ.sɑ.deh
bluesrohkka+N+Pl+Ill+PxPl3	bluesrohkaidasaset	blˈu.es#rˌoh.kɑ>i.dɑ.sɑ.seh
bluesrohkka+N+Pl+Ill+PxSg3	bluesrohkaidasas	blˈu.es#rˌoh.kɑ>i.dɑ.sɑs
bluesrohkka+N+Pl+Ill	bluesrohkaide	blˈu.es#rˌoh.kɑ>i.de
bluesrohkka+N+Pl+Loc+PxDu1	bluesrohkaineame	blˈu.es#rˌoh.kɑ>i.nĕæ.me
bluesrohkka+N+Pl+Loc+PxDu2	bluesrohkaineatte	blˈu.es#rˌoh.kɑ>i.nĕæt.te
bluesrohkka+N+Pl+Loc+PxSg1	bluesrohkainan	blˈu.es#rˌoh.kɑ>i.nɑn
bluesrohkka+N+Pl+Loc+PxSg3	bluesrohkainis	blˈu.es#rˌoh.kɑ>i.nis
bluesrohkka+N+Pl+Nom+PxDu1	bluesrohkaideame	blˈu.es#rˌoh.kɑ>i.dĕæ.me
bluesrohkka+N+Pl+Nom+PxDu3	bluesrohkaideaskka	blˈu.es#rˌoh.kɑ>i.deæs.kɑ
bluesrohkka+N+Pl+Nom+PxPl2	bluesrohkaideattet	blˈu.es#rˌoh.kɑ>i.dĕæt.teh
bluesrohkka+N+Pl+Nom+PxPl3	bluesrohkaideaset	blˈu.es#rˌoh.kɑ>i.dĕæ.seh
bluesrohkka+N+Pl+Nom+PxSg1	bluesrohkaidan	blˈu.es#rˌoh.kɑ>i.dɑn
bluesrohkka+N+Pl+Nom	bluesrohkat	blˈu.es#rˌoh.kɑ>h
bluesrohkka+N+Sg+Acc+PxDu2	bluesrohkade	blˈu.es#rˌoh.kɑ>de
bluesrohkka+N+Sg+Acc+PxPl2	bluesrohkadet	blˈu.es#rˌoh.kɑ>deh
bluesrohkka+N+Sg+Acc+PxPl3	bluesrohkaset	blˈu.es#rˌoh.kɑ>seh
bluesrohkka+N+Sg+Acc+PxSg2	bluesrohkat	blˈu.es#rˌoh.kɑ>h
bluesrohkka+N+Sg+Acc+PxSg3	bluesrohkas	blˈu.es#rˌoh.kɑ>s
bluesrohkka+N+Sg+Acc	bluesrohka	blˈu.es#rˌoh.kɑ>
bluesrohkka+N+Sg+Gen+PxDu2	bluesrohkade	blˈu.es#rˌoh.kɑ>de
bluesrohkka+N+Sg+Gen+PxDu3	bluesrohkaska	blˈu.es#rˌoh.kɑ>skɑ
bluesrohkka+N+Sg+Gen+PxPl3	bluesrohkaset	blˈu.es#rˌoh.kɑ>seh
bluesrohkka+N+Sg+Com+PxDu1	bluesrohkaineame	blˈu.es#rˌoh.kɑ>i.nĕæ.me
bluesrohkka+N+Sg+Com+PxDu2	bluesrohkaineatte	blˈu.es#rˌoh.kɑ>i.nĕæt.te
bluesrohkka+N+Sg+Com+PxDu3	bluesrohkaineaskka	blˈu.es#rˌoh.kɑ>i.neæs.kɑ
bluesrohkka+N+Sg+Com+PxPl1	bluesrohkaineamet	blˈu.es#rˌoh.kɑ>i.nĕæ.meh
bluesrohkka+N+Sg+Com+PxPl2	bluesrohkaineattet	blˈu.es#rˌoh.kɑ>i.nĕæt.teh
bluesrohkka+N+Sg+Com+PxPl3	bluesrohkaineaset	blˈu.es#rˌoh.kɑ>i.nĕæ.seh
bluesrohkka+N+Sg+Com+PxSg1	bluesrohkainan	blˈu.es#rˌoh.kɑ>i.nɑn
bluesrohkka+N+Sg+Com+PxSg2	bluesrohkainat	blˈu.es#rˌoh.kɑ>i.nɑh
bluesrohkka+N+Sg+Com+PxSg3	bluesrohkainis	blˈu.es#rˌoh.kɑ>i.nis
bluesrohkka+N+Sg+Com	bluesrohkain	blˈu.es#rˌoh.kɑ>in
bluesrohkka+N+Sg+Loc	bluesrohkas	blˈu.es#rˌoh.kɑ>s
bluesrohkka+N+Sg+Loc+PxDu1	bluesrohkasteame	blˈu.es#rˌoh.kɑ>stĕæ.me
bluesrohkka+N+Sg+Loc+PxDu2	bluesrohkasteatte	blˈu.es#rˌoh.kɑ>stĕæt.te
bluesrohkka+N+Sg+Loc+PxDu3	bluesrohkasteaskka	blˈu.es#rˌoh.kɑ>steæs.kɑ
bluesrohkka+N+Sg+Loc+PxPl3	bluesrohkasteaset	blˈu.es#rˌoh.kɑ>stĕæ.seh
bluesrohkka+N+Sg+Loc+PxSg1	bluesrohkastan	blˈu.es#rˌoh.kɑ>stɑn
bluesrohkka+N+Sg+Loc+PxSg2	bluesrohkastat	blˈu.es#rˌoh.kɑ>stɑh
bluesrohkka+N+Der/Dimin+N+Sg+Nom	bluesrohkaš	blˈu.es#rˌoh.kɑ»ʃ
bluesrohkka+N+Der/Dimin+N+Der/viđá+Adv	bluesrohkašviđá	blˈu.es#rˌoh.kɑ»ʃ»vˌi.ðɑː
bluesrohkka+N+Der/Dimin+N+Pl+Nom	bluesrohkažat	blˈu.es#rˌoh.kɑ»dʃɑh
bluesrohkka+N+Der/Dimin+N+Sg+Acc+PxSg2	bluesrohkažat	blˈu.es#rˌoh.kɑ»dʃɑh
bluesrohkka+N+Der/Dimin+N+Sg+Nom+PxSg1	bluesrohkažan	blˈu.es#rˌoh.kɑ»dʃɑn
bluesrohkka+N+Der/Dimin+N+Sg+Acc	bluesrohkaža	blˈu.es#rˌoh.kɑ»dʃɑ
bluesrohkka+N+Der/Dimin+N+Pl+Com	bluesrohkažiiguin	blˈu.es#rˌoh.kɑ»dʃˌij.gujn
bluesrohkka+N+Der/Dimin+N+Sg+Loc+PxDu3	bluesrohkažisttiska	blˈu.es#rˌoh.kɑ»dʃˌis.ti>skɑ
bluesrohkka+N+Der/Dimin+N+Sg+Loc+PxPl1	bluesrohkažisttámet	blˈu.es#rˌoh.kɑ»dʃˌis.tɑː>meh
bluesrohkka+N+Der/heapmi+A+Comp+Sg+Nom	bluesrohkahabbo	blˈu.es#rˌoh.kɑ»hˌɑbː.po>
bluesrohkka+N+Der/heapmi+A+Comp+Ess	bluesrohkaheabbon	blˈu.es#rˌoh.kɑ»hˌĕæbː.po>n
bluesrohkka+N+Der/heapmi+A+Comp+Attr	bluesrohkahet	blˈu.es#rˌoh.kɑ»het>
bluesrohkka+N+Der/heapmi+A+Comp+Sg+Nom	bluesrohkahet	blˈu.es#rˌoh.kɑ»het>
bluesrohkka+N+Der/heapmi+A+Comp+Sg+Nom	bluesrohkahit	blˈu.es#rˌoh.kɑ»hit>
bluesrohkka+N+Der/heapmi+A+Superl+Attr	bluesrohkahamos	blˈu.es#rˌoh.kɑ»hˌɑ.mos>
bluesrohkka+N+Der/heapmi+A+Superl+Pl+Loc	bluesrohkahepmosiin	blˈu.es#rˌoh.kɑ»hˌep.mos>ijn
bluesrohkka+N+Der/heapmi+A+Superl+Sg+Loc	bluesrohkahepmosis	blˈu.es#rˌoh.kɑ»hˌep.mos>is
bluesrohkka+N+Der/heapmi+A+Ess	bluesrohkaheapmin	blˈu.es#rˌoh.kɑ»hˌeæp.mi>n
bluesrohkka+N+Der/heapmi+A+Pl+Nom	bluesrohkaheamit	blˈu.es#rˌoh.kɑ»hˌeæ.mi>h
bluesrohkka+N+Der/heapmi+A+Sg+Ill	bluesrohkaheapmái	blˈu.es#rˌoh.kɑ»hˌeæp.mɑː>i
bluesrohkka+N+Der/heapmi+A+Pl+Acc	bluesrohkahemiid	blˈu.es#rˌoh.kɑ»hˌe.mi>id
bluesrohkka+N+Der/heapmi+A+Pl+Com	bluesrohkahemiiguin	blˈu.es#rˌoh.kɑ»hˌe.mi>i.gujn
bluesrohkka+N+Der/heapmi+A+Pl+Ill	bluesrohkahemiide	blˈu.es#rˌoh.kɑ»hˌe.mi>i.de
bluesrohkka+N+Der/heapmi+A+Attr	bluesrohkahis	blˈu.es#rˌoh.kɑ»his>
bluesrohkka+N+Der/heapmi+A+Attr+Der/vuohta+N+Sg+Ill	bluesrohkahisvuhtii	blˈu.es#rˌoh.kɑ»his>»vˌuh.tij
bluesrohkka+N+Der/heapmi+A+Attr+Der/vuohta+N+Der/viđá+Adv	bluesrohkahisvuohtaviđá	blˈu.es#rˌoh.kɑ»his>»vˌuoh.tɑ»vˌi.ðɑː
bluesrohkka+N+Der/heapmi+A+Attr+Der/vuohta+N+Sg+Com+PxDu1	bluesrohkahisvuođaineame	blˈu.es#rˌoh.kɑ»his>»vˌuo.ðɑj.nˌĕæ.me
bluesrohkka+N+Der/huhtti+V+TV+Ger	bluesrohkahuhtediin	blˈu.es#rˌoh.kɑ»hˌuh.te>dijn
bluesrohkka+N+Der/huhtti+V+TV+Imprt+ConNeg	bluesrohkahuhte	blˈu.es#rˌoh.kɑ»hˌuh.te>
bluesrohkka+N+Der/huhtti+V+TV+Imprt+Sg2	bluesrohkahuhte	blˈu.es#rˌoh.kɑ»hˌuh.te>
bluesrohkka+N+Der/huhtti+V+TV+Ind+Prs+ConNeg	bluesrohkahuhte	blˈu.es#rˌoh.kɑ»hˌuh.te>
bluesrohkka+N+Der/huhtti+V+TV+Pot+Prs+Sg3	bluesrohkahuhteš	blˈu.es#rˌoh.kɑ»hˌuh.te>ʃ
bluesrohkka+N+Der/huhtti+V+TV+VAbess	bluesrohkahuhtehaga	blˈu.es#rˌoh.kɑ»hˌuh.te>hɑ.gɑ
bluesrohkka+N+Der/huhtti+V+TV+VAbess+A+Attr	bluesrohkahuhtekeahtes	blˈu.es#rˌoh.kɑ»hˌuh.te>kĕæh.tes
bluesrohkka+N+Der/huhtti+V+TV+Ger+PxSg3	bluesrohkahuhtidettiinis	blˈu.es#rˌoh.kɑ»hˌuh.ti>det.tij.nis
bluesrohkka+N+Der/huhtti+V+TV+VAbess	bluesrohkahuhtihaga	blˈu.es#rˌoh.kɑ»hˌuh.ti>hɑ.gɑ
bluesrohkka+N+Der/huhtti+V+TV+Imprt+Pl2	bluesrohkahuhttet	blˈu.es#rˌoh.kɑ»hˌuhː.te>h
bluesrohkka+N+Der/huhtti+V+TV+Ind+Prt+Sg2	bluesrohkahuhttet	blˈu.es#rˌoh.kɑ»hˌuhː.te>h
bluesrohkka+N+Der/huhtti+V+TV+Ind+Prs+Pl2	bluesrohkahuhttibehtet	blˈu.es#rˌoh.kɑ»hˌuhː.ti>beh.teh
bluesrohkka+N+Der/huhtti+V+TV+Der/PassS+V+IV+Imprt+ConNeg	bluesrohkahuhtto	blˈu.es#rˌoh.kɑ»hˌuhː.to>»
bluesrohkka+N+Der/huhtti+V+TV+Imprt+Du1	bluesrohkahuhttu	blˈu.es#rˌoh.kɑ»hˌuhː.tu>
bluesrohkka+N+Der/huhtti+V+TV+Cond+Prs+ConNeg	bluesrohkahuhtáše	blˈu.es#rˌoh.kɑ»hˌuhː.tɑː>ʃe
bluesrohkka+N+Der/huhtti+V+TV+Ind+Prs+Sg1	bluesrohkahuhtán	blˈu.es#rˌoh.kɑ»hˌuhː.tɑː>n
bluesrohkka+N+Der/huhtti+V+TV+Ind+Prs+Sg2	bluesrohkahuhtát	blˈu.es#rˌoh.kɑ»hˌuhː.tɑː>h
bluesrohkka+N+Der/huhtti+V+TV+Sup	bluesrohkahuhtážit	blˈu.es#rˌoh.kɑ»hˌuhː.tɑː>žih
bluesrohkka+N+Der/huvva+V+IV+Pot+Prs+ConNeg	bluesrohkahuvaš	blˈu.es#rˌoh.kɑ»hˌu.vɑ>ʃ
bluesrohkka+N+Der/huvva+V+IV+Pot+Prs+Sg3	bluesrohkahuvaš	blˈu.es#rˌoh.kɑ»hˌu.vɑ>ʃ
bluesrohkka+N+Der/huvva+V+IV+Sup	bluesrohkahuvažit	blˈu.es#rˌoh.kɑ»hˌu.vɑ>žih
bluesrohkka+N+Der/huvva+V+IV+VAbess	bluesrohkahuvahaga	blˈu.es#rˌoh.kɑ»hˌu.vɑ>hɑ.gɑ
bluesrohkka+N+Der/huvva+V+IV+VGen	bluesrohkahuva	blˈu.es#rˌoh.kɑ»hˌu.vɑ>
bluesrohkka+N+Der/huvva+V+IV+Actio+Com	bluesrohkahuvvamiin	blˈu.es#rˌoh.kɑ»hˌuv.vɑ>mijn
bluesrohkka+N+Der/huvva+V+IV+Actio+Gen	bluesrohkahuvvan	blˈu.es#rˌoh.kɑ»hˌuv.vɑ>n
bluesrohkka+N+Der/huvva+V+IV+Ind+Prt+ConNeg	bluesrohkahuvvan	blˈu.es#rˌoh.kɑ»hˌuv.vɑ>n
bluesrohkka+N+Der/huvva+V+IV+Ind+Prs+Pl3	bluesrohkahuvvet	blˈu.es#rˌoh.kɑ»hˌuv.ve>h
bluesrohkka+N+Der/huvva+V+IV+Imprt+Du2	bluesrohkahuvvi	blˈu.es#rˌoh.kɑ»hˌuv.vi>
bluesrohkka+N+Der/huvva+V+IV+ConNegII	bluesrohkahuvvo	blˈu.es#rˌoh.kɑ»hˌuv.vo>
bluesrohkka+N+Der/huvva+V+IV+Imprt+Pl1	bluesrohkahuvvut	blˈu.es#rˌoh.kɑ»hˌuv.vu>h
bluesrohkka+N+Der/huvva+V+IV+Ind+Prs+Sg3	bluesrohkahuvvá	blˈu.es#rˌoh.kɑ»hˌuvː.vɑː>
bluesrohkka+N+Der/laš+A+Comp+Sg+Ill	bluesrohkalebbui	blˈu.es#rˌoh.kɑ»lˌebː.pu>i
bluesrohkka+N+Der/laš+A+Comp+Sg+Nom	bluesrohkalet	blˈu.es#rˌoh.kɑ»let>
bluesrohkka+N+Der/laš+A+Comp+Sg+Nom	bluesrohkalit	blˈu.es#rˌoh.kɑ»lit>
bluesrohkka+N+Der/laš+A+Comp+Attr	bluesrohkalut	blˈu.es#rˌoh.kɑ»lut>
bluesrohkka+N+Der/laš+A+Comp+Sg+Nom	bluesrohkalut	blˈu.es#rˌoh.kɑ»lut>
bluesrohkka+N+Der/laš+A+Ess	bluesrohkalažžan	blˈu.es#rˌoh.kɑ»lˌɑdː.tʃɑ>n
bluesrohkka+N+Der/laš+A+Superl+Attr	bluesrohkalamos	blˈu.es#rˌoh.kɑ»lˌɑ.mos>
bluesrohkka+N+Der/laš+A+Superl+Ess	bluesrohkalamosin	blˈu.es#rˌoh.kɑ»lˌɑ.mos>in
bluesrohkka+N+Der/laš+A+Superl+Pl+Gen	bluesrohkalamosiid	blˈu.es#rˌoh.kɑ»lˌɑ.mos>ijh
bluesrohkka+N+Der/laš+A+Sg+Ill	bluesrohkalažžii	blˈu.es#rˌoh.kɑ»lˌɑdː.tʃi>i
bluesrohkka+N+Der/laš+A+AttrCmp+Der/juolggat+A+Sg+Nom	bluesrohkalašjuolggat	blˈu.es#rˌoh.kɑ»lɑʃ>»jˌuolk.kɑh
bluesrohkka+N+Der/laš+A+AttrCmp+Der/kultuvrrat+A+Ess	bluesrohkalaškultuvrragin	blˈu.es#rˌoh.kɑ»lɑʃ>»kˌul.htuvr.rˌɑ.gin
bluesrohkka+N+Der/laš+A+Sg+Nom	bluesrohkalaš	blˈu.es#rˌoh.kɑ»lɑʃ>
bluesrohkka+N+Der/laš+A+Der/vuohta+N+Sg+Ill	bluesrohkalašvuhtii	blˈu.es#rˌoh.kɑ»lɑʃ»vˌuh.ti>i
bluesrohkka+N+Der/laš+A+Der/vuohta+N+Der/viđá+Adv	bluesrohkalašvuohtaviđá	blˈu.es#rˌoh.kɑ»lɑʃ»vˌuoh.tɑ»vˌi.ðɑː
bluesrohkka+N+Der/laš+A+Der/vuohta+N+Sg+Loc	bluesrohkalašvuođas	blˈu.es#rˌoh.kɑ»lɑʃ»vˌuo.ðɑ>s
bluesrohkka+N+Ess+PxDu1	bluesrohkkaneame	blˈu.es#rˌohː.kɑ>nĕæ.me
bluesrohkka+N+Ess+PxDu2	bluesrohkkaneatte	blˈu.es#rˌohː.kɑ>nĕæt.te
bluesrohkka+N+Ess+PxDu3	bluesrohkkaneaskka	blˈu.es#rˌohː.kɑ>neæs.kɑ
bluesrohkka+N+Ess+PxPl1	bluesrohkkaneamet	blˈu.es#rˌohː.kɑ>nĕæ.meh
bluesrohkka+N+Ess+PxPl2	bluesrohkkaneattet	blˈu.es#rˌohː.kɑ>nĕæt.teh
bluesrohkka+N+Ess+PxPl3	bluesrohkkaneaset	blˈu.es#rˌohː.kɑ>nĕæ.seh
bluesrohkka+N+Ess+PxSg1	bluesrohkkanan	blˈu.es#rˌohː.kɑ>nɑn
bluesrohkka+N+Ess+PxSg2	bluesrohkkanat	blˈu.es#rˌohː.kɑ>nɑh
bluesrohkka+N+Ess+PxSg3	bluesrohkkanis	blˈu.es#rˌohː.kɑ>nis
bluesrohkka+N+Ess	bluesrohkkan	blˈu.es#rˌohː.kɑ>n
bluesrohkka+N+Sg+Acc+PxDu1	bluesrohkkame	blˈu.es#rˌohː.kɑ>me
bluesrohkka+N+Sg+Acc+PxPl1	bluesrohkkamet	blˈu.es#rˌohː.kɑ>meh
bluesrohkka+N+Sg+Acc+PxSg1	bluesrohkkan	blˈu.es#rˌohː.kɑ>n
bluesrohkka+N+Sg+Gen+PxDu1	bluesrohkkame	blˈu.es#rˌohː.kɑ>me
bluesrohkka+N+Sg+Gen+PxPl1	bluesrohkkamet	blˈu.es#rˌohː.kɑ>meh
bluesrohkka+N+Sg+Gen+PxSg1	bluesrohkkan	blˈu.es#rˌohː.kɑ>n
bluesrohkka+N+Sg+Ill+PxDu1	bluesrohkkaseame	blˈu.es#rˌohː.kɑ>sĕæ.me
bluesrohkka+N+Sg+Ill+PxDu2	bluesrohkkaseatte	blˈu.es#rˌohː.kɑ>sĕæt.te
bluesrohkka+N+Sg+Ill+PxDu3	bluesrohkkaseaskka	blˈu.es#rˌohː.kɑ>seæs.kɑ
bluesrohkka+N+Sg+Ill+PxPl2	bluesrohkkaseattet	blˈu.es#rˌohː.kɑ>sĕæt.teh
bluesrohkka+N+Sg+Ill+PxPl3	bluesrohkkaseaset	blˈu.es#rˌohː.kɑ>sĕæ.seh
bluesrohkka+N+Sg+Ill+PxSg2	bluesrohkkasat	blˈu.es#rˌohː.kɑ>sɑh
bluesrohkka+N+Sg+Nom+PxDu1	bluesrohkkame	blˈu.es#rˌohː.kɑ>me
bluesrohkka+N+Sg+Nom+PxPl1	bluesrohkkamet	blˈu.es#rˌohː.kɑ>meh
bluesrohkka+N+Sg+Nom+PxPl2	bluesrohkkadet	blˈu.es#rˌohː.kɑ>deh
bluesrohkka+N+Sg+Nom+PxSg1	bluesrohkkan	blˈu.es#rˌohː.kɑ>n
bluesrohkka+N+Sg+Nom+PxSg2	bluesrohkkat	blˈu.es#rˌohː.kɑ>h
bluesrohkka+N+Sg+Nom	bluesrohkka	blˈu.es#rˌohː.kɑ>
bluesrohkka+N+Der/viđá+Adv	bluesrohkkaviđá	blˈu.es#rˌohː.kɑ»vˌi.ðɑː
bluesrohkka+N+Sg+Ill	bluesrohkkii	blˈu.es#rˌohː.ki>i
cocktailfeasta+N+Sg+Ill	cocktailfestii	tsˈotsk.tɑːjl#fˌesː.ti>i
cocktailfeasta+N+Ess+PxDu1	cocktailfeastaneame	tsˈotsk.tɑːjl#fˌĕæsː.tɑ>nĕæ.me
cocktailfeasta+N+Ess+PxDu2	cocktailfeastaneatte	tsˈotsk.tɑːjl#fˌĕæsː.tɑ>nĕæt.te
cocktailfeasta+N+Ess+PxDu3	cocktailfeastaneaskka	tsˈotsk.tɑːjl#fˌĕæsː.tɑ>neæs.kɑ
cocktailfeasta+N+Ess+PxPl1	cocktailfeastaneamet	tsˈotsk.tɑːjl#fˌĕæsː.tɑ>nĕæ.meh
cocktailfeasta+N+Ess+PxPl2	cocktailfeastaneattet	tsˈotsk.tɑːjl#fˌĕæsː.tɑ>nĕæt.teh
cocktailfeasta+N+Ess+PxPl3	cocktailfeastaneaset	tsˈotsk.tɑːjl#fˌĕæsː.tɑ>nĕæ.seh
cocktailfeasta+N+Ess+PxSg1	cocktailfeastanan	tsˈotsk.tɑːjl#fˌĕæsː.tɑ>nɑn
cocktailfeasta+N+Ess+PxSg2	cocktailfeastanat	tsˈotsk.tɑːjl#fˌĕæsː.tɑ>nɑh
cocktailfeasta+N+Ess+PxSg3	cocktailfeastanis	tsˈotsk.tɑːjl#fˌĕæsː.tɑ>nis
cocktailfeasta+N+Ess	cocktailfeastan	tsˈotsk.tɑːjl#fˌĕæsː.tɑ>n
cocktailfeasta+N+Sg+Acc+PxDu1	cocktailfeastame	tsˈotsk.tɑːjl#fˌĕæsː.tɑ>me
cocktailfeasta+N+Sg+Acc+PxPl1	cocktailfeastamet	tsˈotsk.tɑːjl#fˌĕæsː.tɑ>meh
cocktailfeasta+N+Sg+Acc+PxSg1	cocktailfeastan	tsˈotsk.tɑːjl#fˌĕæsː.tɑ>n
cocktailfeasta+N+Sg+Gen+PxDu1	cocktailfeastame	tsˈotsk.tɑːjl#fˌĕæsː.tɑ>me
cocktailfeasta+N+Sg+Gen+PxPl1	cocktailfeastamet	tsˈotsk.tɑːjl#fˌĕæsː.tɑ>meh
cocktailfeasta+N+Sg+Gen+PxSg1	cocktailfeastan	tsˈotsk.tɑːjl#fˌĕæsː.tɑ>n
cocktailfeasta+N+Sg+Ill+PxDu1	cocktailfeastaseame	tsˈotsk.tɑːjl#fˌĕæsː.tɑ>sĕæ.me
cocktailfeasta+N+Sg+Ill+PxDu3	cocktailfeastaseaskka	tsˈotsk.tɑːjl#fˌĕæsː.tɑ>seæs.kɑ
cocktailfeasta+N+Sg+Ill+PxPl3	cocktailfeastaseaset	tsˈotsk.tɑːjl#fˌĕæsː.tɑ>sĕæ.seh
cocktailfeasta+N+Sg+Nom+PxDu1	cocktailfeastame	tsˈotsk.tɑːjl#fˌĕæsː.tɑ>me
cocktailfeasta+N+Sg+Nom+PxDu2	cocktailfeastade	tsˈotsk.tɑːjl#fˌĕæsː.tɑ>de
cocktailfeasta+N+Sg+Nom+PxPl2	cocktailfeastadet	tsˈotsk.tɑːjl#fˌĕæsː.tɑ>deh
cocktailfeasta+N+Sg+Nom+PxSg2	cocktailfeastat	tsˈotsk.tɑːjl#fˌĕæsː.tɑ>h
cocktailfeasta+N+Sg+Nom	cocktailfeasta	tsˈotsk.tɑːjl#fˌĕæsː.tɑ>
cocktailfeasta+N+Der/viđá+Adv	cocktailfeastaviđá	tsˈotsk.tɑːjl#fˌĕæsː.tɑ»vˌi.ðɑː
cocktailfeasta+N+Pl+Acc+PxSg2	cocktailfeasttaidat	tsˈotsk.tɑːjl#fˌeæs.tɑ>i.dɑh
cocktailfeasta+N+Pl+Acc+PxSg3	cocktailfeasttaidis	tsˈotsk.tɑːjl#fˌeæs.tɑ>i.dis
cocktailfeasta+N+Pl+Com+PxDu2	cocktailfeasttaideatteguin	tsˈotsk.tɑːjl#fˌeæs.tɑ>i.dĕæt.te.gujn
cocktailfeasta+N+Pl+Com+PxPl1	cocktailfeasttaideametguin	tsˈotsk.tɑːjl#fˌeæs.tɑ>i.dĕæ.met.gujn
cocktailfeasta+N+Pl+Com+PxPl2	cocktailfeasttaideattetguin	tsˈotsk.tɑːjl#fˌeæs.tɑ>i.dĕæt.tet.gujn
cocktailfeasta+N+Pl+Com+PxSg1	cocktailfeasttaidanguin	tsˈotsk.tɑːjl#fˌeæs.tɑ>i.dɑn.gujn
cocktailfeasta+N+Pl+Com+PxSg3	cocktailfeasttaidisguin	tsˈotsk.tɑːjl#fˌeæs.tɑ>i.dis.gujn
cocktailfeasta+N+Pl+Gen	cocktailfeasttaid	tsˈotsk.tɑːjl#fˌeæs.tɑ>id
cocktailfeasta+N+Pl+Ill+PxDu3	cocktailfeasttaidasaska	tsˈotsk.tɑːjl#fˌeæs.tɑ>i.dɑ.sɑs.kɑ
cocktailfeasta+N+Pl+Loc+PxDu3	cocktailfeasttaineaskka	tsˈotsk.tɑːjl#fˌeæs.tɑ>i.neæs.kɑ
cocktailfeasta+N+Pl+Nom	cocktailfeasttat	tsˈotsk.tɑːjl#fˌeæs.tɑ>h
cocktailfeasta+N+Sg+Acc+PxDu3	cocktailfeasttaska	tsˈotsk.tɑːjl#fˌeæs.tɑ>skɑ
cocktailfeasta+N+Sg+Acc+PxPl3	cocktailfeasttaset	tsˈotsk.tɑːjl#fˌeæs.tɑ>seh
cocktailfeasta+N+Sg+Acc	cocktailfeastta	tsˈotsk.tɑːjl#fˌeæs.tɑ>
cocktailfeasta+N+Sg+Gen+PxDu3	cocktailfeasttaska	tsˈotsk.tɑːjl#fˌeæs.tɑ>skɑ
cocktailfeasta+N+Sg+Gen+PxPl2	cocktailfeasttadet	tsˈotsk.tɑːjl#fˌeæs.tɑ>deh
cocktailfeasta+N+Sg+Gen+PxPl3	cocktailfeasttaset	tsˈotsk.tɑːjl#fˌeæs.tɑ>seh
cocktailfeasta+N+Sg+Gen+PxSg2	cocktailfeasttat	tsˈotsk.tɑːjl#fˌeæs.tɑ>h
cocktailfeasta+N+Sg+Com+PxDu1	cocktailfeasttaineame	tsˈotsk.tɑːjl#fˌeæs.tɑ>i.nĕæ.me
cocktailfeasta+N+Sg+Com+PxDu2	cocktailfeasttaineatte	tsˈotsk.tɑːjl#fˌeæs.tɑ>i.nĕæt.te
cocktailfeasta+N+Sg+Com+PxDu3	cocktailfeasttaineaskka	tsˈotsk.tɑːjl#fˌeæs.tɑ>i.neæs.kɑ
cocktailfeasta+N+Sg+Com+PxPl1	cocktailfeasttaineamet	tsˈotsk.tɑːjl#fˌeæs.tɑ>i.nĕæ.meh
cocktailfeasta+N+Sg+Com+PxPl2	cocktailfeasttaineattet	tsˈotsk.tɑːjl#fˌeæs.tɑ>i.nĕæt.teh
cocktailfeasta+N+Sg+Com+PxPl3	cocktailfeasttaineaset	tsˈotsk.tɑːjl#fˌeæs.tɑ>i.nĕæ.seh
cocktailfeasta+N+Sg+Com+PxSg1	cocktailfeasttainan	tsˈotsk.tɑːjl#fˌeæs.tɑ>i.nɑn
cocktailfeasta+N+Sg+Com+PxSg3	cocktailfeasttainis	tsˈotsk.tɑːjl#fˌeæs.tɑ>i.nis
cocktailfeasta+N+Sg+Com	cocktailfeasttain	tsˈotsk.tɑːjl#fˌeæs.tɑ>in
cocktailfeasta+N+Sg+Loc	cocktailfeasttas	tsˈotsk.tɑːjl#fˌeæs.tɑ>s
cocktailfeasta+N+Sg+Loc+PxDu3	cocktailfeasttasteaskka	tsˈotsk.tɑːjl#fˌeæs.tɑ>steæs.kɑ
cocktailfeasta+N+Sg+Loc+PxPl2	cocktailfeasttasteattet	tsˈotsk.tɑːjl#fˌeæs.tɑ>stĕæt.teh
cocktailfeasta+N+Sg+Loc+PxSg2	cocktailfeasttastat	tsˈotsk.tɑːjl#fˌeæs.tɑ>stɑh
cocktailfeasta+N+Der/Dimin+N+Sg+Nom	cocktailfeasttaš	tsˈotsk.tɑːjl#fˌeæs.tɑ»ʃ
cocktailfeasta+N+Der/Dimin+N+Der/viđá+Adv	cocktailfeasttašviđá	tsˈotsk.tɑːjl#fˌeæs.tɑ»ʃ»vˌi.ðɑː
cocktailfeasta+N+Der/Dimin+N+Ess	cocktailfeasttažin	tsˈotsk.tɑːjl#fˌeæs.tɑ»dʃin
cocktailfeasta+N+Der/Dimin+N+Der/Dimin+N+Sg+Gen+PxSg1	cocktailfeasttažažžan	tsˈotsk.tɑːjl#fˌeæs.tɑ»dʃˌɑdː.tʃɑ>n
cocktailfeasta+N+Der/Dimin+N+Pl+Acc+PxSg2	cocktailfeasttažiiddát	tsˈotsk.tɑːjl#fˌeæs.tɑ»dʃˌijtː.tɑː>h
cocktailfeasta+N+Der/Dimin+N+Pl+Com+PxPl2	cocktailfeasttažiiddádetguin	tsˈotsk.tɑːjl#fˌeæs.tɑ»dʃˌijtː.tɑː>det.gujn
cocktailfeasta+N+Der/Dimin+N+Pl+Nom+PxSg3	cocktailfeasttažiiddis	tsˈotsk.tɑːjl#fˌeæs.tɑ»dʃˌijt.ti>s
cocktailfeasta+N+Der/heapmi+A+Comp+Sg+Gen	cocktailfeasttaheappo	tsˈotsk.tɑːjl#fˌeæs.tɑ»hˌĕæp.po>
cocktailfeasta+N+Der/heapmi+A+Superl+Attr	cocktailfeasttahamos	tsˈotsk.tɑːjl#fˌeæs.tɑ»hˌɑ.mos>
cocktailfeasta+N+Der/heapmi+A+Superl+Ess	cocktailfeasttahamosin	tsˈotsk.tɑːjl#fˌeæs.tɑ»hˌɑ.mos>in
cocktailfeasta+N+Der/heapmi+A+Superl+Sg+Ill	cocktailfeasttahamosii	tsˈotsk.tɑːjl#fˌeæs.tɑ»hˌɑ.mos>ij
cocktailfeasta+N+Der/heapmi+A+Superl+Ess	cocktailfeasttaheamosin	tsˈotsk.tɑːjl#fˌeæs.tɑ»hˌĕæ.mos>in
cocktailfeasta+N+Der/heapmi+A+Sg+Loc	cocktailfeasttaheames	tsˈotsk.tɑːjl#fˌeæs.tɑ»hˌĕæ.me>s
cocktailfeasta+N+Der/heapmi+A+Pl+Nom	cocktailfeasttaheamit	tsˈotsk.tɑːjl#fˌeæs.tɑ»hˌeæ.mi>h
cocktailfeasta+N+Der/heapmi+A+Sg+Ill	cocktailfeasttaheapmái	tsˈotsk.tɑːjl#fˌeæs.tɑ»hˌeæp.mɑː>i
cocktailfeasta+N+Der/heapmi+A+Pl+Ill	cocktailfeasttahemiide	tsˈotsk.tɑːjl#fˌeæs.tɑ»hˌe.mi>i.de
cocktailfeasta+N+Der/heapmi+A+Sg+Com	cocktailfeasttahemiin	tsˈotsk.tɑːjl#fˌeæs.tɑ»hˌe.mi>in
cocktailfeasta+N+Der/heapmi+A+Attr+Der/vuohta+N+Sg+Ill	cocktailfeasttahisvuhtii	tsˈotsk.tɑːjl#fˌeæs.tɑ»his>»vˌuh.tij
cocktailfeasta+N+Der/heapmi+A+Attr+Der/vuohta+N+Sg+Loc+PxDu3	cocktailfeasttahisvuođasteaskka	tsˈotsk.tɑːjl#fˌeæs.tɑ»his>»vˌuo.ðɑs.tˌeæs.kɑ
cocktailfeasta+N+Der/huhtti+V+TV+Ind+Prs+ConNeg	cocktailfeasttahuhte	tsˈotsk.tɑːjl#fˌeæs.tɑ»hˌuh.te>
cocktailfeasta+N+Der/huhtti+V+TV+Pot+Prs+Du3	cocktailfeasttahuhtežeaba	tsˈotsk.tɑːjl#fˌeæs.tɑ»hˌuh.te>žeæ.bɑ
cocktailfeasta+N+Der/huhtti+V+TV+VAbess+A+Attr	cocktailfeasttahuhtikeahtes	tsˈotsk.tɑːjl#fˌeæs.tɑ»hˌuh.ti>kĕæh.tes
cocktailfeasta+N+Der/huhtti+V+TV+Der/NomAg+N+Sg+Gen+PxPl3	cocktailfeasttahuhttiset	tsˈotsk.tɑːjl#fˌeæs.tɑ»hˌuhː.ti>»seh
cocktailfeasta+N+Der/huhtti+V+TV+Der/muš+N+Der/viđá+Adv	cocktailfeasttahuhttámoššviđá	tsˈotsk.tɑːjl#fˌeæs.tɑ»hˌuhː.tɑː>»moʃː»vˌi.ðɑː
cocktailfeasta+N+Der/huhtti+V+TV+Der/muš+N+Sg+Ill	cocktailfeasttahuhttámuššii	tsˈotsk.tɑːjl#fˌeæs.tɑ»hˌuhː.tɑː>»mˌuʃ.ʃij
cocktailfeasta+N+Der/huhtti+V+TV+Cond+Prs+Du3	cocktailfeasttahuhtáleigga	tsˈotsk.tɑːjl#fˌeæs.tɑ»hˌuhː.tɑː>lejk.kɑ
cocktailfeasta+N+Der/huhtti+V+TV+Ind+Prs+Sg2	cocktailfeasttahuhtát	tsˈotsk.tɑːjl#fˌeæs.tɑ»hˌuhː.tɑː>h
cocktailfeasta+N+Der/huvva+V+IV+Ger+PxSg2	cocktailfeasttahuvadettiinat	tsˈotsk.tɑːjl#fˌeæs.tɑ»hˌu.vɑ>det.tij.nɑh
cocktailfeasta+N+Der/huvva+V+IV+Sup	cocktailfeasttahuvažit	tsˈotsk.tɑːjl#fˌeæs.tɑ»hˌu.vɑ>žih
cocktailfeasta+N+Der/huvva+V+IV+VAbess	cocktailfeasttahuvahaga	tsˈotsk.tɑːjl#fˌeæs.tɑ»hˌu.vɑ>hɑ.gɑ
cocktailfeasta+N+Der/huvva+V+IV+VAbess+A+Attr	cocktailfeasttahuvakeahtes	tsˈotsk.tɑːjl#fˌeæs.tɑ»hˌu.vɑ>kĕæh.tes
cocktailfeasta+N+Der/huvva+V+IV+VAbess	cocktailfeasttahuvakeahttá	tsˈotsk.tɑːjl#fˌeæs.tɑ»hˌu.vɑ>kĕæhː.tɑː
cocktailfeasta+N+Der/huvva+V+IV+Imprt+Pl2	cocktailfeasttahuvvet	tsˈotsk.tɑːjl#fˌeæs.tɑ»hˌuv.ve>h
cocktailfeasta+N+Der/huvva+V+IV+ConNegII	cocktailfeasttahuvvo	tsˈotsk.tɑːjl#fˌeæs.tɑ»hˌuv.vo>
cocktailfeasta+N+Der/huvva+V+IV+Imprt+Du1	cocktailfeasttahuvvu	tsˈotsk.tɑːjl#fˌeæs.tɑ»hˌuv.vu>
cocktailfeasta+N+Der/laš+A+Comp+Ess	cocktailfeasttaleabbon	tsˈotsk.tɑːjl#fˌeæs.tɑ»lˌĕæbː.po>n
cocktailfeasta+N+Der/laš+A+Comp+Sg+Ill	cocktailfeasttalebbui	tsˈotsk.tɑːjl#fˌeæs.tɑ»lˌebː.pu>i
cocktailfeasta+N+Der/laš+A+Comp+Sg+Nom	cocktailfeasttalet	tsˈotsk.tɑːjl#fˌeæs.tɑ»let>
cocktailfeasta+N+Der/laš+A+Comp+Attr	cocktailfeasttalut	tsˈotsk.tɑːjl#fˌeæs.tɑ»lut>
cocktailfeasta+N+Der/laš+A+Comp+Sg+Nom	cocktailfeasttalut	tsˈotsk.tɑːjl#fˌeæs.tɑ»lut>
cocktailfeasta+N+Der/laš+A+Ess	cocktailfeasttalažžan	tsˈotsk.tɑːjl#fˌeæs.tɑ»lˌɑdː.tʃɑ>n
cocktailfeasta+N+Der/laš+A+Superl+Sg+Ill	cocktailfeasttalaččamussii	tsˈotsk.tɑːjl#fˌeæs.tɑ»lˌɑt.tʃɑ>mus.sij
cocktailfeasta+N+Der/laš+A+AttrCmp+Der/agat+A+Sg+Nom	cocktailfeasttalašagat	tsˈotsk.tɑːjl#fˌeæs.tɑ»lɑʃ>»ˌɑ.gɑh
cocktailfeasta+N+Der/laš+A+Sg+Nom	cocktailfeasttalaš	tsˈotsk.tɑːjl#fˌeæs.tɑ»lɑʃ>
cocktailfeasta+N+Der/laš+A+Der/vuohta+N+Der/viđá+Adv	cocktailfeasttalašvuohtaviđá	tsˈotsk.tɑːjl#fˌeæs.tɑ»lɑʃ»vˌuoh.tɑ»vˌi.ðɑː
cocktailfeasta+N+Der/laš+A+Der/vuohta+N+Sg+Com+PxDu2	cocktailfeasttalašvuođaineatte	tsˈotsk.tɑːjl#fˌeæs.tɑ»lɑʃ»vˌuo.ðɑ>i.nĕæt.te
comeback+N+Sg+Nom	comeback	tsˈo.me#pɑtsk>
comeback+N+Ess+PxDu1	comebackaneame	tsˈo.me#pˌɑts.kɑ>nĕæ.me
comeback+N+Ess+PxDu2	comebackaneatte	tsˈo.me#pˌɑts.kɑ>nĕæt.te
comeback+N+Ess+PxDu3	comebackaneaskka	tsˈo.me#pˌɑts.kɑ>neæs.kɑ
comeback+N+Ess+PxPl1	comebackaneamet	tsˈo.me#pˌɑts.kɑ>nĕæ.meh
comeback+N+Ess+PxPl2	comebackaneattet	tsˈo.me#pˌɑts.kɑ>nĕæt.teh
comeback+N+Ess+PxPl3	comebackaneaset	tsˈo.me#pˌɑts.kɑ>nĕæ.seh
comeback+N+Ess+PxSg1	comebackanan	tsˈo.me#pˌɑts.kɑ>nɑn
comeback+N+Ess+PxSg2	comebackanat	tsˈo.me#pˌɑts.kɑ>nɑh
comeback+N+Ess+PxSg3	comebackanis	tsˈo.me#pˌɑts.kɑ>nis
comeback+N+Ess	comebackan	tsˈo.me#pˌɑts.kɑ>n
comeback+N+Pl+Acc+PxDu1	comebackaideame	tsˈo.me#pˌɑts.kɑ>i.dĕæ.me
comeback+N+Pl+Acc+PxDu3	comebackaideaskka	tsˈo.me#pˌɑts.kɑ>i.deæs.kɑ
comeback+N+Pl+Acc+PxPl2	comebackaideattet	tsˈo.me#pˌɑts.kɑ>i.dĕæt.teh
comeback+N+Pl+Acc+PxPl3	comebackaideaset	tsˈo.me#pˌɑts.kɑ>i.dĕæ.seh
comeback+N+Pl+Acc+PxSg3	comebackaidis	tsˈo.me#pˌɑts.kɑ>i.dis
comeback+N+Pl+Com+PxDu3	comebackaideaskkaguin	tsˈo.me#pˌɑts.kɑ>i.deæs.kɑ.gujn
comeback+N+Pl+Com+PxPl3	comebackaideasetguin	tsˈo.me#pˌɑts.kɑ>i.dĕæ.set.gujn
comeback+N+Pl+Com	comebackaiguin	tsˈo.me#pˌɑts.kɑ>i.gujn
comeback+N+Pl+Gen+PxDu1	comebackaideame	tsˈo.me#pˌɑts.kɑ>i.dĕæ.me
comeback+N+Pl+Gen+PxPl1	comebackaideamet	tsˈo.me#pˌɑts.kɑ>i.dĕæ.meh
comeback+N+Pl+Gen+PxSg3	comebackaidis	tsˈo.me#pˌɑts.kɑ>i.dis
comeback+N+Pl+Ill+PxDu1	comebackaidaseame	tsˈo.me#pˌɑts.kɑ>i.dɑ.sĕæ.me
comeback+N+Pl+Ill	comebackaide	tsˈo.me#pˌɑts.kɑ>i.de
comeback+N+Pl+Loc+PxDu1	comebackaineame	tsˈo.me#pˌɑts.kɑ>i.nĕæ.me
comeback+N+Pl+Loc+PxPl1	comebackaineamet	tsˈo.me#pˌɑts.kɑ>i.nĕæ.meh
comeback+N+Pl+Loc+PxPl2	comebackaineattet	tsˈo.me#pˌɑts.kɑ>i.nĕæt.teh
comeback+N+Pl+Loc+PxPl3	comebackaineaset	tsˈo.me#pˌɑts.kɑ>i.nĕæ.seh
comeback+N+Pl+Loc+PxSg3	comebackainis	tsˈo.me#pˌɑts.kɑ>i.nis
comeback+N+Pl+Loc	comebackain	tsˈo.me#pˌɑts.kɑ>in
comeback+N+Pl+Nom+PxDu1	comebackaideame	tsˈo.me#pˌɑts.kɑ>i.dĕæ.me
comeback+N+Pl+Nom+PxPl1	comebackaideamet	tsˈo.me#pˌɑts.kɑ>i.dĕæ.meh
comeback+N+Pl+Nom	comebackat	tsˈo.me#pˌɑts.kɑ>h
comeback+N+Sg+Acc+PxDu2	comebackade	tsˈo.me#pˌɑts.kɑ>de
comeback+N+Sg+Acc+PxPl1	comebackamet	tsˈo.me#pˌɑts.kɑ>meh
comeback+N+Sg+Acc+PxPl2	comebackadet	tsˈo.me#pˌɑts.kɑ>deh
comeback+N+Sg+Acc+PxSg1	comebackan	tsˈo.me#pˌɑts.kɑ>n
comeback+N+Sg+Acc+PxSg3	comebackas	tsˈo.me#pˌɑts.kɑ>s
comeback+N+Sg+Com+PxDu1	comebackaineame	tsˈo.me#pˌɑts.kɑ>i.nĕæ.me
comeback+N+Sg+Com+PxPl3	comebackaineaset	tsˈo.me#pˌɑts.kɑ>i.nĕæ.seh
comeback+N+Sg+Com+PxSg1	comebackainan	tsˈo.me#pˌɑts.kɑ>i.nɑn
comeback+N+Sg+Com	comebackain	tsˈo.me#pˌɑts.kɑ>in
comeback+N+Sg+Gen+PxDu3	comebackaska	tsˈo.me#pˌɑts.kɑ>skɑ
comeback+N+Sg+Gen+PxPl2	comebackadet	tsˈo.me#pˌɑts.kɑ>deh
comeback+N+Sg+Gen+PxSg1	comebackan	tsˈo.me#pˌɑts.kɑ>n
comeback+N+Sg+Gen+PxSg2	comebackat	tsˈo.me#pˌɑts.kɑ>h
comeback+N+Sg+Gen	comebacka	tsˈo.me#pˌɑts.kɑ>
comeback+N+Sg+Ill+PxDu1	comebackasame	tsˈo.me#pˌɑts.kɑ>sɑ.me
comeback+N+Sg+Ill+PxDu2	comebackasatte	tsˈo.me#pˌɑts.kɑ>sɑt.te
comeback+N+Sg+Ill+PxPl2	comebackasattet	tsˈo.me#pˌɑts.kɑ>sɑt.teh
comeback+N+Sg+Ill+PxPl3	comebackasaset	tsˈo.me#pˌɑts.kɑ>sɑ.seh
comeback+N+Sg+Ill+PxSg1	comebackasan	tsˈo.me#pˌɑts.kɑ>sɑn
comeback+N+Sg+Ill+PxSg2	comebackasat	tsˈo.me#pˌɑts.kɑ>sɑh
comeback+N+Sg+Ill+PxSg3	comebackasas	tsˈo.me#pˌɑts.kɑ>sɑs
comeback+N+Sg+Loc	comebackas	tsˈo.me#pˌɑts.kɑ>s
comeback+N+Sg+Loc+PxDu2	comebackasteatte	tsˈo.me#pˌɑts.kɑ>stĕæt.te
comeback+N+Sg+Loc+PxPl3	comebackasteaset	tsˈo.me#pˌɑts.kɑ>stĕæ.seh
comeback+N+Sg+Loc+PxSg1	comebackastan	tsˈo.me#pˌɑts.kɑ>stɑn
comeback+N+Sg+Loc+PxSg3	comebackastis	tsˈo.me#pˌɑts.kɑ>stis
comeback+N+Sg+Nom+PxDu1	comebackame	tsˈo.me#pˌɑts.kɑ>me
comeback+N+Sg+Nom+PxDu3	comebackaska	tsˈo.me#pˌɑts.kɑ>skɑ
comeback+N+Sg+Nom+PxPl1	comebackamet	tsˈo.me#pˌɑts.kɑ>meh
comeback+N+Sg+Nom+PxPl2	comebackadet	tsˈo.me#pˌɑts.kɑ>deh
comeback+N+Sg+Nom+PxPl3	comebackaset	tsˈo.me#pˌɑts.kɑ>seh
comeback+N+Sg+Nom+PxSg2	comebackat	tsˈo.me#pˌɑts.kɑ>h
comeback+N+Sg+Nom+PxSg3	comebackas	tsˈo.me#pˌɑts.kɑ>s
comeback+N+Sg+Nom	comebacka	tsˈo.me#pˌɑts.kɑ>
comeback+N+Der/Dimin+N+Sg+Nom	comebackaš	tsˈo.me#pˌɑts.kɑ>»ʃ
comeback+N+Der/Dimin+N+Der/viđá+Adv	comebackašviđá	tsˈo.me#pˌɑts.kɑ>»ʃ»vˌi.ðɑː
comeback+N+Der/Dimin+N+Ess	comebackažin	tsˈo.me#pˌɑts.kɑ>»žin
comeback+N+Der/Dimin+N+Pl+Nom	comebackažat	tsˈo.me#pˌɑts.kɑ>»žɑh
comeback+N+Der/Dimin+N+Pl+Acc	comebackažiid	tsˈo.me#pˌɑts.kɑ>»žijh
comeback+N+Der/Dimin+N+Sg+Ill	comebackažii	tsˈo.me#pˌɑts.kɑ>»žij
comeback+N+Der/heapmi+A+Comp+Sg+Nom	comebackahat	tsˈo.me#pˌɑts.kɑ>»hɑh
comeback+N+Der/heapmi+A+Comp+Attr	comebackahet	tsˈo.me#pˌɑts.kɑ>»heh
comeback+N+Der/heapmi+A+Comp+Sg+Nom	comebackahut	tsˈo.me#pˌɑts.kɑ>»huh
comeback+N+Der/heapmi+A+Superl+Sg+Ill	comebackahepmosii	tsˈo.me#pˌɑts.kɑ>»hˌep.mo.sij
comeback+N+Der/heapmi+A+Ess	comebackaheapmin	tsˈo.me#pˌɑts.kɑ>»hˌeæp.min
comeback+N+Der/heapmi+A+Sg+Gen	comebackaheame	tsˈo.me#pˌɑts.kɑ>»hˌĕæ.me
comeback+N+Der/heapmi+A+Sg+Com	comebackahemiin	tsˈo.me#pˌɑts.kɑ>»hˌe.mijn
comeback+N+Der/heapmi+A+Attr+Der/vuohta+N+Sg+Gen+PxSg3	comebackahisvuođas	tsˈo.me#pˌɑts.kɑ>»his»vˌuo.ðɑs
comeback+N+Der/huhtti+V+TV+Ind+Prs+ConNeg	comebackahuhte	tsˈo.me#pˌɑts.kɑ>»hˌuh.te
comeback+N+Der/huhtti+V+TV+VAbess	comebackahuhtehaga	tsˈo.me#pˌɑts.kɑ>»hˌuh.te.hˌɑ.gɑ
comeback+N+Der/huhtti+V+TV+Ger	comebackahuhtidiin	tsˈo.me#pˌɑts.kɑ>»hˌuh.ti.dijn
comeback+N+Der/huhtti+V+TV+Ind+Prt+Pl1	comebackahuhtiimet	tsˈo.me#pˌɑts.kɑ>»hˌuh.tij.meh
comeback+N+Der/huhtti+V+TV+VAbess+A+Attr	comebackahuhtikeahtes	tsˈo.me#pˌɑts.kɑ>»hˌuh.ti.kˌĕæh.tes
comeback+N+Der/huhtti+V+TV+Actio+Gen	comebackahuhttin	tsˈo.me#pˌɑts.kɑ>»hˌuhː.tin
comeback+N+Der/huhtti+V+TV+Der/NomAg+N+Pl+Nom	comebackahuhttit	tsˈo.me#pˌɑts.kɑ>»hˌuhː.ti»h
comeback+N+Der/huhtti+V+TV+Der/PassL+V+IV+Actio+Gen	comebackahuhttojuvvon	tsˈo.me#pˌɑts.kɑ>»hˌuhː.to.jˌuv.von
comeback+N+Der/huhtti+V+TV+Cond+Prs+Pl3	comebackahuhtáše	tsˈo.me#pˌɑts.kɑ>»hˌuhː.tɑː.ʃe
comeback+N+Der/huvva+V+IV+Ger	comebackahuvadiin	tsˈo.me#pˌɑts.kɑ>»hˌu.vɑ.dijn
comeback+N+Der/huvva+V+IV+Ind+Prs+ConNeg	comebackahuva	tsˈo.me#pˌɑts.kɑ>»hˌu.vɑ
comeback+N+Der/huvva+V+IV+Ind+Prs+Pl2	comebackahuvvabehtet	tsˈo.me#pˌɑts.kɑ>»hˌuv.vɑ.bˌeh.teh
comeback+N+Der/huvva+V+IV+Imprt+Pl2	comebackahuvvet	tsˈo.me#pˌɑts.kɑ>»hˌuv.veh
comeback+N+Der/huvva+V+IV+ConNegII	comebackahuvvo	tsˈo.me#pˌɑts.kɑ>»hˌuv.vo
comeback+N+Der/huvva+V+IV+Imprt+Pl1	comebackahuvvut	tsˈo.me#pˌɑts.kɑ>»hˌuvː.vuh
comeback+N+Der/huvva+V+IV+Ind+Prs+Sg3	comebackahuvvá	tsˈo.me#pˌɑts.kɑ>»hˌuvː.vɑː
comeback+N+Sg+Ill	comebackii	tsˈo.me#pˌɑts.ki>i
hacker+N+Ess	hackerin	hˈɑts.ker>in
hacker+N+Pl+Nom	hackerat	hˈɑts.ker>ɑh
hacker+N+Sg+Acc+PxDu1	hackereame	hˈɑts.ker>ĕæ.me
hacker+N+Sg+Acc+PxDu2	hackereatte	hˈɑts.ker>ĕæt.te
hacker+N+Sg+Acc+PxDu3	hackereaskka	hˈɑts.ker>eæs.kɑ
hacker+N+Sg+Acc+PxPl1	hackereamet	hˈɑts.ker>ĕæ.meh
hacker+N+Sg+Acc+PxPl2	hackereattet	hˈɑts.ker>ĕæt.teh
hacker+N+Sg+Acc+PxSg1	hackeran	hˈɑts.ker>ɑn
hacker+N+Sg+Gen+PxDu1	hackereame	hˈɑts.ker>ĕæ.me
hacker+N+Sg+Gen+PxDu3	hackereaskka	hˈɑts.ker>eæs.kɑ
hacker+N+Sg+Gen+PxPl2	hackereattet	hˈɑts.ker>ĕæt.teh
hacker+N+Sg+Gen+PxSg1	hackeran	hˈɑts.ker>ɑn
hacker+N+Sg+Gen+PxSg2	hackerat	hˈɑts.ker>ɑh
hacker+N+Sg+Gen+PxSg3	hackeris	hˈɑts.ker>is
hacker+N+Sg+Nom+PxPl3	hackereaset	hˈɑts.ker>ĕæ.seh
hacker+N+Sg+Nom+PxSg1	hackeran	hˈɑts.ker>ɑn
hacker+N+Sg+Acc	hackera	hˈɑts.ker>ɑ
hacker+N+Sg+Gen	hackera	hˈɑts.ker>ɑ
hacker+N+Sg+Ill+PxDu1	hackerasame	hˈɑts.ker>ɑ.sɑ.me
hacker+N+Sg+Ill+PxDu2	hackerasade	hˈɑts.ker>ɑ.sɑ.de
hacker+N+Sg+Ill+PxPl1	hackerasamet	hˈɑts.ker>ɑ.sɑ.meh
hacker+N+Sg+Ill+PxPl2	hackerasadet	hˈɑts.ker>ɑ.sɑ.deh
hacker+N+Sg+Ill+PxPl3	hackerasaset	hˈɑts.ker>ɑ.sɑ.seh
hacker+N+Sg+Ill+PxSg1	hackerasan	hˈɑts.ker>ɑ.sɑn
hacker+N+Pl+Acc	hackeriid	hˈɑts.ker>ijh
hacker+N+Pl+Acc+PxDu2	hackeriiddáde	hˈɑts.ker>ijt.tɑː.de
hacker+N+Pl+Com	hackeriiguin	hˈɑts.ker>ij.gujn
hacker+N+Pl+Ill+PxSg3	hackeriiddásis	hˈɑts.ker>ijt.tɑː.sis
hacker+N+Pl+Loc+PxDu3	hackeriinniska	hˈɑts.ker>ijn.nis.kɑ
hacker+N+Pl+Nom+PxSg3	hackeriiddis	hˈɑts.ker>ijt.tis
hacker+N+Pl+Nom+PxDu1	hackeriiddáme	hˈɑts.ker>ijt.tɑː.me
hacker+N+Pl+Nom+PxSg2	hackeriiddát	hˈɑts.ker>ijt.tɑːh
hacker+N+Sg+Com	hackeriin	hˈɑts.ker>ijn
hacker+N+Sg+Com+PxPl3	hackeriinniset	hˈɑts.ker>ijn.ni.seh
hacker+N+Sg+Com+PxSg2	hackeriinnát	hˈɑts.ker>ijn.nɑːh
hacker+N+Sg+Ill	hackerii	hˈɑts.ker>ij
hacker+N+Sg+Loc	hackeris	hˈɑts.ker>is
hacker+N+Sg+Loc+PxDu3	hackeristtiska	hˈɑts.ker>is.tis.kɑ
hacker+N+Sg+Loc+PxPl3	hackeristtiset	hˈɑts.ker>is.ti.seh
hacker+N+Sg+Loc+PxSg3	hackeristtis	hˈɑts.ker>is.tis
hacker+N+Sg+Loc+PxDu1	hackeristtáme	hˈɑts.ker>is.tɑː.me
hacker+N+Sg+Loc+PxDu2	hackeristtáde	hˈɑts.ker>is.tɑː.de
hacker+N+Sg+Loc+PxSg2	hackeristtát	hˈɑts.ker>is.tɑːh
hacker+N+Der/geahtes+A+Attr	hackergeahtes	hˈɑts.ker>»gˌĕæh.tes
hacker+N+Der/geahtes+A+Attr	hackerkeahtes	hˈɑts.ker>»kˌĕæh.tes
hacker+N+Der/Dimin+N+Der/Dimin+N+Sg+Nom	hackeraččaš	hˈɑts.ker»ˌɑt.tʃɑ»ʃ
hacker+N+Der/Dimin+N+Der/Dimin+N+Ess	hackeraččažin	hˈɑts.ker»ˌɑt.tʃɑ»dʃin
hacker+N+Der/Dimin+N+Der/Dimin+N+Pl+Nom	hackeraččažat	hˈɑts.ker»ˌɑt.tʃɑ»dʃɑh
hacker+N+Der/Dimin+N+Der/Dimin+N+Sg+Gen+PxDu1	hackeraččažeame	hˈɑts.ker»ˌɑt.tʃɑ»dʃˌĕæ.me
hacker+N+Der/Dimin+N+Der/Dimin+N+Sg+Gen+PxSg1	hackeraččažan	hˈɑts.ker»ˌɑt.tʃɑ»dʃɑn
hacker+N+Der/Dimin+N+Der/Dimin+N+Sg+Ill	hackeraččažii	hˈɑts.ker»ˌɑt.tʃɑ»dʃij
hacker+N+Der/Dimin+N+Pl+Com+PxDu2	hackeraččaideatteguin	hˈɑts.ker»ˌɑt.tʃɑ>i.dĕæt.te.gujn
hacker+N+Der/Dimin+N+Pl+Ill	hackeraččaide	hˈɑts.ker»ˌɑt.tʃɑ>i.de
hacker+N+Der/Dimin+N+Pl+Nom+PxPl1	hackeraččaideamet	hˈɑts.ker»ˌɑt.tʃɑ>i.dĕæ.meh
hacker+N+Der/Dimin+N+Sg+Acc+PxDu3	hackeraččaska	hˈɑts.ker»ˌɑt.tʃɑ>skɑ
hacker+N+Der/Dimin+N+Sg+Acc+PxSg2	hackeraččat	hˈɑts.ker»ˌɑt.tʃɑ>h
hacker+N+Der/Dimin+N+Sg+Com+PxPl1	hackeraččaineamet	hˈɑts.ker»ˌɑt.tʃɑ>i.nĕæ.meh
hacker+N+Der/Dimin+N+Sg+Com	hackeraččain	hˈɑts.ker»ˌɑt.tʃɑ>in
hacker+N+Der/Dimin+N+Sg+Nom	hackeraš	hˈɑts.ker»ɑʃ>
hacker+N+Der/Dimin+N+Ess+PxPl2	hackeražžaneattet	hˈɑts.ker»ˌɑdː.tʃɑ>nĕæt.teh
hacker+N+Der/Dimin+N+Ess+PxPl3	hackeražžaneaset	hˈɑts.ker»ˌɑdː.tʃɑ>nĕæ.seh
hacker+N+Der/Dimin+N+Ess+PxSg1	hackeražžanan	hˈɑts.ker»ˌɑdː.tʃɑ>nɑn
hacker+N+Der/Dimin+N+Sg+Acc+PxPl1	hackeražžamet	hˈɑts.ker»ˌɑdː.tʃɑ>meh
hacker+N+Der/Dimin+N+Sg+Gen+PxPl1	hackeražžamet	hˈɑts.ker»ˌɑdː.tʃɑ>meh
hacker+N+Der/Dimin+N+Sg+Nom+PxDu2	hackeražžade	hˈɑts.ker»ˌɑdː.tʃɑ>de
hacker+N+Der/Dimin+N+Sg+Nom+PxDu3	hackeražžaska	hˈɑts.ker»ˌɑdː.tʃɑ>skɑ
hacker+N+Der/Dimin+N+Sg+Ill+PxSg3	hackeražžasis	hˈɑts.ker»ˌɑdː.tʃɑ>sis
hacker+N+Der/Dimin+N+Sg+Ill	hackeražžii	hˈɑts.ker»ˌɑdː.tʃi>i
hacker+N+Der/heapmi+A+Ess	hackerheapmin	hˈɑts.ker»hˌeæp.mi>n
hacker+N+Der/heapmi+A+Sg+Acc	hackerheame	hˈɑts.ker»hˌĕæ.me>
hacker+N+Der/heapmi+A+Sg+Loc	hackerheames	hˈɑts.ker»hˌĕæ.me>s
hacker+N+Der/heapmi+A+Pl+Nom	hackerheamit	hˈɑts.ker»hˌeæ.mi>h
hacker+N+Der/heapmi+A+Sg+Gen	hackerheami	hˈɑts.ker»hˌeæ.mi>
hacker+N+Der/heapmi+A+Sg+Loc	hackerheamis	hˈɑts.ker»hˌeæ.mi>s
hacker+N+Der/heapmi+A+Sg+Nom	hackerheapme	hˈɑts.ker»hˌĕæp.me>
hacker+N+Der/heapmi+A+Sg+Ill	hackerheapmái	hˈɑts.ker»hˌeæp.mɑː>i
hacker+N+Der/heapmi+A+Pl+Acc	hackerhemiid	hˈɑts.ker»hˌe.mi>id
hacker+N+Der/heapmi+A+Pl+Gen	hackerhemiid	hˈɑts.ker»hˌe.mi>id
hacker+N+Der/heapmi+A+Pl+Ill	hackerhemiide	hˈɑts.ker»hˌe.mi>i.de
hacker+N+Der/heapmi+A+Pl+Loc	hackerhemiin	hˈɑts.ker»hˌe.mi>in
hacker+N+Der/heapmi+A+Sg+Com	hackerhemiin	hˈɑts.ker»hˌe.mi>in
hacker+N+Der/heapmi+A+Attr	hackerhis	hˈɑts.ker»his>
hacker+N+Der/heapmi+A+Attr+Der/vuohta+N+Sg+Ill	hackerhisvuhtii	hˈɑts.ker»his>»vˌuh.tij
hacker+N+Der/heapmi+A+Attr+Der/vuohta+N+Ess+PxDu1	hackerhisvuohtaneame	hˈɑts.ker»his>»vˌuoh.tɑ.nˌĕæ.me
hacker+N+Der/heapmi+A+Attr+Der/vuohta+N+Der/viđá+Adv	hackerhisvuohtaviđá	hˈɑts.ker»his>»vˌuoh.tɑ»vˌi.ðɑː
hacker+N+Der/heapmi+A+Attr+Der/vuohta+N+Pl+Gen+PxPl3	hackerhisvuođaideaset	hˈɑts.ker»his>»vˌuo.ðɑj.dˌĕæ.seh
hacker+N+Der/heapmi+A+Attr+Der/vuohta+N+Sg+Acc+PxDu2	hackerhisvuođade	hˈɑts.ker»his>»vˌuo.ðɑ.de
hacker+N+Der/heapmi+A+Attr+Der/vuohta+N+Sg+Acc	hackerhisvuođa	hˈɑts.ker»his>»vˌuo.ðɑ
hacker+N+Der/heapmi+A+Attr+Der/vuohta+N+Sg+Loc	hackerhisvuođas	hˈɑts.ker»his>»vˌuo.ðɑs
hacker+N+Der/heapmi+A+Attr+Der/vuohta+N+Sg+Loc+PxDu2	hackerhisvuođasteatte	hˈɑts.ker»his>»vˌuo.ðɑs.tˌĕæt.te
hacker+N+Der/heapmi+A+Attr+Der/vuohta+N+Sg+Loc+PxPl2	hackerhisvuođasteattet	hˈɑts.ker»his>»vˌuo.ðɑs.tˌĕæt.teh
hacker+N+Der/laš+A+Comp+Attr	hackerlaččat	hˈɑts.ker»lˌɑt.tʃɑt>
hacker+N+Der/laš+A+Comp+Ess	hackerlaččabun	hˈɑts.ker»lˌɑt.tʃɑ.bun
hacker+N+Der/laš+A+Comp+Pl+Com	hackerlaččabuiguin	hˈɑts.ker»lˌɑt.tʃɑ.bˌuj.gujn
hacker+N+Der/laš+A+Comp+Pl+Nom	hackerlaččabut	hˈɑts.ker»lˌɑt.tʃɑ.buh
hacker+N+Der/laš+A+Comp+Der/at+Adv	hackerlaččabut	hˈɑts.ker»lˌɑt.tʃɑ.buh
hacker+N+Der/laš+A+Ess	hackerlažžan	hˈɑts.ker»lˌɑdː.tʃɑn
hacker+N+Der/laš+A+Superl+Attr	hackerlaččamus	hˈɑts.ker»lˌɑt.tʃɑ.mus>
hacker+N+Der/laš+A+Superl+Sg+Nom	hackerlaččamus	hˈɑts.ker»lˌɑt.tʃɑ.mus>
hacker+N+Der/laš+A+Superl+Der/at+Adv	hackerlaččamusat	hˈɑts.ker»lˌɑt.tʃɑ.mˌu.sɑ>h
hacker+N+Der/laš+A+Superl+Sg+Gen	hackerlaččamusa	hˈɑts.ker»lˌɑt.tʃɑ.mˌu.sɑ>
hacker+N+Der/laš+A+Superl+Ess	hackerlaččamussan	hˈɑts.ker»lˌɑt.tʃɑ.mˌus.sɑ>n
hacker+N+Der/laš+A+Comp+Sg+Nom	hackerleabbo	hˈɑts.ker»l>ĕæbː.po
hacker+N+Der/laš+A+Comp+Sg+Nom	hackerlit	hˈɑts.ker»l>ih
hacker+N+Der/laš+A+Superl+Attr	hackerlamos	hˈɑts.ker»l>ɑ.mos
hacker+N+Der/laš+A+Superl+Der/at+Adv	hackerlepmosit	hˈɑts.ker»l>ep.mo.sih
hacker+N+Der/laš+A+Pl+Acc	hackerlaččaid	hˈɑts.ker»lˌɑt.tʃɑjh
hacker+N+Der/laš+A+Sg+Acc	hackerlačča	hˈɑts.ker»lˌɑt.tʃɑ
hacker+N+Der/laš+A+Sg+Loc	hackerlaččas	hˈɑts.ker»lˌɑt.tʃɑs
hacker+N+Der/laš+A+Sg+Ill	hackerlažžii	hˈɑts.ker»lˌɑdː.tʃij
hacker+N+Der/laš+A+Attr+Der/vuohta+N+Sg+Ill	hackerlašvuhtii	hˈɑts.ker»lɑʃ>»vˌuh.tij
hacker+N+Der/laš+A+Attr+Der/vuohta+N+Ess+PxSg1	hackerlašvuohtanan	hˈɑts.ker»lɑʃ>»vˌuoh.tɑ.nɑn
hacker+N+Der/laš+A+AttrCmp+Der/bealat+A+Sg+Nom	hackerlašbealat	hˈɑts.ker»lɑʃ>»bˌeæ.lɑh
hacker+N+Der/laš+A+AttrCmp+Der/geažat+A+Pl+Nom	hackerlašgeažagat	hˈɑts.ker»lɑʃ>»gˌeæ.dʃɑ.gɑh
hacker+N+Der/laš+A+AttrCmp+Der/heakkat+A+Pl+Nom	hackerlašheakkagat	hˈɑts.ker»lɑʃ>»hˌeæk.kɑ.gɑh
hacker+N+Der/laš+A+AttrCmp+Der/heakkat+A+Sg+Acc	hackerlašheakkaga	hˈɑts.ker»lɑʃ>»hˌeæk.kɑ.gɑ
hacker+N+Der/laš+A+AttrCmp+Der/kultuvrrat+A+Sg+Nom	hackerlaškultuvrrat	hˈɑts.ker»lɑʃ>»kˌul.htuvr.rɑh
hacker+N+Der/laš+A+AttrCmp+Der/linjjat+A+Ess	hackerlašlinjjagin	hˈɑts.ker»lɑʃ>»lˌiɲ.jɑ.gin
hacker+N+Der/laš+A+AttrCmp+Der/pláhtat+A+Der/vuohta+N+Sg+Com+PxDu2	hackerlašpláhtatvuođaineatte	hˈɑts.ker»lɑʃ>»plˌɑːh.tɑh»vˌuo.ðɑj.nˌĕæt.te
hacker+N+Der/laš+A+AttrCmp+Der/rávnnjat+A+Pl+Nom	hackerlašrávnnjagat	hˈɑts.ker»lɑʃ>»rˌɑːvn.ɲɑ.gɑh
hacker+N+Der/laš+A+AttrCmp+Der/uvssat+A+Pl+Nom	hackerlašuvssagat	hˈɑts.ker»lɑʃ>»ˌuvs.sɑ.gɑh
hacker+N+Der/laš+A+AttrCmp+Der/uvssat+A+Sg+Nom	hackerlašuvssat	hˈɑts.ker»lɑʃ>»ˌuvs.sɑh
hacker+N+Der/laš+A+Sg+Nom	hackerlaš	hˈɑts.ker»lɑʃ>
hacker+N+Der/laš+A+Der/vuohta+N+Sg+Ill	hackerlašvuhtii	hˈɑts.ker»lɑʃ»vˌuh.ti>i
hacker+N+Der/laš+A+Der/vuohta+N+Sg+Nom+PxDu3	hackerlašvuohtaska	hˈɑts.ker»lɑʃ»vˌuoh.tɑ>skɑ
hacker+N+Der/laš+A+Der/vuohta+N+Sg+Nom+PxSg3	hackerlašvuohtas	hˈɑts.ker»lɑʃ»vˌuoh.tɑ>s
hacker+N+Der/laš+A+Der/vuohta+N+Pl+Nom	hackerlašvuođat	hˈɑts.ker»lɑʃ»vˌuo.ðɑ>h
hacker+N+Der/laš+A+Der/vuohta+N+Sg+Com+PxPl1	hackerlašvuođaineamet	hˈɑts.ker»lɑʃ»vˌuo.ðɑ>i.nĕæ.meh
hacker+N+Der/laš+A+Der/vuohta+N+Sg+Com+PxSg1	hackerlašvuođainan	hˈɑts.ker»lɑʃ»vˌuo.ðɑ>i.nɑn
hacker+N+Der/laš+A+Der/vuohta+N+Sg+Loc	hackerlašvuođas	hˈɑts.ker»lɑʃ»vˌuo.ðɑ>s
hacker+N+Der/viđá+Adv	hackerviđá	hˈɑts.ker»vˌi.ðɑː
hattrick+N+Sg+Nom	hattrick	hˈɑh#tritsk>
hattrick+N+Ess+PxDu1	hattrickaneame	hˈɑh#trˌits.kɑ>nĕæ.me
hattrick+N+Ess+PxDu2	hattrickaneatte	hˈɑh#trˌits.kɑ>nĕæt.te
hattrick+N+Ess+PxDu3	hattrickaneaskka	hˈɑh#trˌits.kɑ>neæs.kɑ
hattrick+N+Ess+PxPl1	hattrickaneamet	hˈɑh#trˌits.kɑ>nĕæ.meh
hattrick+N+Ess+PxPl2	hattrickaneattet	hˈɑh#trˌits.kɑ>nĕæt.teh
hattrick+N+Ess+PxPl3	hattrickaneaset	hˈɑh#trˌits.kɑ>nĕæ.seh
hattrick+N+Ess+PxSg2	hattrickanat	hˈɑh#trˌits.kɑ>nɑh
hattrick+N+Ess+PxSg3	hattrickanis	hˈɑh#trˌits.kɑ>nis
hattrick+N+Ess	hattrickan	hˈɑh#trˌits.kɑ>n
hattrick+N+Pl+Acc+PxPl1	hattrickaideamet	hˈɑh#trˌits.kɑ>i.dĕæ.meh
hattrick+N+Pl+Acc+PxPl2	hattrickaideattet	hˈɑh#trˌits.kɑ>i.dĕæt.teh
hattrick+N+Pl+Acc+PxSg1	hattrickaidan	hˈɑh#trˌits.kɑ>i.dɑn
hattrick+N+Pl+Acc+PxSg2	hattrickaidat	hˈɑh#trˌits.kɑ>i.dɑh
hattrick+N+Pl+Com+PxPl1	hattrickaideametguin	hˈɑh#trˌits.kɑ>i.dĕæ.met.gujn
hattrick+N+Pl+Com+PxPl3	hattrickaideasetguin	hˈɑh#trˌits.kɑ>i.dĕæ.set.gujn
hattrick+N+Pl+Com+PxSg1	hattrickaidanguin	hˈɑh#trˌits.kɑ>i.dɑn.gujn
hattrick+N+Pl+Com	hattrickaiguin	hˈɑh#trˌits.kɑ>i.gujn
hattrick+N+Pl+Gen+PxDu1	hattrickaideame	hˈɑh#trˌits.kɑ>i.dĕæ.me
hattrick+N+Pl+Gen+PxDu2	hattrickaideatte	hˈɑh#trˌits.kɑ>i.dĕæt.te
hattrick+N+Pl+Gen+PxDu3	hattrickaideaskka	hˈɑh#trˌits.kɑ>i.deæs.kɑ
hattrick+N+Pl+Gen+PxPl1	hattrickaideamet	hˈɑh#trˌits.kɑ>i.dĕæ.meh
hattrick+N+Pl+Gen+PxPl3	hattrickaideaset	hˈɑh#trˌits.kɑ>i.dĕæ.seh
hattrick+N+Pl+Gen+PxSg2	hattrickaidat	hˈɑh#trˌits.kɑ>i.dɑh
hattrick+N+Pl+Gen+PxSg3	hattrickaidis	hˈɑh#trˌits.kɑ>i.dis
hattrick+N+Pl+Ill+PxPl1	hattrickaidaseamet	hˈɑh#trˌits.kɑ>i.dɑ.sĕæ.meh
hattrick+N+Pl+Ill	hattrickaide	hˈɑh#trˌits.kɑ>i.de
hattrick+N+Pl+Loc+PxPl3	hattrickaineaset	hˈɑh#trˌits.kɑ>i.nĕæ.seh
hattrick+N+Pl+Loc+PxSg1	hattrickainan	hˈɑh#trˌits.kɑ>i.nɑn
hattrick+N+Pl+Nom+PxDu1	hattrickaideame	hˈɑh#trˌits.kɑ>i.dĕæ.me
hattrick+N+Pl+Nom+PxPl1	hattrickaideamet	hˈɑh#trˌits.kɑ>i.dĕæ.meh
hattrick+N+Pl+Nom	hattrickat	hˈɑh#trˌits.kɑ>h
hattrick+N+Sg+Acc+PxDu1	hattrickame	hˈɑh#trˌits.kɑ>me
hattrick+N+Sg+Acc+PxDu2	hattrickade	hˈɑh#trˌits.kɑ>de
hattrick+N+Sg+Acc+PxDu3	hattrickaska	hˈɑh#trˌits.kɑ>skɑ
hattrick+N+Sg+Acc+PxPl1	hattrickamet	hˈɑh#trˌits.kɑ>meh
hattrick+N+Sg+Acc+PxPl2	hattrickadet	hˈɑh#trˌits.kɑ>deh
hattrick+N+Sg+Acc+PxSg1	hattrickan	hˈɑh#trˌits.kɑ>n
hattrick+N+Sg+Acc	hattricka	hˈɑh#trˌits.kɑ>
hattrick+N+Sg+Com+PxPl3	hattrickaineaset	hˈɑh#trˌits.kɑ>i.nĕæ.seh
hattrick+N+Sg+Com+PxSg2	hattrickainat	hˈɑh#trˌits.kɑ>i.nɑh
hattrick+N+Sg+Com+PxSg3	hattrickainis	hˈɑh#trˌits.kɑ>i.nis
hattrick+N+Sg+Gen+PxPl2	hattrickadet	hˈɑh#trˌits.kɑ>deh
hattrick+N+Sg+Gen+PxPl3	hattrickaset	hˈɑh#trˌits.kɑ>seh
hattrick+N+Sg+Gen+PxSg1	hattrickan	hˈɑh#trˌits.kɑ>n
hattrick+N+Sg+Gen+PxSg3	hattrickas	hˈɑh#trˌits.kɑ>s
hattrick+N+Sg+Ill+PxDu2	hattrickasatte	hˈɑh#trˌits.kɑ>sɑt.te
hattrick+N+Sg+Ill+PxPl1	hattrickasamet	hˈɑh#trˌits.kɑ>sɑ.meh
hattrick+N+Sg+Ill+PxPl3	hattrickasaset	hˈɑh#trˌits.kɑ>sɑ.seh
hattrick+N+Sg+Ill+PxSg2	hattrickasat	hˈɑh#trˌits.kɑ>sɑh
hattrick+N+Sg+Loc	hattrickas	hˈɑh#trˌits.kɑ>s
hattrick+N+Sg+Loc+PxPl1	hattrickasteamet	hˈɑh#trˌits.kɑ>stĕæ.meh
hattrick+N+Sg+Loc+PxSg2	hattrickastat	hˈɑh#trˌits.kɑ>stɑh
hattrick+N+Sg+Loc+PxSg3	hattrickastis	hˈɑh#trˌits.kɑ>stis
hattrick+N+Sg+Nom+PxDu1	hattrickame	hˈɑh#trˌits.kɑ>me
hattrick+N+Sg+Nom+PxDu2	hattrickade	hˈɑh#trˌits.kɑ>de
hattrick+N+Sg+Nom+PxPl1	hattrickamet	hˈɑh#trˌits.kɑ>meh
hattrick+N+Sg+Nom+PxPl2	hattrickadet	hˈɑh#trˌits.kɑ>deh
hattrick+N+Sg+Nom+PxSg1	hattrickan	hˈɑh#trˌits.kɑ>n
hattrick+N+Sg+Nom+PxSg2	hattrickat	hˈɑh#trˌits.kɑ>h
hattrick+N+Der/Dimin+N+Sg+Nom	hattrickaš	hˈɑh#trˌits.kɑ>»ʃ
hattrick+N+Der/Dimin+N+Der/viđá+Adv	hattrickašviđá	hˈɑh#trˌits.kɑ>»ʃ»vˌi.ðɑː
hattrick+N+Der/Dimin+N+Ess	hattrickažin	hˈɑh#trˌits.kɑ>»žin
hattrick+N+Der/Dimin+N+Sg+Acc+PxSg1	hattrickažan	hˈɑh#trˌits.kɑ>»žɑn
hattrick+N+Der/Dimin+N+Der/Dimin+N+Pl+Gen	hattrickažaččaid	hˈɑh#trˌits.kɑ>»žˌɑt.tʃɑjh
hattrick+N+Der/Dimin+N+Der/Dimin+N+Sg+Nom	hattrickažaš	hˈɑh#trˌits.kɑ>»žɑʃ
hattrick+N+Der/Dimin+N+Sg+Ill	hattrickažii	hˈɑh#trˌits.kɑ>»žij
hattrick+N+Der/heapmi+A+Comp+Sg+Ill	hattrickahebbui	hˈɑh#trˌits.kɑ>»hˌebː.puj
hattrick+N+Der/heapmi+A+Superl+Sg+Nom	hattrickaheamos	hˈɑh#trˌits.kɑ>»hˌĕæ.mos
hattrick+N+Der/heapmi+A+Sg+Nom	hattrickaheapme	hˈɑh#trˌits.kɑ>»hˌĕæp.me
hattrick+N+Der/heapmi+A+Sg+Com	hattrickahemiin	hˈɑh#trˌits.kɑ>»hˌe.mijn
hattrick+N+Der/heapmi+A+Attr	hattrickahis	hˈɑh#trˌits.kɑ>»his
hattrick+N+Der/heapmi+A+Attr+Der/vuohta+N+Ess+PxPl3	hattrickahisvuohtaneaset	hˈɑh#trˌits.kɑ>»his»vˌuoh.tɑ.nˌĕæ.seh
hattrick+N+Der/huhtti+V+TV+Ger	hattrickahuhtediin	hˈɑh#trˌits.kɑ>»hˌuh.te.dijn
hattrick+N+Der/huhtti+V+TV+Imprt+ConNeg	hattrickahuhte	hˈɑh#trˌits.kɑ>»hˌuh.te
hattrick+N+Der/huhtti+V+TV+Ind+Prs+ConNeg	hattrickahuhte	hˈɑh#trˌits.kɑ>»hˌuh.te
hattrick+N+Der/huhtti+V+TV+VAbess+A+Attr	hattrickahuhtekeahtes	hˈɑh#trˌits.kɑ>»hˌuh.te.kˌĕæh.tes
hattrick+N+Der/huhtti+V+TV+VAbess	hattrickahuhtekeahttá	hˈɑh#trˌits.kɑ>»hˌuh.te.kˌĕæhː.tɑː
hattrick+N+Der/huhtti+V+TV+Ind+Prt+Du1	hattrickahuhtiime	hˈɑh#trˌits.kɑ>»hˌuh.tij.me
hattrick+N+Der/huhtti+V+TV+VAbess	hattrickahuhtikeahttájin	hˈɑh#trˌits.kɑ>»hˌuh.ti.kˌĕæhː.tɑː.jin
hattrick+N+Der/huhtti+V+TV+Imprt+Pl2	hattrickahuhttet	hˈɑh#trˌits.kɑ>»hˌuhː.teh
hattrick+N+Der/huhtti+V+TV+Imprt+Du2	hattrickahuhtti	hˈɑh#trˌits.kɑ>»hˌuhː.ti
hattrick+N+Der/huhtti+V+TV+Der/PassL+V+IV+Actio+Loc	hattrickahuhttojuvvomis	hˈɑh#trˌits.kɑ>»hˌuhː.to.jˌuv.vo.mis
hattrick+N+Der/huhtti+V+TV+Ind+Prs+Sg2	hattrickahuhtát	hˈɑh#trˌits.kɑ>»hˌuhː.tɑːh
hattrick+N+Der/huvva+V+IV+Cond+Prs+Sg2	hattrickahuvašedjet	hˈɑh#trˌits.kɑ>»hˌu.vɑ.ʃˌec.ceh
hattrick+N+Der/huvva+V+IV+Ger+PxPl3	hattrickahuvadettiineaset	hˈɑh#trˌits.kɑ>»hˌu.vɑ.dˌet.tij.nˌĕæ.seh
hattrick+N+Der/huvva+V+IV+Ind+Prs+ConNeg	hattrickahuva	hˈɑh#trˌits.kɑ>»hˌu.vɑ
hattrick+N+Der/huvva+V+IV+Der/NomAct+N+Sg+Nom	hattrickahuvvan	hˈɑh#trˌits.kɑ>»hˌuv.vɑ»n
hattrick+N+Der/huvva+V+IV+Imprt+Du2	hattrickahuvvi	hˈɑh#trˌits.kɑ>»hˌuvː.vi
hattrick+N+Der/huvva+V+IV+Imprt+Pl1	hattrickahuvvut	hˈɑh#trˌits.kɑ>»hˌuvː.vuh
hattrick+N+Sg+Ill	hattrickii	hˈɑh#trˌits.ki>i
pickup+N+Sg+Nom	pickup	phˈitsk.up>
pickup+N+Ess+PxDu1	pickupaneame	phˈitsk.u.pɑ>nĕæ.me
pickup+N+Ess+PxDu2	pickupaneatte	phˈitsk.u.pɑ>nĕæt.te
pickup+N+Ess+PxDu3	pickupaneaskka	phˈitsk.u.pɑ>neæs.kɑ
pickup+N+Ess+PxPl1	pickupaneamet	phˈitsk.u.pɑ>nĕæ.meh
pickup+N+Ess+PxPl2	pickupaneattet	phˈitsk.u.pɑ>nĕæt.teh
pickup+N+Ess+PxPl3	pickupaneaset	phˈitsk.u.pɑ>nĕæ.seh
pickup+N+Ess+PxSg1	pickupanan	phˈitsk.u.pɑ>nɑn
pickup+N+Ess+PxSg2	pickupanat	phˈitsk.u.pɑ>nɑh
pickup+N+Ess+PxSg3	pickupanis	phˈitsk.u.pɑ>nis
pickup+N+Ess	pickupan	phˈitsk.u.pɑ>n
pickup+N+Pl+Acc+PxDu2	pickupaideatte	phˈitsk.u.pɑ>i.dĕæt.te
pickup+N+Pl+Acc+PxDu3	pickupaideaskka	phˈitsk.u.pɑ>i.deæs.kɑ
pickup+N+Pl+Acc+PxPl1	pickupaideamet	phˈitsk.u.pɑ>i.dĕæ.meh
pickup+N+Pl+Acc+PxPl3	pickupaideaset	phˈitsk.u.pɑ>i.dĕæ.seh
pickup+N+Pl+Acc+PxSg1	pickupaidan	phˈitsk.u.pɑ>i.dɑn
pickup+N+Pl+Acc+PxSg2	pickupaidat	phˈitsk.u.pɑ>i.dɑh
pickup+N+Pl+Acc+PxSg3	pickupaidis	phˈitsk.u.pɑ>i.dis
pickup+N+Pl+Acc	pickupaid	phˈitsk.u.pɑ>id
pickup+N+Pl+Com+PxDu1	pickupaideameguin	phˈitsk.u.pɑ>i.dĕæ.me.gujn
pickup+N+Pl+Com+PxDu2	pickupaideatteguin	phˈitsk.u.pɑ>i.dĕæt.te.gujn
pickup+N+Pl+Com+PxDu3	pickupaideaskkaguin	phˈitsk.u.pɑ>i.deæs.kɑ.gujn
pickup+N+Pl+Com+PxPl2	pickupaideattetguin	phˈitsk.u.pɑ>i.dĕæt.tet.gujn
pickup+N+Pl+Com	pickupaiguin	phˈitsk.u.pɑ>i.gujn
pickup+N+Pl+Gen+PxDu1	pickupaideame	phˈitsk.u.pɑ>i.dĕæ.me
pickup+N+Pl+Gen+PxDu2	pickupaideatte	phˈitsk.u.pɑ>i.dĕæt.te
pickup+N+Pl+Gen+PxPl2	pickupaideattet	phˈitsk.u.pɑ>i.dĕæt.teh
pickup+N+Pl+Gen+PxSg1	pickupaidan	phˈitsk.u.pɑ>i.dɑn
pickup+N+Pl+Gen+PxSg2	pickupaidat	phˈitsk.u.pɑ>i.dɑh
pickup+N+Pl+Gen+PxSg3	pickupaidis	phˈitsk.u.pɑ>i.dis
pickup+N+Pl+Gen	pickupaid	phˈitsk.u.pɑ>id
pickup+N+Pl+Ill+PxDu3	pickupaidaseaskka	phˈitsk.u.pɑ>i.dɑ.seæs.kɑ
pickup+N+Pl+Ill+PxPl1	pickupaidaseamet	phˈitsk.u.pɑ>i.dɑ.sĕæ.meh
pickup+N+Pl+Ill+PxPl3	pickupaidaseaset	phˈitsk.u.pɑ>i.dɑ.sĕæ.seh
pickup+N+Pl+Ill+PxSg1	pickupaidasan	phˈitsk.u.pɑ>i.dɑ.sɑn
pickup+N+Pl+Ill+PxSg2	pickupaidasat	phˈitsk.u.pɑ>i.dɑ.sɑh
pickup+N+Pl+Ill	pickupaide	phˈitsk.u.pɑ>i.de
pickup+N+Pl+Loc+PxDu1	pickupaineame	phˈitsk.u.pɑ>i.nĕæ.me
pickup+N+Pl+Loc+PxDu2	pickupaineatte	phˈitsk.u.pɑ>i.nĕæt.te
pickup+N+Pl+Loc+PxDu3	pickupaineaskka	phˈitsk.u.pɑ>i.neæs.kɑ
pickup+N+Pl+Loc+PxPl1	pickupaineamet	phˈitsk.u.pɑ>i.nĕæ.meh
pickup+N+Pl+Loc+PxPl2	pickupaineattet	phˈitsk.u.pɑ>i.nĕæt.teh
pickup+N+Pl+Loc+PxSg2	pickupainat	phˈitsk.u.pɑ>i.nɑh
pickup+N+Pl+Loc+PxSg3	pickupainis	phˈitsk.u.pɑ>i.nis
pickup+N+Pl+Loc	pickupain	phˈitsk.u.pɑ>in
pickup+N+Pl+Nom+PxDu1	pickupaideame	phˈitsk.u.pɑ>i.dĕæ.me
pickup+N+Pl+Nom+PxPl1	pickupaideamet	phˈitsk.u.pɑ>i.dĕæ.meh
pickup+N+Pl+Nom+PxSg1	pickupaidan	phˈitsk.u.pɑ>i.dɑn
pickup+N+Pl+Nom	pickupat	phˈitsk.u.pɑ>h
pickup+N+Sg+Acc+PxDu1	pickupame	phˈitsk.u.pɑ>me
pickup+N+Sg+Acc+PxDu2	pickupade	phˈitsk.u.pɑ>de
pickup+N+Sg+Acc+PxDu3	pickupaska	phˈitsk.u.pɑ>skɑ
pickup+N+Sg+Acc+PxPl2	pickupadet	phˈitsk.u.pɑ>deh
pickup+N+Sg+Acc+PxPl3	pickupaset	phˈitsk.u.pɑ>seh
pickup+N+Sg+Acc+PxSg1	pickupan	phˈitsk.u.pɑ>n
pickup+N+Sg+Acc	pickupa	phˈitsk.u.pɑ>
pickup+N+Sg+Com+PxDu1	pickupaineame	phˈitsk.u.pɑ>i.nĕæ.me
pickup+N+Sg+Com+PxDu2	pickupaineatte	phˈitsk.u.pɑ>i.nĕæt.te
pickup+N+Sg+Com+PxDu3	pickupaineaskka	phˈitsk.u.pɑ>i.neæs.kɑ
pickup+N+Sg+Com+PxPl1	pickupaineamet	phˈitsk.u.pɑ>i.nĕæ.meh
pickup+N+Sg+Com+PxPl2	pickupaineattet	phˈitsk.u.pɑ>i.nĕæt.teh
pickup+N+Sg+Com+PxPl3	pickupaineaset	phˈitsk.u.pɑ>i.nĕæ.seh
pickup+N+Sg+Com+PxSg1	pickupainan	phˈitsk.u.pɑ>i.nɑn
pickup+N+Sg+Com+PxSg3	pickupainis	phˈitsk.u.pɑ>i.nis
pickup+N+Sg+Com	pickupain	phˈitsk.u.pɑ>in
pickup+N+Sg+Gen+PxDu1	pickupame	phˈitsk.u.pɑ>me
pickup+N+Sg+Gen+PxPl1	pickupamet	phˈitsk.u.pɑ>meh
pickup+N+Sg+Gen+PxPl2	pickupadet	phˈitsk.u.pɑ>deh
pickup+N+Sg+Gen+PxSg1	pickupan	phˈitsk.u.pɑ>n
pickup+N+Sg+Gen+PxSg2	pickupat	phˈitsk.u.pɑ>h
pickup+N+Sg+Gen+PxSg3	pickupas	phˈitsk.u.pɑ>s
pickup+N+Sg+Ill+PxDu1	pickupasame	phˈitsk.u.pɑ>sɑ.me
pickup+N+Sg+Ill+PxDu2	pickupasatte	phˈitsk.u.pɑ>sɑt.te
pickup+N+Sg+Ill+PxPl1	pickupasamet	phˈitsk.u.pɑ>sɑ.meh
pickup+N+Sg+Ill+PxPl2	pickupasattet	phˈitsk.u.pɑ>sɑt.teh
pickup+N+Sg+Ill+PxPl3	pickupasaset	phˈitsk.u.pɑ>sɑ.seh
pickup+N+Sg+Ill+PxSg2	pickupasat	phˈitsk.u.pɑ>sɑh
pickup+N+Sg+Ill+PxSg3	pickupasas	phˈitsk.u.pɑ>sɑs
pickup+N+Sg+Loc	pickupas	phˈitsk.u.pɑ>s
pickup+N+Sg+Loc+PxDu3	pickupasteaskka	phˈitsk.u.pɑ>steæs.kɑ
pickup+N+Sg+Loc+PxPl3	pickupasteaset	phˈitsk.u.pɑ>stĕæ.seh
pickup+N+Sg+Loc+PxSg3	pickupastis	phˈitsk.u.pɑ>stis
pickup+N+Sg+Nom+PxDu1	pickupame	phˈitsk.u.pɑ>me
pickup+N+Sg+Nom+PxDu2	pickupade	phˈitsk.u.pɑ>de
pickup+N+Sg+Nom+PxDu3	pickupaska	phˈitsk.u.pɑ>skɑ
pickup+N+Sg+Nom+PxPl1	pickupamet	phˈitsk.u.pɑ>meh
pickup+N+Sg+Nom+PxPl2	pickupadet	phˈitsk.u.pɑ>deh
pickup+N+Sg+Nom+PxPl3	pickupaset	phˈitsk.u.pɑ>seh
pickup+N+Sg+Nom+PxSg2	pickupat	phˈitsk.u.pɑ>h
pickup+N+Sg+Nom+PxSg3	pickupas	phˈitsk.u.pɑ>s
pickup+N+Der/Dimin+N+Sg+Nom	pickupaš	phˈitsk.u.pɑ>»ʃ
pickup+N+Der/Dimin+N+Der/viđá+Adv	pickupašviđá	phˈitsk.u.pɑ>»ʃ»vˌi.ðɑː
pickup+N+Der/Dimin+N+Ess	pickupažin	phˈitsk.u.pɑ>»žin
pickup+N+Der/Dimin+N+Pl+Nom	pickupažat	phˈitsk.u.pɑ>»žɑh
pickup+N+Der/Dimin+N+Sg+Gen+PxSg1	pickupažan	phˈitsk.u.pɑ>»žɑn
pickup+N+Der/Dimin+N+Der/Dimin+N+Sg+Nom	pickupažaš	phˈitsk.u.pɑ>»žɑʃ
pickup+N+Der/Dimin+N+Sg+Com	pickupažiin	phˈitsk.u.pɑ>»žijn
pickup+N+Der/heapmi+A+Comp+Attr	pickupahut	phˈitsk.u.pɑ>»huh
pickup+N+Der/heapmi+A+Comp+Sg+Nom	pickupahut	phˈitsk.u.pɑ>»huh
pickup+N+Der/heapmi+A+Superl+Ess	pickupahamosin	phˈitsk.u.pɑ>»hˌɑ.mo.sin
pickup+N+Der/heapmi+A+Ess	pickupaheapmin	phˈitsk.u.pɑ>»hˌeæp.min
pickup+N+Der/heapmi+A+Sg+Acc	pickupaheame	phˈitsk.u.pɑ>»hˌĕæ.me
pickup+N+Der/heapmi+A+Pl+Nom	pickupaheamit	phˈitsk.u.pɑ>»hˌeæ.mih
pickup+N+Der/heapmi+A+Pl+Acc	pickupahemiid	phˈitsk.u.pɑ>»hˌe.mijh
pickup+N+Der/heapmi+A+Sg+Com	pickupahemiin	phˈitsk.u.pɑ>»hˌe.mijn
pickup+N+Der/heapmi+A+Attr	pickupahis	phˈitsk.u.pɑ>»his
pickup+N+Der/heapmi+A+Attr+Der/vuohta+N+Sg+Ill	pickupahisvuhtii	phˈitsk.u.pɑ>»his»vˌuh.tij
pickup+N+Der/heapmi+A+Attr+Der/vuohta+N+Der/viđá+Adv	pickupahisvuohtaviđá	phˈitsk.u.pɑ>»his»vˌuoh.tɑ»vˌi.ðɑː
pickup+N+Der/heapmi+A+Attr+Der/vuohta+N+Sg+Loc+PxSg1	pickupahisvuođastan	phˈitsk.u.pɑ>»his»vˌuo.ðɑs.tɑn
pickup+N+Der/huhtti+V+TV+Ger	pickupahuhtedettiin	phˈitsk.u.pɑ>»hˌuh.te.dˌet.tijn
pickup+N+Der/huhtti+V+TV+Ger	pickupahuhtedin	phˈitsk.u.pɑ>»hˌuh.te.din
pickup+N+Der/huhtti+V+TV+Ind+Prs+ConNeg	pickupahuhte	phˈitsk.u.pɑ>»hˌuh.te
pickup+N+Der/huhtti+V+TV+Pot+Prs+Pl1	pickupahuhtežat	phˈitsk.u.pɑ>»hˌuh.te.dʃɑh
pickup+N+Der/huhtti+V+TV+VAbess	pickupahuhtihaga	phˈitsk.u.pɑ>»hˌuh.ti.hˌɑ.gɑ
pickup+N+Der/huhtti+V+TV+VAbess+A+Attr	pickupahuhtikeahtes	phˈitsk.u.pɑ>»hˌuh.ti.kˌĕæh.tes
pickup+N+Der/huhtti+V+TV+Imprt+Pl2	pickupahuhttet	phˈitsk.u.pɑ>»hˌuhː.teh
pickup+N+Der/huhtti+V+TV+Ind+Prs+Pl3	pickupahuhttet	phˈitsk.u.pɑ>»hˌuhː.teh
pickup+N+Der/huhtti+V+TV+Inf	pickupahuhttit	phˈitsk.u.pɑ>»hˌuhː.tih
pickup+N+Der/huhtti+V+TV+Der/PassS+V+IV+Ind+Prt+Sg3	pickupahuhttui	phˈitsk.u.pɑ>»hˌuhː.tu»i
pickup+N+Der/huhtti+V+TV+Cond+Prs+ConNeg	pickupahuhtále	phˈitsk.u.pɑ>»hˌuhː.tɑː.le
pickup+N+Der/huhtti+V+TV+Ind+Prs+Sg1	pickupahuhtán	phˈitsk.u.pɑ>»hˌuhː.tɑːn
pickup+N+Der/huhtti+V+TV+Ind+Prs+Sg2	pickupahuhtát	phˈitsk.u.pɑ>»hˌuhː.tɑːh
pickup+N+Der/huhtti+V+TV+Sup	pickupahuhtážit	phˈitsk.u.pɑ>»hˌuhː.tɑː.dʃih
pickup+N+Der/huvva+V+IV+Cond+Prs+Sg2	pickupahuvašedjet	phˈitsk.u.pɑ>»hˌu.vɑ.ʃˌec.ceh
pickup+N+Der/huvva+V+IV+Cond+Prs+Sg2	pickupahuvašit	phˈitsk.u.pɑ>»hˌu.vɑ.ʃih
pickup+N+Der/huvva+V+IV+Ger	pickupahuvadiin	phˈitsk.u.pɑ>»hˌu.vɑ.dijn
pickup+N+Der/huvva+V+IV+Imprt+Sg2	pickupahuva	phˈitsk.u.pɑ>»hˌu.vɑ
pickup+N+Der/huvva+V+IV+Pot+Prs+ConNeg	pickupahuvaš	phˈitsk.u.pɑ>»hˌu.vɑʃ
pickup+N+Der/huvva+V+IV+Pot+Prs+Pl3	pickupahuvažit	phˈitsk.u.pɑ>»hˌu.vɑ.dʃih
pickup+N+Der/huvva+V+IV+VAbess	pickupahuvahaga	phˈitsk.u.pɑ>»hˌu.vɑ.hˌɑ.gɑ
pickup+N+Der/huvva+V+IV+VAbess	pickupahuvakeahttájin	phˈitsk.u.pɑ>»hˌu.vɑ.kˌĕæhː.tɑː.jin
pickup+N+Der/huvva+V+IV+VGen	pickupahuva	phˈitsk.u.pɑ>»hˌu.vɑ
pickup+N+Der/huvva+V+IV+Actio+Ess	pickupahuvvame	phˈitsk.u.pɑ>»hˌuv.vɑ.me
pickup+N+Der/huvva+V+IV+Ind+Prt+Pl3	pickupahuvve	phˈitsk.u.pɑ>»hˌuv.ve
pickup+N+Der/huvva+V+IV+Ind+Prt+Sg2	pickupahuvvet	phˈitsk.u.pɑ>»hˌuv.veh
pickup+N+Der/huvva+V+IV+ConNegII	pickupahuvvo	phˈitsk.u.pɑ>»hˌuv.vo
pickup+N+Der/huvva+V+IV+Imprt+ConNegII	pickupahuvvo	phˈitsk.u.pɑ>»hˌuv.vo
pickup+N+Der/huvva+V+IV+Imprt+Pl3	pickupahuvvoset	phˈitsk.u.pɑ>»hˌuv.vo.seh
pickup+N+Der/huvva+V+IV+Imprt+Pl1	pickupahuvvut	phˈitsk.u.pɑ>»hˌuvː.vuh
pickup+N+Der/huvva+V+IV+Ind+Prs+Sg3	pickupahuvvá	phˈitsk.u.pɑ>»hˌuvː.vɑː
pickup+N+Sg+Ill	pickupii	phˈitsk.u.pi>i
