Aaltonen+N+Prop+Sem/Sur+Ess	Aaltosin	ˈɑːlː.l̥to>.sin
Aaltonen+N+Prop+Sem/Sur+Pl+Com	Aaltosiiguin	ˈɑːlː.l̥to>.sij.gujn
Aaltonen+N+Prop+Sem/Sur+Sg+Gen	Aaltosa	ˈɑːlː.l̥to>.sɑ
Aaltonen+N+Prop+Sem/Sur+Ess	Aaltonenin	ˈɑːlː.l̥to.ne.n>in
Aaltonen+N+Prop+Sem/Sur+Sg+Gen	Aaltonena	ˈɑːlː.l̥to.ne.n>ɑ
Aaltonen+N+Prop+Sem/Sur+Sg+Ill	Aaltonenii	ˈɑːlː.l̥to.ne.n>ij
Ahokainen+N+Prop+Sem/Sur+Sg+Ill	Ahokaisii	ˈɑ.ho.kɑj>.sij
Aholainen+N+Prop+Sem/Sur+Sg+Acc	Aholainen	ˈɑ.ho.lˌɑj.nen>
Ahonen+N+Prop+Sem/Sur+Pl+Gen	Ahosiid	ˈɑ.ho>.sijh
Ahponen+N+Prop+Sem/Sur+Sg+Acc	Ahponena	ˈɑh.po.ne.n>ɑ
Ahvonen+N+Prop+Sem/Sur+Pl+Gen	Ahvoneniid	ˈɑh.vo.ne.n>ijh
Ainovarppanen+N+Prop+Der/laš+A+Ess+PxDu3	Ainovarppanenlažžaneaskka	ˈɑj.no.vˌɑrr̥.pɑ.nˌen.lɑdː.tʃɑ.neæs.kɑ
Airaksinen+N+Prop+Sem/Sur+Pl+Nom	Airaksisat	ˈɑjː.rɑːkː.si>.sɑh
Airaksinen+N+Prop+Sem/Sur+Sg+Gen	Airaksisa	ˈɑjː.rɑːkː.si>.sɑ
Airaksinen+N+Prop+Sem/Sur+Sg+Loc	Airaksisis	ˈɑjː.rɑːkː.si>.sis
Airaksinen+N+Prop+Sem/Sur+Pl+Nom	Airaksinenat	ˈɑjː.rɑːkː.sˌi.ne.n>ɑh
Akkanen+N+Prop+Sem/Sur+Ess	Akkasin	ˈɑkː.kɑː>.sin
Akkanen+N+Prop+Sem/Sur+Pl+Nom	Akkasat	ˈɑkː.kɑː>.sɑh
Akkanen+N+Prop+Sem/Sur+Pl+Com	Akkasiiguin	ˈɑkː.kɑː>.sij.gujn
Akkanen+N+Prop+Sem/Sur+Sg+Gen	Akkasa	ˈɑkː.kɑː>.sɑ
Akkanen+N+Prop+Sem/Sur+Ess	Akkanenin	ˈɑkː.kɑː.ne.n>in
Akkanen+N+Prop+Sem/Sur+Pl+Com	Akkaneniiguin	ˈɑkː.kɑː.ne.n>ij.gujn
Akkanen+N+Prop+Sem/Sur+Pl+Loc	Akkaneniin	ˈɑkː.kɑː.ne.n>ijn
Akkanen+N+Prop+Sem/Sur+Sg+Acc	Akkanen	ˈɑkː.kɑː.nen>
Akkanen+N+Prop+Sem/Sur+Sg+Gen+Allegro	Akkanen	ˈɑkː.kɑː.nen>
Akkanen+N+Prop+Sem/Sur+Sg+Gen	Akkanena	ˈɑkː.kɑː.ne.n>ɑ
Akkanen+N+Prop+Sem/Sur+Sg+Com	Akkaneniin	ˈɑkː.kɑː.ne.n>ijn
Alaluusua+N+Prop+Sg+Loc	Alaluusuas	ˈɑ.lɑː.lˌu.u.sˌu.ɑ>s
Alhonen+N+Prop+Sem/Sur+Ess	Alhosin	ˈɑlə.ho>.sin
Alhonen+N+Prop+Sem/Sur+Pl+Nom	Alhosat	ˈɑlə.ho>.sɑh
Alhonen+N+Prop+Sem/Sur+Ess	Alhonenin	ˈɑlə.ho.ne.n>in
Alinen+N+Prop+Sem/Sur+Sg+Acc	Alinena	ˈɑ.li.ne.n>ɑ
Alonen+N+Prop+Sem/Sur+Pl+Nom	Alosat	ˈɑ.lo>.sɑh
Alonen+N+Prop+Sem/Sur+Pl+Ill	Alosiidda	ˈɑ.lo>.sijt.tɑ
Annunen+N+Prop+Sem/Sur+Sg+Gen	Annusa	ˈɑn.nu>.sɑ
Annunen+N+Prop+Sem/Sur+Sg+Ill	Annunenii	ˈɑn.nu.ne.n>ij
Anttinen+N+Prop+Sem/Sur+Ess	Anttisin	ˈɑnn̥.ti>.sin
Anttolainen+N+Prop+Sem/Sur+Sg+Com	Anttolaisiin	ˈɑnn̥.to.lɑj>.sijn
Arminen+N+Prop+Sem/Sur+Sg+Acc	Armisa	ˈɑr.mi>.sɑ
Aronen+N+Prop+Sem/Sur+Sg+Ill	Arosii	ˈɑ.ro>.sij
Aronen+N+Prop+Sem/Sur+Pl+Nom	Aronenat	ˈɑ.ro.ne.n>ɑh
Aronen+N+Prop+Sem/Sur+Sg+Gen	Aronena	ˈɑ.ro.ne.n>ɑ
Arpiainen+N+Prop+Sem/Sur+Sg+Gen	Arpiainena	ˈɑrə.hpi.ˌɑj.ne.n>ɑ
Arponen+N+Prop+Sem/Sur+Sg+Acc	Arposa	ˈɑrə.hpo>.sɑ
Arponen+N+Prop+Sem/Sur+Sg+Nom	Arponen	ˈɑrə.hpo.nen>
Arponen+N+Prop+Sem/Sur+Sg+Acc	Arponena	ˈɑrə.hpo.ne.n>ɑ
Arponen+N+Prop+Sem/Sur+Sg+Com	Arponeniin	ˈɑrə.hpo.ne.n>ijn
Arvinen+N+Prop+Sem/Sur+Sg+Gen	Arvisa	ˈɑrə.vi>.sɑ
Asikainen+N+Prop+Sem/Sur+Sg+Loc	Asikaisis	ˈɑ.si.kɑj>.sis
Asikainen+N+Prop+Sem/Sur+Ess	Asikainenin	ˈɑ.si.kˌɑj.ne.n>in
Asikainen+N+Prop+Sem/Sur+Sg+Acc	Asikainena	ˈɑ.si.kˌɑj.ne.n>ɑ
Astikainen+N+Prop+Sem/Sur+Pl+Loc	Astikaisiin	ˈɑsː.ti.kɑj>.sijn
Astikainen+N+Prop+Sem/Sur+Sg+Loc	Astikaisis	ˈɑsː.ti.kɑj>.sis
Astikainen+N+Prop+Sem/Sur+Sg+Gen	Astikainena	ˈɑsː.ti.kˌɑj.ne.n>ɑ
Auranen+N+Prop+Sem/Sur+Pl+Nom	Aurasat	ˈɑu.rɑ>.sɑh
Auvinen+N+Prop+Sem/Sur+Pl+Nom	Auvisat	ˈɑu.vi>.sɑh
Auvinen+N+Prop+Sem/Sur+Pl+Loc	Auvisiin	ˈɑu.vi>.sijn
Auvinen+N+Prop+Sem/Sur+Sg+Ill	Auvisii	ˈɑu.vi>.sij
Auvinen+N+Prop+Sem/Sur+Pl+Acc	Auvineniid	ˈɑu.vi.ne.n>ijh
Avikainen+N+Prop+Sem/Sur+Ess	Avikaisin	ˈɑ.vi.kɑj>.sin
Avikainen+N+Prop+Sem/Sur+Sg+Gen	Avikaisa	ˈɑ.vi.kɑj>.sɑ
Avikainen+N+Prop+Sem/Sur+Pl+Nom	Avikainenat	ˈɑ.vi.kˌɑj.ne.n>ɑh
Avikainen+N+Prop+Sem/Sur+Sg+Nom	Avikainen	ˈɑ.vi.kˌɑj.nen>
Björninen+N+Prop+Sem/Sur+Ess	Björnisin	bjˈør.ni>.sin
Björninen+N+Prop+Sem/Sur+Pl+Nom	Björnisat	bjˈør.ni>.sɑh
Björninen+N+Prop+Sem/Sur+Pl+Acc	Björnisiid	bjˈør.ni>.sijh
Björninen+N+Prop+Sem/Sur+Pl+Com	Björnisiiguin	bjˈør.ni>.sij.gujn
Björninen+N+Prop+Sem/Sur+Pl+Gen	Björnisiid	bjˈør.ni>.sijh
Björninen+N+Prop+Sem/Sur+Pl+Ill	Björnisiidda	bjˈør.ni>.sijt.tɑ
Björninen+N+Prop+Sem/Sur+Sg+Acc	Björnisa	bjˈør.ni>.sɑ
Björninen+N+Prop+Sem/Sur+Sg+Gen	Björnisa	bjˈør.ni>.sɑ
Björninen+N+Prop+Sem/Sur+Sg+Com	Björnisiin	bjˈør.ni>.sijn
Björninen+N+Prop+Sem/Sur+Sg+Ill	Björnisii	bjˈør.ni>.sij
Björninen+N+Prop+Sem/Sur+Sg+Loc	Björnisis	bjˈør.ni>.sis
Björninen+N+Prop+Sem/Sur+Ess	Björninenin	bjˈør.ni.ne.n>in
Björninen+N+Prop+Sem/Sur+Pl+Nom	Björninenat	bjˈør.ni.ne.n>ɑh
Björninen+N+Prop+Sem/Sur+Pl+Acc	Björnineniid	bjˈør.ni.ne.n>ijh
Björninen+N+Prop+Sem/Sur+Pl+Com	Björnineniiguin	bjˈør.ni.ne.n>ij.gujn
Björninen+N+Prop+Sem/Sur+Pl+Ill	Björnineniidda	bjˈør.ni.ne.n>ijt.tɑ
Björninen+N+Prop+Sem/Sur+Pl+Loc	Björnineniin	bjˈør.ni.ne.n>ijn
Björninen+N+Prop+Sem/Sur+Sg+Gen+Allegro	Björninen	bjˈør.ni.nen>
Björninen+N+Prop+Sem/Sur+Sg+Nom	Björninen	bjˈør.ni.nen>
Björninen+N+Prop+Sem/Sur+Sg+Acc	Björninena	bjˈør.ni.ne.n>ɑ
Björninen+N+Prop+Sem/Sur+Sg+Gen	Björninena	bjˈør.ni.ne.n>ɑ
Björninen+N+Prop+Sem/Sur+Sg+Com	Björnineniin	bjˈør.ni.ne.n>ijn
Björninen+N+Prop+Sem/Sur+Sg+Ill	Björninenii	bjˈør.ni.ne.n>ij
Eerikäinen+N+Prop+Sem/Sur+Sg+Acc	Eerikäisa	ˈeː.ri.kæj>.sɑ
Eerikäinen+N+Prop+Sem/Sur+Sg+Gen	Eerikäisa	ˈeː.ri.kæj>.sɑ
Eerikäinen+N+Prop+Sem/Sur+Sg+Com	Eerikäisiin	ˈeː.ri.kæj>.sijn
Eerikäinen+N+Prop+Sem/Sur+Sg+Loc	Eerikäisis	ˈeː.ri.kæj>.sis
Eerikäinen+N+Prop+Sem/Sur+Ess	Eerikäinenin	ˈeː.ri.kˌæj.ne.n>in
Eerikäinen+N+Prop+Sem/Sur+Pl+Nom	Eerikäinenat	ˈeː.ri.kˌæj.ne.n>ɑh
Eerikäinen+N+Prop+Sem/Sur+Sg+Acc	Eerikäinena	ˈeː.ri.kˌæj.ne.n>ɑ
Eerikäinen+N+Prop+Sem/Sur+Sg+Gen	Eerikäinena	ˈeː.ri.kˌæj.ne.n>ɑ
Eerikäinen+N+Prop+Sem/Sur+Sg+Com	Eerikäineniin	ˈeː.ri.kˌæj.ne.n>ijn
Eerikäinen+N+Prop+Sem/Sur+Sg+Ill	Eerikäinenii	ˈeː.ri.kˌæj.ne.n>ij
Ehrukainen+N+Prop+Sem/Sur+Ess	Ehrukaisin	ˈeh.ru.kɑj>.sin
Ehrukainen+N+Prop+Sem/Sur+Pl+Nom	Ehrukaisat	ˈeh.ru.kɑj>.sɑh
Ehrukainen+N+Prop+Sem/Sur+Pl+Acc	Ehrukaisiid	ˈeh.ru.kɑj>.sijh
Ehrukainen+N+Prop+Sem/Sur+Pl+Com	Ehrukaisiiguin	ˈeh.ru.kɑj>.sij.gujn
Ehrukainen+N+Prop+Sem/Sur+Pl+Ill	Ehrukaisiidda	ˈeh.ru.kɑj>.sijt.tɑ
Ehrukainen+N+Prop+Sem/Sur+Sg+Ill	Ehrukaisii	ˈeh.ru.kɑj>.sij
Ehrukainen+N+Prop+Sem/Sur+Pl+Gen	Ehrukaineniid	ˈeh.ru.kˌɑj.ne.n>ijh
Ekonen+N+Prop+Sem/Sur+Ess	Ekosin	ˈe.ko>.sin
Ekonen+N+Prop+Sem/Sur+Pl+Nom	Ekosat	ˈe.ko>.sɑh
Ekonen+N+Prop+Sem/Sur+Sg+Acc	Ekosa	ˈe.ko>.sɑ
Ekonen+N+Prop+Sem/Sur+Pl+Nom	Ekonenat	ˈe.ko.ne.n>ɑh
Ekonen+N+Prop+Sem/Sur+Sg+Gen+Allegro	Ekonen	ˈe.ko.nen>
Ekonen+N+Prop+Sem/Sur+Sg+Acc	Ekonena	ˈe.ko.ne.n>ɑ
Ellonen+N+Prop+Sem/Sur+Pl+Nom	Ellosat	ˈel.lo>.sɑh
Ellonen+N+Prop+Sem/Sur+Sg+Gen	Ellonena	ˈel.lo.ne.n>ɑ
Elonen+N+Prop+Sem/Sur+Sg+Ill	Elosii	ˈe.lo>.sij
Elonen+N+Prop+Sem/Sur+Pl+Nom	Elonenat	ˈe.lo.ne.n>ɑh
Elonen+N+Prop+Sem/Sur+Pl+Acc	Eloneniid	ˈe.lo.ne.n>ijh
Elonen+N+Prop+Sem/Sur+Pl+Com	Eloneniiguin	ˈe.lo.ne.n>ij.gujn
Elonen+N+Prop+Sem/Sur+Sg+Acc	Elonen	ˈe.lo.nen>
Elonen+N+Prop+Sem/Sur+Sg+Gen+Allegro	Elonen	ˈe.lo.nen>
Elonen+N+Prop+Sem/Sur+Sg+Gen	Elonena	ˈe.lo.ne.n>ɑ
Elonen+N+Prop+Sem/Sur+Sg+Ill	Elonenii	ˈe.lo.ne.n>ij
Eronen+N+Prop+Sem/Sur+Ess	Erosin	ˈe.ro>.sin
Eronen+N+Prop+Sem/Sur+Pl+Nom	Erosat	ˈe.ro>.sɑh
Eronen+N+Prop+Sem/Sur+Ess	Eronenin	ˈe.ro.ne.n>in
Eronen+N+Prop+Sem/Sur+Pl+Com	Eroneniiguin	ˈe.ro.ne.n>ij.gujn
Eronen+N+Prop+Sem/Sur+Pl+Gen	Eroneniid	ˈe.ro.ne.n>ijh
Eränen+N+Prop+Sem/Sur+Pl+Nom	Eräsat	ˈe.ræ>.sɑh
Eränen+N+Prop+Sem/Sur+Sg+Com	Eräsiin	ˈe.ræ>.sijn
Eränen+N+Prop+Sem/Sur+Pl+Nom	Eränenat	ˈe.ræ.ne.n>ɑh
Eränen+N+Prop+Sem/Sur+Pl+Loc	Eräneniin	ˈe.ræ.ne.n>ijn
Eränen+N+Prop+Sem/Sur+Sg+Acc	Eränen	ˈe.ræ.nen>
Eskelinen+N+Prop+Sem/Sur+Sg+Gen	Eskelisa	ˈesː.ke.li>.sɑ
Eskelinen+N+Prop+Sem/Sur+Sg+Ill	Eskelinenii	ˈesː.ke.lˌi.ne.n>ij
Eteläinen+N+Prop+Sem/Sur+Sg+Gen	Eteläisa	ˈe.te.læj>.sɑ
Eteläpää+N+Prop+Ess	Eteläpään	ˈe.te.læ#phˌæ.æ>n
Eteläpää+N+Prop+Sg+Nom	Eteläpää	ˈe.te.læ#phˌæ.æ>
Eteläpää+N+Prop+Sg+Loc	Eteläpääs	ˈe.te.læ#phˌæ.æ>s
Ettanen+N+Prop+Sem/Sur+Pl+Nom	Ettasat	ˈetː.tɑː>.sɑh
Ettanen+N+Prop+Sem/Sur+Sg+Acc	Ettanen	ˈetː.tɑː.nen>
Ettanen+N+Prop+Sem/Sur+Sg+Gen	Ettanena	ˈetː.tɑː.ne.n>ɑ
Ettanen+N+Prop+Sem/Sur+Sg+Com	Ettaneniin	ˈetː.tɑː.ne.n>ijn
Hakkarainen+N+Prop+Sem/Sur+Sg+Acc	Hakkaraisa	hˈɑkː.kɑː.rɑj>.sɑ
Hallikainen+N+Prop+Sem/Sur+Sg+Acc	Hallikainen	hˈɑl.li.kˌɑj.nen>
Halminen+N+Prop+Sem/Sur+Sg+Com	Halmisiin	hˈɑlə.mi>.sijn
Halonen+N+Prop+Sem/Sur+Pl+Ill	Halosiidda	hˈɑ.lo>.sijt.tɑ
Hamunen+N+Prop+Sem/Sur+Pl+Acc	Hamuneniid	hˈɑ.mu.ne.n>ijh
Hanninen+N+Prop+Sem/Sur+Ess	Hanninenin	hˈɑn.ni.ne.n>in
Happonen+N+Prop+Sem/Sur+Sg+Loc	Happosis	hˈɑp.po>.sis
Harjunen+N+Prop+Sem/Sur+Sg+Loc	Harjunenis	hˈɑrə.ju.ne.n>is
Hartonen+N+Prop+Sem/Sur+Ess	Hartosin	hˈɑrə.hto>.sin
Haverinen+N+Prop+Sem/Sur+Pl+Com	Haverineniiguin	hˈɑ.ve.rˌi.ne.n>ij.gujn
Havunen+N+Prop+Sem/Sur+Sg+Gen	Havusa	hˈɑ.vu>.sɑ
Heikkonen+N+Prop+Sem/Sur+Pl+Nom	Heikkosat	hˈejç.ko>.sɑh
Heimonen+N+Prop+Sem/Sur+Sg+Acc	Heimonena	hˈej.mo.ne.n>ɑ
Helanen+N+Prop+Sem/Sur+Pl+Nom	Helanenat	hˈe.lɑː.ne.n>ɑh
Helppolainen+N+Prop+Sem/Sur+Pl+Nom	Helppolainenat	hˈell̥.po.lˌɑj.ne.n>ɑh
Henttunen+N+Prop+Sem/Sur+Sg+Acc	Henttusa	hˈenn̥.tu>.sɑ
Hermunen+N+Prop+Sem/Sur+Sg+Acc	Hermusa	hˈer.mu>.sɑ
Hermunen+N+Prop+Sem/Sur+Sg+Gen	Hermusa	hˈer.mu>.sɑ
Hessulainen+N+Prop+Sem/Sur+Pl+Nom	Hessulaisat	hˈes.su.lɑj>.sɑh
Hessulainen+N+Prop+Sem/Sur+Pl+Com	Hessulaisiiguin	hˈes.su.lɑj>.sij.gujn
Himmanen+N+Prop+Sem/Sur+Sg+Gen	Himmasa	hˈimː.mɑː>.sɑ
Hintsanen+N+Prop+Sem/Sur+Sg+Loc	Hintsasis	hˈint.sɑː>.sis
Hippeläinen+N+Prop+Sem/Sur+Pl+Nom	Hippeläisat	hˈip.pe.læj>.sɑh
Hirvinen+N+Prop+Sem/Sur+Pl+Acc	Hirvisiid	hˈirə.vi>.sijh
Hirvonen+N+Prop+Sem/Sur+Pl+Loc	Hirvoneniin	hˈirə.vo.ne.n>ijn
Holttinen+N+Prop+Sem/Sur+Sg+Ill	Holttisii	hˈoll̥.ti>.sij
Holttinen+N+Prop+Sem/Sur+Pl+Nom	Holttinenat	hˈoll̥.ti.ne.n>ɑh
Homanen+N+Prop+Sem/Sur+Ess	Homanenin	hˈo.mɑː.ne.n>in
Honkanen+N+Prop+Sem/Sur+Pl+Nom	Honkasat	hˈoŋŋ.ŋ̊kɑ>.sɑh
Hoskonen+N+Prop+Sem/Sur+Sg+Acc	Hoskosa	hˈosː.ko>.sɑ
Hottinen+N+Prop+Sem/Sur+Pl+Nom	Hottisat	hˈot.ti>.sɑh
Hovilainen+N+Prop+Sem/Sur+Pl+Ill	Hovilaisiidda	hˈo.vi.lɑj>.sijt.tɑ
Huhdanpää+N+Prop+Sg+Com	Huhdanpääin	hˈuh.dɑːn#phˌæ.æ>in
Huhtilainen+N+Prop+Sem/Sur+Pl+Com	Huhtilaisiiguin	hˈuh.ti.lɑj>.sij.gujn
Huiskonen+N+Prop+Sem/Sur+Pl+Nom	Huiskonenat	hˈujː.sko.ne.n>ɑh
Hukkanen+N+Prop+Sem/Sur+Sg+Ill	Hukkasii	hˈukː.kɑː>.sij
Hukkanen+N+Prop+Sem/Sur+Ess	Hukkanenin	hˈukː.kɑː.ne.n>in
Huopainen+N+Prop+Sem/Sur+Sg+Com	Huopaineniin	hˈuo.pɑj.ne.n>ijn
Huppunen+N+Prop+Sem/Sur+Sg+Loc	Huppunenis	hˈup.pu.ne.n>is
Huuhtanen+N+Prop+Sem/Sur+Ess	Huuhtasin	hˈu.uh.tɑ>.sin
Hynynen+N+Prop+Sem/Sur+Ess	Hynysin	hˈy.ny>.sin
Hynönen+N+Prop+Sem/Sur+Sg+Acc	Hynösa	hˈy.nø>.sɑ
Hyppänen+N+Prop+Sem/Sur+Ess	Hyppänenin	hˈyp.pæ.ne.n>in
Hyppänen+N+Prop+Sem/Sur+Sg+Loc	Hyppänenis	hˈyp.pæ.ne.n>is
Hyppönen+N+Prop+Sem/Sur+Pl+Acc	Hyppösiid	hˈyp.pø>.sijh
Hyppönen+N+Prop+Sem/Sur+Sg+Acc	Hyppönena	hˈyp.pø.ne.n>ɑ
Hyppönen+N+Prop+Sem/Sur+Sg+Gen	Hyppönena	hˈyp.pø.ne.n>ɑ
Hyökki+N+Prop+Sem/Sur+Ess	Hyökkin	hˈy.øk.ki>n
Häkkinen+N+Prop+Sem/Sur+Pl+Nom	Häkkinenat	hˈæk.ki.ne.n>ɑh
Häkkänen+N+Prop+Sem/Sur+Sg+Com	Häkkäsiin	hˈæk.kæ>.sijn
Hälinen+N+Prop+Sem/Sur+Sg+Acc	Hälisa	hˈæ.li>.sɑ
Hälinen+N+Prop+Sem/Sur+Sg+Ill	Hälinenii	hˈæ.li.ne.n>ij
Hännikäinen+N+Prop+Sem/Sur+Pl+Nom	Hännikäinenat	hˈæn.ni.kˌæj.ne.n>ɑh
Hätinen+N+Prop+Sem/Sur+Sg+Ill	Hätisii	hˈæ.ti>.sij
Häyrinen+N+Prop+Sem/Sur+Sg+Gen	Häyrisa	hˈæ.y.ri>.sɑ
Ihalainen+N+Prop+Sem/Sur+Pl+Ill	Ihalaisiidda	ˈi.hɑː.lɑj>.sijt.tɑ
Ihalainen+N+Prop+Sem/Sur+Sg+Gen	Ihalaisa	ˈi.hɑː.lɑj>.sɑ
Ihalainen+N+Prop+Sem/Sur+Ess	Ihalainenin	ˈi.hɑː.lˌɑj.ne.n>in
Ihonen+N+Prop+Sem/Sur+Pl+Nom	Ihosat	ˈi.ho>.sɑh
Ihonen+N+Prop+Sem/Sur+Pl+Gen	Ihoneniid	ˈi.ho.ne.n>ijh
Ihonen+N+Prop+Sem/Sur+Sg+Acc	Ihonen	ˈi.ho.nen>
Ihonen+N+Prop+Sem/Sur+Sg+Ill	Ihonenii	ˈi.ho.ne.n>ij
Iivanainen+N+Prop+Sem/Sur+Pl+Com	Iivanaisiiguin	ˈijː.vɑː.nɑj>.sij.gujn
Iivanainen+N+Prop+Sem/Sur+Pl+Nom	Iivanainenat	ˈijː.vɑː.nˌɑj.ne.n>ɑh
Iivanainen+N+Prop+Sem/Sur+Sg+Loc	Iivanainenis	ˈijː.vɑː.nˌɑj.ne.n>is
Iivarinen+N+Prop+Sem/Sur+Pl+Gen	Iivarisiid	ˈijː.vɑː.ri>.sijh
Iivarinen+N+Prop+Sem/Sur+Sg+Acc	Iivarinen	ˈijː.vɑː.rˌi.nen>
Iivonen+N+Prop+Sem/Sur+Sg+Acc	Iivosa	ˈijː.vo>.sɑ
Iivonen+N+Prop+Sem/Sur+Sg+Acc	Iivonen	ˈijː.vo.nen>
Ikonen+N+Prop+Sem/Sur+Ess	Ikosin	ˈi.ko>.sin
Ikonen+N+Prop+Sem/Sur+Pl+Gen	Ikosiid	ˈi.ko>.sijh
Ikonen+N+Prop+Sem/Sur+Pl+Ill	Ikosiidda	ˈi.ko>.sijt.tɑ
Ikonen+N+Prop+Sem/Sur+Pl+Nom	Ikonenat	ˈi.ko.ne.n>ɑh
Ikäheimonen+N+Prop+Sem/Sur+Pl+Ill	Ikäheimosiidda	ˈi.kæ.hˌej.mo>.sijt.tɑ
Ikäheimonen+N+Prop+Sem/Sur+Sg+Com	Ikäheimoneniin	ˈi.kæ.hˌej.mo.ne.n>ijn
Ikäläinen+N+Prop+Sem/Sur+Pl+Nom	Ikäläisat	ˈi.kæ.læj>.sɑh
Ikäläinen+N+Prop+Sem/Sur+Sg+Ill	Ikäläisii	ˈi.kæ.læj>.sij
Ikäläinen+N+Prop+Sem/Sur+Pl+Nom	Ikäläinenat	ˈi.kæ.lˌæj.ne.n>ɑh
Ikäläinen+N+Prop+Sem/Sur+Sg+Nom	Ikäläinen	ˈi.kæ.lˌæj.nen>
Illikainen+N+Prop+Sem/Sur+Ess	Illikaisin	ˈil.li.kɑj>.sin
Illikainen+N+Prop+Sem/Sur+Pl+Nom	Illikaisat	ˈil.li.kɑj>.sɑh
Ilmanen+N+Prop+Sem/Sur+Pl+Loc	Ilmaneniin	ˈilə.mɑ.ne.n>ijn
Ilmonen+N+Prop+Sem/Sur+Sg+Com	Ilmoneniin	ˈilə.mo.ne.n>ijn
Ilonen+N+Prop+Sem/Sur+Sg+Loc	Ilonenis	ˈi.lo.ne.n>is
Iltanen+N+Prop+Sem/Sur+Ess	Iltanenin	ˈilː.l̥tɑ.ne.n>in
Ilvonen+N+Prop+Sem/Sur+Pl+Nom	Ilvosat	ˈilə.vo>.sɑh
Immonen+N+Prop+Sem/Sur+Pl+Gen	Immosiid	ˈim.mo>.sijh
Immonen+N+Prop+Sem/Sur+Sg+Acc	Immosa	ˈim.mo>.sɑ
Immonen+N+Prop+Sem/Sur+Pl+Com	Immoneniiguin	ˈim.mo.ne.n>ij.gujn
Imponen+N+Prop+Sem/Sur+Pl+Nom	Imposat	ˈimː.m̥po>.sɑh
Imponen+N+Prop+Sem/Sur+Pl+Gen	Imposiid	ˈimː.m̥po>.sijh
Imponen+N+Prop+Sem/Sur+Pl+Nom	Imponenat	ˈimː.m̥po.ne.n>ɑh
Imponen+N+Prop+Sem/Sur+Pl+Acc	Imponeniid	ˈimː.m̥po.ne.n>ijh
Inkonen+N+Prop+Sem/Sur+Pl+Loc	Inkosiin	ˈiŋŋ.ŋ̊ko>.sijn
Inkonen+N+Prop+Sem/Sur+Sg+Ill	Inkonenii	ˈiŋŋ.ŋ̊ko.ne.n>ij
Innanen+N+Prop+Sem/Sur+Ess	Innasin	ˈinː.nɑː>.sin
Intonen+N+Prop+Sem/Sur+Pl+Ill	Intosiidda	ˈinː.n̥to>.sijt.tɑ
Intonen+N+Prop+Sem/Sur+Sg+Acc	Intosa	ˈinː.n̥to>.sɑ
Intonen+N+Prop+Sem/Sur+Sg+Gen	Intonena	ˈinː.n̥to.ne.n>ɑ
Isoherranen+N+Prop+Sem/Sur+Sg+Loc	Isoherrasis	ˈi.so.hˌer.rɑ>.sis
Isokääntä+N+Prop+Der/laš+A+Pl+Acc+PxDu3	Isokääntälaččaideaskka	ˈi.so#khˌæ.ænː.n̥tæ>.lɑt.tʃɑj.deæs.kɑ
Isokääntä+N+Prop+Der/laš+A+Sg+Gen+PxPl3	Isokääntälaččaset	ˈi.so#khˌæ.ænː.n̥tæ>.lɑt.tʃɑ.seh
Issakainen+N+Prop+Sem/Sur+Pl+Nom	Issakaisat	ˈisː.sɑː.kɑj>.sɑh
Issakainen+N+Prop+Sem/Sur+Pl+Ill	Issakaisiidda	ˈisː.sɑː.kɑj>.sijt.tɑ
Issakainen+N+Prop+Sem/Sur+Pl+Loc	Issakaisiin	ˈisː.sɑː.kɑj>.sijn
Issakainen+N+Prop+Sem/Sur+Sg+Ill	Issakaisii	ˈisː.sɑː.kɑj>.sij
Issakainen+N+Prop+Sem/Sur+Sg+Gen+Allegro	Issakainen	ˈisː.sɑː.kˌɑj.nen>
Itkonen+N+Prop+Sem/Sur+Pl+Loc	Itkosiin	ˈitː.hko>.sijn
Itkonen+N+Prop+Sem/Sur+Sg+Ill	Itkosii	ˈitː.hko>.sij
Itkonen+N+Prop+Sem/Sur+Sg+Loc	Itkosis	ˈitː.hko>.sis
Itkonen+N+Prop+Sem/Sur+Pl+Nom	Itkonenat	ˈitː.hko.ne.n>ɑh
Itkonen+N+Prop+Sem/Sur+Sg+Acc	Itkonena	ˈitː.hko.ne.n>ɑ
Itkonen+N+Prop+Sem/Sur+Sg+Gen	Itkonena	ˈitː.hko.ne.n>ɑ
Jaakkonen+N+Prop+Sem/Sur+Sg+Loc	Jaakkonenis	jˈɑ.ɑk.kˌo.ne.n>is
Jaaranen+N+Prop+Sem/Sur+Sg+Loc	Jaaranenis	jˈɑ.ɑ.rˌɑ.ne.n>is
Jakonen+N+Prop+Sem/Sur+Sg+Gen	Jakonena	jˈɑ.ko.ne.n>ɑ
Janhunen+N+Prop+Sem/Sur+Pl+Gen	Janhusiid	jˈɑn.hu>.sijh
Jarveläinen+N+Prop+Sem/Sur+Pl+Acc	Jarveläisiid	jˈɑrə.ve.læj>.sijh
Jarveläinen+N+Prop+Sem/Sur+Sg+Acc	Jarveläisa	jˈɑrə.ve.læj>.sɑ
Jarveläinen+N+Prop+Sem/Sur+Pl+Ill	Jarveläineniidda	jˈɑrə.ve.lˌæj.ne.n>ijt.tɑ
Jarveläinen+N+Prop+Sem/Sur+Sg+Loc	Jarveläinenis	jˈɑrə.ve.lˌæj.ne.n>is
Javanainen+N+Prop+Sem/Sur+Sg+Acc	Javanaisa	jˈɑ.vɑː.nɑj>.sɑ
Javanainen+N+Prop+Sem/Sur+Pl+Com	Javanaineniiguin	jˈɑ.vɑː.nˌɑj.ne.n>ij.gujn
Jeskanen+N+Prop+Sem/Sur+Pl+Nom	Jeskasat	jˈesː.kɑː>.sɑh
Jeskanen+N+Prop+Sem/Sur+Sg+Com	Jeskaneniin	jˈesː.kɑː.ne.n>ijn
Jetsonen+N+Prop+Sem/Sur+Sg+Loc	Jetsosis	jˈet.so>.sis
Joensuu+N+Prop+Sg+Ill	Joensuui	jˈoen#sˌu.u>i
Joensuu+N+Prop+Der/laš+A+AttrCmp+Der/fárddat+A+Sg+Loc	Joensuulašfárddagis	jˈoen#sˌu.u>.lɑʃ»fˌɑːrt.tɑ.gis
Jolkkonen+N+Prop+Sem/Sur+Pl+Nom	Jolkkonenat	jˈoll̥.ko.ne.n>ɑh
Jonninen+N+Prop+Sem/Sur+Sg+Ill	Jonnisii	jˈon.ni>.sij
Joukainen+N+Prop+Sem/Sur+Sg+Acc	Joukainen	jˈou.kɑj.nen>
Joukainen+N+Prop+Sem/Sur+Sg+Gen	Joukainena	jˈou.kɑj.ne.n>ɑ
Jukarainen+N+Prop+Sem/Sur+Ess	Jukaraisin	jˈu.kɑː.rɑj>.sin
Jukarainen+N+Prop+Sem/Sur+Sg+Ill	Jukarainenii	jˈu.kɑː.rˌɑj.ne.n>ij
Jumppanen+N+Prop+Sem/Sur+Pl+Nom	Jumppasat	jˈumm̥ː.pɑː>.sɑh
Juntunen+N+Prop+Sem/Sur+Ess	Juntunenin	jˈunː.n̥tu.ne.n>in
Juottonen+N+Prop+Sem/Sur+Pl+Loc	Juottosiin	jˈŭot.to>.sijn
Juottonen+N+Prop+Sem/Sur+Ess	Juottonenin	jˈŭot.to.ne.n>in
Jussilainen+N+Prop+Sem/Sur+Sg+Gen+Allegro	Jussilainen	jˈus.si.lˌɑj.nen>
Juvonen+N+Prop+Sem/Sur+Sg+Ill	Juvosii	jˈu.vo>.sij
Jyrkinen+N+Prop+Sem/Sur+Ess	Jyrkinenin	jˈyrə.hki.ne.n>in
Jyrkinen+N+Prop+Sem/Sur+Sg+Acc	Jyrkinen	jˈyrə.hki.nen>
Jyrkiäinen+N+Prop+Sem/Sur+Pl+Loc	Jyrkiäisiin	jˈyrə.hki.æj>.sijn
Jyrkiäinen+N+Prop+Sem/Sur+Sg+Com	Jyrkiäisiin	jˈyrə.hki.æj>.sijn
Jyrkiäinen+N+Prop+Sem/Sur+Sg+Acc	Jyrkiäinena	jˈyrə.hki.ˌæj.ne.n>ɑ
Jäppinen+N+Prop+Sem/Sur+Ess	Jäppisin	jˈæp.pi>.sin
Järvenpää+N+Prop+Sg+Com	Järvenpääin	jˈærə.ven#phˌæ.æ>in
Järvenpää+N+Prop+Der/laš+A+Sg+Nom	Järvenpäälaš	jˈærə.ven#phˌæ.æ>.lɑʃ
Järviluoma+N+Prop+Sem/Sur+Sg+Gen	Järviluoma	jˈærə.vi#lˌuo.mɑ>
Jääskö+N+Prop+Der/laš+A+Attr	Jääsölaš	jˈæ.æs#ø>.lɑʃ
Jääskeläinen+N+Prop+Sem/Sur+Pl+Com	Jääskeläisiiguin	jˈæ.æs.kˌe.læj>.sij.gujn
Jääskeläinen+N+Prop+Sem/Sur+Sg+Acc	Jääskeläinena	jˈæ.æs.kˌe.læj.ne.n>ɑ
Kahilainen+N+Prop+Sem/Sur+Ess	Kahilaisin	khˈɑ.hi.lɑj>.sin
Kaivonen+N+Prop+Sem/Sur+Pl+Loc	Kaivosiin	khˈɑjː.vo>.sijn
Kasanen+N+Prop+Sem/Sur+Sg+Ill	Kasasii	khˈɑ.sɑː>.sij
Kasurinen+N+Prop+Sem/Sur+Pl+Nom	Kasurinenat	khˈɑ.su.rˌi.ne.n>ɑh
Katainen+N+Prop+Sem/Sur+Sg+Com	Kataisiin	khˈɑ.tɑːj>.sijn
Katainen+N+Prop+Sem/Sur+Ess	Katainenin	khˈɑ.tɑːj.ne.n>in
Katainen+N+Prop+Sem/Sur+Pl+Loc	Kataineniin	khˈɑ.tɑːj.ne.n>ijn
Katainen+N+Prop+Sem/Sur+Sg+Acc	Katainena	khˈɑ.tɑːj.ne.n>ɑ
Kejonen+N+Prop+Sem/Sur+Sg+Com	Kejosiin	khˈe.jo>.sijn
Kemppainen+N+Prop+Sem/Sur+Pl+Com	Kemppaisiiguin	khˈemm̥ː.pɑːj>.sij.gujn
Kesonen+N+Prop+Sem/Sur+Sg+Com	Kesosiin	khˈe.so>.sijn
Kielinen+N+Prop+Sem/Sur+Ess	Kielisin	khˈie.li>.sin
Kiimalainen+N+Prop+Sem/Sur+Sg+Acc	Kiimalaisa	khˈij.mɑː.lɑj>.sɑ
Kipinoinen+N+Prop+Sem/Sur+Sg+Acc	Kipinoinena	khˈi.pi.nˌoj.ne.n>ɑ
Kirkinen+N+Prop+Sem/Sur+Ess	Kirkisin	khˈirə.hki>.sin
Kiukkonen+N+Prop+Sem/Sur+Ess	Kiukkosin	khˈi.uk.ko>.sin
Kivinen+N+Prop+Sem/Sur+Sg+Gen+Allegro	Kivinen	khˈi.vi.nen>
Kivinen+N+Prop+Sem/Sur+Sg+Gen	Kivinena	khˈi.vi.ne.n>ɑ
Klemettinen+N+Prop+Sem/Sur+Pl+Nom	Klemettisat	klˈeː.met.ti>.sɑh
Klemettinen+N+Prop+Sem/Sur+Pl+Acc	Klemettisiid	klˈeː.met.ti>.sijh
Klemettinen+N+Prop+Sem/Sur+Sg+Com	Klemettisiin	klˈeː.met.ti>.sijn
Klemettinen+N+Prop+Sem/Sur+Sg+Com	Klemettineniin	klˈeː.met.tˌi.ne.n>ijn
Knuutinen+N+Prop+Sem/Sur+Ess	Knuutisin	knˈu.u.ti>.sin
Knuutinen+N+Prop+Sem/Sur+Sg+Com	Knuutisiin	knˈu.u.ti>.sijn
Knuutinen+N+Prop+Sem/Sur+Pl+Acc	Knuutineniid	knˈu.u.tˌi.ne.n>ijh
Knuutinen+N+Prop+Sem/Sur+Sg+Gen+Allegro	Knuutinen	knˈu.u.tˌi.nen>
Koivunen+N+Prop+Sem/Sur+Ess	Koivusin	khˈojː.vu>.sin
Kojonen+N+Prop+Sem/Sur+Pl+Com	Kojoneniiguin	khˈo.jo.ne.n>ij.gujn
Komonen+N+Prop+Sem/Sur+Sg+Com	Komoneniin	khˈo.mo.ne.n>ijn
Koppinen+N+Prop+Sem/Sur+Sg+Loc	Koppinenis	khˈop.pi.ne.n>is
Korjonen+N+Prop+Sem/Sur+Sg+Loc	Korjosis	khˈorə.jo>.sis
Koskelainen+N+Prop+Sem/Sur+Pl+Acc	Koskelaisiid	khˈosː.ke.lɑj>.sijh
Kottonen+N+Prop+Sem/Sur+Sg+Acc	Kottonen	khˈot.to.nen>
Kuhmonen+N+Prop+Sem/Sur+Sg+Acc	Kuhmonena	khˈuh.mo.ne.n>ɑ
Kujanpää+N+Prop+Der/laš+A+Sg+Com+PxDu2	Kujanpäälaččaineatte	khˈu.jɑːn#phˌæ.æ>.lɑt.tʃɑj.nĕæt.te
Kukkanen+N+Prop+Sem/Sur+Pl+Nom	Kukkasat	khˈukː.kɑː>.sɑh
Kultanen+N+Prop+Sem/Sur+Sg+Com	Kultasiin	khˈulː.l̥tɑ>.sijn
Kuntonen+N+Prop+Sem/Sur+Sg+Com	Kuntoneniin	khˈunː.n̥to.ne.n>ijn
Kurronen+N+Prop+Sem/Sur+Pl+Ill	Kurroneniidda	khˈur.ro.ne.n>ijt.tɑ
Kuuppo+N+Prop+Sem/Sur+Sg+Loc	Kuuppos	khˈu.up.po>s
Kuusiluoma+N+Prop+Sem/Sur+Sg+Ill	Kuusiluomai	khˈu.u.si#lˌuo.mɑ>i
Kykkänen+N+Prop+Sem/Sur+Pl+Com	Kykkäsiiguin	khˈyk.kæ>.sij.gujn
Kykkänen+N+Prop+Sem/Sur+Sg+Acc	Kykkäsa	khˈyk.kæ>.sɑ
Kyllästinen+N+Prop+Sem/Sur+Pl+Gen	Kyllästineniid	khˈyl.læs.tˌi.ne.n>ijh
Kylänpää+N+Prop+Der/laš+A+Ess+PxDu3	Kylänpäälažžaneaskka	khˈy.læn#phˌæ.æ>.lɑdː.tʃɑ.neæs.kɑ
Kymäläinen+N+Prop+Sem/Sur+Ess	Kymäläinenin	khˈy.mæ.lˌæj.ne.n>in
Kymäläinen+N+Prop+Sem/Sur+Sg+Acc	Kymäläinen	khˈy.mæ.lˌæj.nen>
Kyröläinen+N+Prop+Sem/Sur+Sg+Acc	Kyröläisa	khˈy.rø.læj>.sɑ
Kyröläinen+N+Prop+Sem/Sur+Sg+Ill	Kyröläinenii	khˈy.rø.lˌæj.ne.n>ij
Kyynäräinen+N+Prop+Sem/Sur+Pl+Gen	Kyynäräisiid	khˈy.y.nˌæ.ræj>.sijh
Kähkönen+N+Prop+Sem/Sur+Ess	Kähkönenin	khˈæh.kø.ne.n>in
Käsnänen+N+Prop+Sem/Sur+Ess	Käsnäsin	khˈæs.næ>.sin
Könönen+N+Prop+Sem/Sur+Ess	Könösin	khˈø.nø>.sin
Könönen+N+Prop+Sem/Sur+Sg+Ill	Könösii	khˈø.nø>.sij
Könönen+N+Prop+Sem/Sur+Ess	Könönenin	khˈø.nø.ne.n>in
Könönen+N+Prop+Sem/Sur+Pl+Nom	Könönenat	khˈø.nø.ne.n>ɑh
Könönen+N+Prop+Sem/Sur+Sg+Gen	Könönena	khˈø.nø.ne.n>ɑ
Könönen+N+Prop+Sem/Sur+Sg+Com	Könöneniin	khˈø.nø.ne.n>ijn
Lakanen+N+Prop+Sem/Sur+Sg+Gen	Lakasa	lˈɑ.kɑː>.sɑ
Lamponen+N+Prop+Sem/Sur+Ess	Lamponenin	lˈɑmː.m̥po.ne.n>in
Lattunen+N+Prop+Sem/Sur+Pl+Gen	Lattuneniid	lˈɑt.tu.ne.n>ijh
Laulainen+N+Prop+Sem/Sur+Pl+Gen	Laulaisiid	lˈɑu.lɑj>.sijh
Leiponen+N+Prop+Sem/Sur+Pl+Loc	Leiposiin	lˈejː.çpo>.sijn
Leminen+N+Prop+Sem/Sur+Sg+Ill	Leminenii	lˈe.mi.ne.n>ij
Leskinen+N+Prop+Sem/Sur+Pl+Nom	Leskisat	lˈesː.ki>.sɑh
Lesonen+N+Prop+Sem/Sur+Ess	Lesosin	lˈe.so>.sin
Lesonen+N+Prop+Sem/Sur+Sg+Gen	Lesonena	lˈe.so.ne.n>ɑ
Lievonen+N+Prop+Sem/Sur+Ess	Lievosin	lˈĭe.vo>.sin
Lihavainen+N+Prop+Sem/Sur+Sg+Com	Lihavaineniin	lˈi.hɑː.vˌɑj.ne.n>ijn
Lintunen+N+Prop+Sem/Sur+Pl+Gen	Lintuneniid	lˈinː.n̥tu.ne.n>ijh
Littunen+N+Prop+Sem/Sur+Sg+Acc	Littusa	lˈit.tu>.sɑ
Littunen+N+Prop+Sem/Sur+Sg+Ill	Littunenii	lˈit.tu.ne.n>ij
Liukkonen+N+Prop+Sem/Sur+Pl+Nom	Liukkosat	lˈi.uk.ko>.sɑh
Liukkonen+N+Prop+Sem/Sur+Pl+Gen	Liukkosiid	lˈi.uk.ko>.sijh
Liukkonen+N+Prop+Sem/Sur+Sg+Acc	Liukkosa	lˈi.uk.ko>.sɑ
Loponen+N+Prop+Sem/Sur+Sg+Gen	Loposa	lˈo.po>.sɑ
Louhelainen+N+Prop+Sem/Sur+Sg+Acc	Louhelaisa	lˈou.he.lɑj>.sɑ
Luhtanen+N+Prop+Sem/Sur+Pl+Ill	Luhtaneniidda	lˈuhː.tɑː.ne.n>ijt.tɑ
Luhtanen+N+Prop+Sem/Sur+Sg+Nom	Luhtanen	lˈuhː.tɑː.nen>
Lukkaroinen+N+Prop+Sem/Sur+Pl+Loc	Lukkaroineniin	lˈukː.kɑː.rˌoj.ne.n>ijn
Luontopoika+N+Prop+Sg+Ill	Luontopoikai	lˈŭonː.n̥to#phˌojː.çkɑ>i
Luossavaara+N+Prop+Sg+Nom	Luossavaara	lˈuos.sɑ#vˌɑ.ɑ.rɑ>
Luttinen+N+Prop+Sem/Sur+Sg+Gen	Luttinena	lˈut.ti.ne.n>ɑ
Luukkonen+N+Prop+Sem/Sur+Pl+Nom	Luukkonenat	lˈu.uk.kˌo.ne.n>ɑh
Lyhykäinen+N+Prop+Sem/Sur+Sg+Com	Lyhykäisiin	lˈy.hy.kæj>.sijn
Lyhykäinen+N+Prop+Sem/Sur+Sg+Loc	Lyhykäisis	lˈy.hy.kæj>.sis
Lyttinen+N+Prop+Sem/Sur+Sg+Acc	Lyttinena	lˈyt.ti.ne.n>ɑ
Lähteinen+N+Prop+Sem/Sur+Sg+Nom	Lähteinen	lˈæh.tej.nen>
Lähteinen+N+Prop+Sem/Sur+Sg+Loc	Lähteinenis	lˈæh.tej.ne.n>is
Länkinen+N+Prop+Sem/Sur+Pl+Com	Länkisiiguin	lˈæŋŋ.ŋ̊ki>.sij.gujn
Länkinen+N+Prop+Sem/Sur+Pl+Gen	Länkisiid	lˈæŋŋ.ŋ̊ki>.sijh
Länkinen+N+Prop+Sem/Sur+Sg+Ill	Länkisii	lˈæŋŋ.ŋ̊ki>.sij
Läntinen+N+Prop+Sem/Sur+Pl+Com	Läntisiiguin	lˈænː.n̥ti>.sij.gujn
Läntinen+N+Prop+Sem/Sur+Sg+Com	Läntineniin	lˈænː.n̥ti.ne.n>ijn
Löhönen+N+Prop+Sem/Sur+Sg+Gen	Löhösa	lˈø.hø>.sɑ
Löhönen+N+Prop+Sem/Sur+Pl+Ill	Löhöneniidda	lˈø.hø.ne.n>ijt.tɑ
Löppönen+N+Prop+Sem/Sur+Sg+Ill	Löppösii	lˈøp.pø>.sij
Löppönen+N+Prop+Sem/Sur+Pl+Ill	Löppöneniidda	lˈøp.pø.ne.n>ijt.tɑ
Löppönen+N+Prop+Sem/Sur+Sg+Gen	Löppönena	lˈøp.pø.ne.n>ɑ
Lötjönen+N+Prop+Sem/Sur+Sg+Com	Lötjösiin	lˈøt.jø>.sijn
Lötjönen+N+Prop+Sem/Sur+Sg+Gen+Allegro	Lötjönen	lˈøt.jø.nen>
Maljanen+N+Prop+Sem/Sur+Pl+Acc	Maljaneniid	mˈɑʎ.ʎɑː.ne.n>ijh
Mankinen+N+Prop+Sem/Sur+Pl+Nom	Mankinenat	mˈɑŋŋ.ŋ̊ki.ne.n>ɑh
Marainen+N+Prop+Sem/Sur+Ess	Marainenin	mˈɑ.rɑːj.ne.n>in
Massinen+N+Prop+Sem/Sur+Sg+Nom	Massinen	mˈɑs.si.nen>
Maukonen+N+Prop+Sem/Sur+Pl+Nom	Maukonenat	mˈɑu.ko.ne.n>ɑh
Mehtonen+N+Prop+Sem/Sur+Pl+Acc	Mehtosiid	mˈeh.to>.sijh
Mehtonen+N+Prop+Sem/Sur+Pl+Loc	Mehtosiin	mˈeh.to>.sijn
Metsänen+N+Prop+Sem/Sur+Sg+Gen	Metsäsa	mˈet.sæ>.sɑ
Mielikäinen+N+Prop+Sem/Sur+Sg+Acc	Mielikäinena	mˈie.li.kˌæj.ne.n>ɑ
Mieskolainen+N+Prop+Sem/Sur+Sg+Gen	Mieskolainena	mˈĭesː.ko.lˌɑj.ne.n>ɑ
Miettunen+N+Prop+Sem/Sur+Pl+Acc	Miettuneniid	mˈiet.tu.ne.n>ijh
Miikkulainen+N+Prop+Sem/Sur+Sg+Gen	Miikkulaisa	mˈijç.ku.lɑj>.sɑ
Miikkulainen+N+Prop+Sem/Sur+Sg+Ill	Miikkulainenii	mˈijç.ku.lˌɑj.ne.n>ij
Mikkolainen+N+Prop+Sem/Sur+Ess	Mikkolaisin	mˈik.ko.lɑj>.sin
Mitrunen+N+Prop+Sem/Sur+Sg+Gen	Mitrusa	mˈit.ru>.sɑ
Moilanen+N+Prop+Sem/Sur+Ess	Moilanenin	mˈojː.lɑː.ne.n>in
Moilanen+N+Prop+Sem/Sur+Sg+Nom	Moilanen	mˈojː.lɑː.nen>
Moisanen+N+Prop+Sem/Sur+Pl+Nom	Moisasat	mˈojː.sɑː>.sɑh
Moisanen+N+Prop+Sem/Sur+Pl+Ill	Moisasiidda	mˈojː.sɑː>.sijt.tɑ
Mononen+N+Prop+Sem/Sur+Sg+Loc	Monosis	mˈo.no>.sis
Mononen+N+Prop+Sem/Sur+Pl+Nom	Mononenat	mˈo.no.ne.n>ɑh
Mononen+N+Prop+Sem/Sur+Sg+Gen	Mononena	mˈo.no.ne.n>ɑ
Montonen+N+Prop+Sem/Sur+Pl+Ill	Montosiidda	mˈonː.n̥to>.sijt.tɑ
Montonen+N+Prop+Sem/Sur+Sg+Loc	Montosis	mˈonː.n̥to>.sis
Muhonen+N+Prop+Sem/Sur+Ess	Muhonenin	mˈu.ho.ne.n>in
Mujunen+N+Prop+Sem/Sur+Sg+Gen	Mujunena	mˈu.ju.ne.n>ɑ
Muranen+N+Prop+Sem/Sur+Ess	Muranenin	mˈu.rɑː.ne.n>in
Mutanen+N+Prop+Sem/Sur+Sg+Acc	Mutasa	mˈu.tɑː>.sɑ
Mykkänen+N+Prop+Sem/Sur+Ess	Mykkäsin	mˈyk.kæ>.sin
Mykkänen+N+Prop+Sem/Sur+Sg+Acc	Mykkäsa	mˈyk.kæ>.sɑ
Mykkänen+N+Prop+Sem/Sur+Pl+Gen	Mykkäneniid	mˈyk.kæ.ne.n>ijh
Mykkänen+N+Prop+Sem/Sur+Sg+Com	Mykkäneniin	mˈyk.kæ.ne.n>ijn
Mykkänen+N+Prop+Sem/Sur+Sg+Loc	Mykkänenis	mˈyk.kæ.ne.n>is
Mynttinen+N+Prop+Sem/Sur+Pl+Nom	Mynttisat	mˈynn̥.ti>.sɑh
Mynttinen+N+Prop+Sem/Sur+Sg+Gen	Mynttinena	mˈynn̥.ti.ne.n>ɑ
Myyryläinen+N+Prop+Sem/Sur+Sg+Acc	Myyryläisa	mˈy.y.rˌy.læj>.sɑ
Myyryläinen+N+Prop+Sem/Sur+Sg+Acc	Myyryläinen	mˈy.y.rˌy.læj.nen>
Myöhänen+N+Prop+Sem/Sur+Ess	Myöhäsin	mˈy.ø.hæ>.sin
Myöhänen+N+Prop+Sem/Sur+Sg+Com	Myöhäneniin	mˈy.ø.hˌæ.ne.n>ijn
Mäenpää+N+Prop+Ess	Mäenpään	mˈæ.en#phˌæ.æ>n
Mäenpää+N+Prop+Sg+Com	Mäenpääin	mˈæ.en#phˌæ.æ>in
Mäenpää+N+Prop+Der/laš+A+Pl+Loc+PxSg1	Mäenpäälaččainan	mˈæ.en#phˌæ.æ>.lɑt.tʃɑj.nɑn
Mähönen+N+Prop+Sem/Sur+Sg+Com	Mähöneniin	mˈæ.hø.ne.n>ijn
Mäkeläinen+N+Prop+Sem/Sur+Pl+Com	Mäkeläisiiguin	mˈæ.ke.læj>.sij.gujn
Mäkeläinen+N+Prop+Sem/Sur+Ess	Mäkeläinenin	mˈæ.ke.lˌæj.ne.n>in
Mäkynen+N+Prop+Sem/Sur+Pl+Loc	Mäkyneniin	mˈæ.ky.ne.n>ijn
Mäkäläinen+N+Prop+Sem/Sur+Pl+Gen	Mäkäläineniid	mˈæ.kæ.lˌæj.ne.n>ijh
Mäntynen+N+Prop+Sem/Sur+Sg+Com	Mäntyneniin	mˈænː.n̥ty.ne.n>ijn
Mökkönen+N+Prop+Sem/Sur+Ess	Mökkösin	mˈøk.kø>.sin
Mökkönen+N+Prop+Sem/Sur+Sg+Ill	Mökkösii	mˈøk.kø>.sij
Mökkönen+N+Prop+Sem/Sur+Pl+Nom	Mökkönenat	mˈøk.kø.ne.n>ɑh
Mönttinen+N+Prop+Sem/Sur+Sg+Loc	Mönttinenis	mˈønn̥.ti.ne.n>is
Möttönen+N+Prop+Sem/Sur+Pl+Nom	Möttösat	mˈøt.tø>.sɑh
Möttönen+N+Prop+Sem/Sur+Pl+Ill	Möttöneniidda	mˈøt.tø.ne.n>ijt.tɑ
Möykkynen+N+Prop+Sem/Sur+Ess	Möykkysin	mˈø.yk.ky>.sin
Möykkynen+N+Prop+Sem/Sur+Pl+Nom	Möykkynenat	mˈø.yk.kˌy.ne.n>ɑh
Narinen+N+Prop+Sem/Sur+Ess	Narisin	nˈɑ.ri>.sin
Narinen+N+Prop+Sem/Sur+Pl+Loc	Narisiin	nˈɑ.ri>.sijn
Narinen+N+Prop+Sem/Sur+Pl+Nom	Narinenat	nˈɑ.ri.ne.n>ɑh
Narinen+N+Prop+Sem/Sur+Pl+Com	Narineniiguin	nˈɑ.ri.ne.n>ij.gujn
Natunen+N+Prop+Sem/Sur+Pl+Acc	Natuneniid	nˈɑ.tu.ne.n>ijh
Natunen+N+Prop+Sem/Sur+Sg+Ill	Natunenii	nˈɑ.tu.ne.n>ij
Naukkarinen+N+Prop+Sem/Sur+Sg+Acc	Naukkarinena	nˈɑuk.kɑ.rˌi.ne.n>ɑ
Naumanen+N+Prop+Sem/Sur+Ess	Naumanenin	nˈɑu.mɑ.ne.n>in
Naumanen+N+Prop+Sem/Sur+Pl+Nom	Naumanenat	nˈɑu.mɑ.ne.n>ɑh
Neuvonen+N+Prop+Sem/Sur+Ess	Neuvosin	nˈeu.vo>.sin
Nevanpää+N+Prop+Der/laš+A+Pl+Nom+PxPl1	Nevanpäälaččaideamet	nˈe.vɑːn#phˌæ.æ>.lɑt.tʃɑj.dĕæ.meh
Niemonen+N+Prop+Sem/Sur+Pl+Ill	Niemosiidda	nˈĭe.mo>.sijt.tɑ
Niittynen+N+Prop+Sem/Sur+Sg+Gen+Allegro	Niittynen	nˈijç.ty.nen>
Nikkonen+N+Prop+Sem/Sur+Sg+Acc	Nikkosa	nˈik.ko>.sɑ
Nikunen+N+Prop+Sem/Sur+Ess	Nikusin	nˈi.ku>.sin
Nirkkonen+N+Prop+Sem/Sur+Sg+Com	Nirkkosiin	nˈirr̥.ko>.sijn
Nirkkonen+N+Prop+Sem/Sur+Ess	Nirkkonenin	nˈirr̥.ko.ne.n>in
Nironen+N+Prop+Sem/Sur+Sg+Nom	Nironen	nˈi.ro.nen>
Niukkanen+N+Prop+Sem/Sur+Sg+Com	Niukkaneniin	nˈi.uk.kˌɑ.ne.n>ijn
Nivalainen+N+Prop+Sem/Sur+Pl+Nom	Nivalaisat	nˈi.vɑː.lɑj>.sɑh
Nokkonen+N+Prop+Sem/Sur+Pl+Com	Nokkoneniiguin	nˈok.ko.ne.n>ij.gujn
Nopanen+N+Prop+Sem/Sur+Pl+Nom	Nopasat	nˈo.pɑː>.sɑh
Nopanen+N+Prop+Sem/Sur+Pl+Gen	Nopasiid	nˈo.pɑː>.sijh
Noponen+N+Prop+Sem/Sur+Sg+Gen	Noposa	nˈo.po>.sɑ
Nousiainen+N+Prop+Der/laš+A+Ess+PxPl3	Nousiailažžaneaset	nˈou.si.ˌɑjː.lɑdː.tʃˌɑ.nĕæ.seh
Nuolioja+N+Prop+Der/laš+A+Sg+Gen+PxDu3	Nuoliojalaččaska	nˈuo.li#ˌo.jɑ>.lɑt.tʃɑs.kɑ
Nuopponen+N+Prop+Sem/Sur+Ess	Nuopposin	nˈŭop.po>.sin
Nupponen+N+Prop+Sem/Sur+Ess	Nupposin	nˈup.po>.sin
Nupponen+N+Prop+Sem/Sur+Ess	Nupponenin	nˈup.po.ne.n>in
Nupponen+N+Prop+Sem/Sur+Pl+Loc	Nupponeniin	nˈup.po.ne.n>ijn
Nurhonen+N+Prop+Sem/Sur+Ess	Nurhonenin	nˈur.ho.ne.n>in
Nuutilainen+N+Prop+Sem/Sur+Pl+Nom	Nuutilaisat	nˈu.u.tˌi.lɑj>.sɑh
Nykänen+N+Prop+Sem/Sur+Sg+Acc	Nykäsa	nˈy.kæ>.sɑ
Nykänen+N+Prop+Sem/Sur+Sg+Com	Nykäsiin	nˈy.kæ>.sijn
Nykänen+N+Prop+Sem/Sur+Sg+Loc	Nykäsis	nˈy.kæ>.sis
Nykänen+N+Prop+Sem/Sur+Pl+Ill	Nykäneniidda	nˈy.kæ.ne.n>ijt.tɑ
Nykänen+N+Prop+Sem/Sur+Pl+Loc	Nykäneniin	nˈy.kæ.ne.n>ijn
Nykänen+N+Prop+Sem/Sur+Sg+Loc	Nykänenis	nˈy.kæ.ne.n>is
Nyrönen+N+Prop+Sem/Sur+Ess	Nyrösin	nˈy.rø>.sin
Nyyssönen+N+Prop+Sem/Sur+Pl+Nom	Nyyssösat	nˈy.ys.sø>.sɑh
Nyyssönen+N+Prop+Sem/Sur+Sg+Acc	Nyyssönen	nˈy.ys.sˌø.nen>
Närvänen+N+Prop+Sem/Sur+Sg+Gen	Närvänena	nˈærə.væ.ne.n>ɑ
Näsänen+N+Prop+Sem/Sur+Sg+Acc	Näsäsa	nˈæ.sæ>.sɑ
Näsänen+N+Prop+Sem/Sur+Sg+Gen	Näsänena	nˈæ.sæ.ne.n>ɑ
Nättinen+N+Prop+Sem/Sur+Pl+Com	Nättineniiguin	nˈæt.ti.ne.n>ij.gujn
Näätänen+N+Prop+Sem/Sur+Pl+Nom	Näätäsat	nˈæ.æ.tæ>.sɑh
Näätänen+N+Prop+Sem/Sur+Sg+Acc	Näätäsa	nˈæ.æ.tæ>.sɑ
Näätänen+N+Prop+Sem/Sur+Sg+Acc	Näätänena	nˈæ.æ.tˌæ.ne.n>ɑ
Ohtonen+N+Prop+Sem/Sur+Pl+Acc	Ohtosiid	ˈoh.to>.sijh
Ohtonen+N+Prop+Sem/Sur+Ess	Ohtonenin	ˈoh.to.ne.n>in
Ohtonen+N+Prop+Sem/Sur+Sg+Gen+Allegro	Ohtonen	ˈoh.to.nen>
Ohtonen+N+Prop+Sem/Sur+Sg+Nom	Ohtonen	ˈoh.to.nen>
Oikarainen+N+Prop+Der/laš+A+Ess+PxSg1	Oikarainenlažžanan	ˈojː.çkɑ.rˌɑj.nen.lˌɑdː.tʃɑ.nɑn
Oikkonen+N+Prop+Sem/Sur+Ess	Oikkonenin	ˈojç.ko.ne.n>in
Oinonen+N+Prop+Sem/Sur+Ess	Oinosin	ˈoj.no>.sin
Oivanen+N+Prop+Sem/Sur+Sg+Ill	Oivasii	ˈojː.vɑː>.sij
Oivanen+N+Prop+Sem/Sur+Sg+Loc	Oivasis	ˈojː.vɑː>.sis
Oivanen+N+Prop+Sem/Sur+Ess	Oivanenin	ˈojː.vɑː.ne.n>in
Oivanen+N+Prop+Sem/Sur+Sg+Acc	Oivanen	ˈojː.vɑː.nen>
Ojanen+N+Prop+Sem/Sur+Ess	Ojasin	ˈo.jɑː>.sin
Ojanen+N+Prop+Sem/Sur+Sg+Gen	Ojasa	ˈo.jɑː>.sɑ
Ojanen+N+Prop+Sem/Sur+Ess	Ojanenin	ˈo.jɑː.ne.n>in
Ojanen+N+Prop+Sem/Sur+Sg+Nom	Ojanen	ˈo.jɑː.nen>
Ojansuu+N+Prop+Sem/Sur+Pl+Acc	Ojansuuid	ˈo.jɑːn#sˌu.u>id
Ojansuu+N+Prop+Sem/Sur+Pl+Nom	Ojansuut	ˈo.jɑːn#sˌu.u>h
Ojansuu+N+Prop+Sem/Sur+Sg+Loc	Ojansuus	ˈo.jɑːn#sˌu.u>s
Okkonen+N+Prop+Sem/Sur+Ess	Okkosin	ˈok.ko>.sin
Okkonen+N+Prop+Sem/Sur+Sg+Acc	Okkosa	ˈok.ko>.sɑ
Okkonen+N+Prop+Sem/Sur+Sg+Ill	Okkosii	ˈok.ko>.sij
Okkonen+N+Prop+Sem/Sur+Pl+Gen	Okkoneniid	ˈok.ko.ne.n>ijh
Okkonen+N+Prop+Sem/Sur+Sg+Acc	Okkonena	ˈok.ko.ne.n>ɑ
Okkonen+N+Prop+Sem/Sur+Sg+Loc	Okkonenis	ˈok.ko.ne.n>is
Oksanen+N+Prop+Sem/Sur+Sg+Ill	Oksasii	ˈokː.sɑː>.sij
Oksanen+N+Prop+Sem/Sur+Sg+Gen	Oksanena	ˈokː.sɑː.ne.n>ɑ
Oksanen+N+Prop+Sem/Sur+Sg+Loc	Oksanenis	ˈokː.sɑː.ne.n>is
Olkinuora+N+Prop+Sem/Sur+Pl+Gen	Olkinuoraid	ˈolə.hki.nˌuo.rɑ>id
Olkinuora+N+Prop+Sem/Sur+Sg+Acc	Olkinuora	ˈolə.hki.nˌuo.rɑ>
Olkkonen+N+Prop+Sem/Sur+Ess	Olkkonenin	ˈoll̥.ko.ne.n>in
Olkkonen+N+Prop+Sem/Sur+Sg+Loc	Olkkonenis	ˈoll̥.ko.ne.n>is
Ollonen+N+Prop+Sem/Sur+Pl+Nom	Ollonenat	ˈol.lo.ne.n>ɑh
Oranen+N+Prop+Sem/Sur+Ess	Orasin	ˈo.rɑː>.sin
Oranen+N+Prop+Sem/Sur+Sg+Gen	Orasa	ˈo.rɑː>.sɑ
Oranen+N+Prop+Sem/Sur+Pl+Nom	Oranenat	ˈo.rɑː.ne.n>ɑh
Oranen+N+Prop+Sem/Sur+Pl+Ill	Oraneniidda	ˈo.rɑː.ne.n>ijt.tɑ
Oravainen+N+Prop+Sg+Com	Oravaineniin	ˈo.rɑː.vˌɑj.ne.n>ijn
Oravainen+N+Prop+Der/laš+A+Sg+Nom+PxDu3	Oravailažžaska	ˈo.rɑː.vˌɑjː.lɑdː.tʃˌɑs.kɑ
Otranen+N+Prop+Sem/Sur+Pl+Nom	Otrasat	ˈot.rɑː>.sɑh
Otranen+N+Prop+Sem/Sur+Sg+Com	Otraneniin	ˈot.rɑː.ne.n>ijn
Ottavainen+N+Prop+Sem/Sur+Ess	Ottavaisin	ˈotː.tɑː.vɑj>.sin
Ottavainen+N+Prop+Sem/Sur+Sg+Gen	Ottavaisa	ˈotː.tɑː.vɑj>.sɑ
Ottavainen+N+Prop+Sem/Sur+Ess	Ottavainenin	ˈotː.tɑː.vˌɑj.ne.n>in
Outinen+N+Prop+Sem/Sur+Ess	Outisin	ˈou.ti>.sin
Outinen+N+Prop+Sem/Sur+Pl+Nom	Outisat	ˈou.ti>.sɑh
Outinen+N+Prop+Sem/Sur+Pl+Ill	Outisiidda	ˈou.ti>.sijt.tɑ
Outinen+N+Prop+Sem/Sur+Sg+Gen	Outisa	ˈou.ti>.sɑ
Outinen+N+Prop+Sem/Sur+Sg+Ill	Outisii	ˈou.ti>.sij
Outinen+N+Prop+Sem/Sur+Sg+Nom	Outinen	ˈou.ti.nen>
Paatelainen+N+Prop+Sem/Sur+Pl+Nom	Paatelaisat	phˈɑ.ɑ.tˌe.lɑj>.sɑh
Palkeinen+N+Prop+Sem/Sur+Sg+Acc	Palkeinena	phˈɑlə.hkej.ne.n>ɑ
Papunen+N+Prop+Sem/Sur+Ess	Papunenin	phˈɑ.pu.ne.n>in
Parjanen+N+Prop+Sem/Sur+Sg+Loc	Parjasis	phˈɑrə.jɑ>.sis
Pehkonen+N+Prop+Sem/Sur+Pl+Nom	Pehkosat	phˈeh.ko>.sɑh
Peiponen+N+Prop+Sem/Sur+Ess	Peiponenin	phˈejː.çpo.ne.n>in
Pekkinen+N+Prop+Sem/Sur+Pl+Com	Pekkineniiguin	phˈek.ki.ne.n>ij.gujn
Pekkonen+N+Prop+Sem/Sur+Sg+Loc	Pekkosis	phˈek.ko>.sis
Pekurinen+N+Prop+Sem/Sur+Pl+Nom	Pekurinenat	phˈe.ku.rˌi.ne.n>ɑh
Pekurinen+N+Prop+Sem/Sur+Sg+Gen	Pekurinena	phˈe.ku.rˌi.ne.n>ɑ
Peltonen+N+Prop+Sem/Sur+Sg+Nom	Peltonen	phˈelː.l̥to.nen>
Pentikäinen+N+Prop+Sem/Sur+Pl+Nom	Pentikäisat	phˈenː.n̥ti.kæj>.sɑh
Pentikäinen+N+Prop+Sem/Sur+Pl+Gen	Pentikäisiid	phˈenː.n̥ti.kæj>.sijh
Perttunen+N+Prop+Sem/Sur+Pl+Nom	Perttusat	phˈerr̥.tu>.sɑh
Pesonen+N+Prop+Sem/Sur+Pl+Gen	Pesoneniid	phˈe.so.ne.n>ijh
Pesonen+N+Prop+Sem/Sur+Pl+Ill	Pesoneniidda	phˈe.so.ne.n>ijt.tɑ
Pettinen+N+Prop+Sem/Sur+Ess	Pettinenin	phˈet.ti.ne.n>in
Piaskainen+N+Prop+Sem/Sur+Ess	Piaskainenin	phˈi.ɑs.kˌɑj.ne.n>in
Piesanen+N+Prop+Sem/Sur+Sg+Acc	Piesasa	phˈie.sɑ>.sɑ
Pikkarainen+N+Prop+Sem/Sur+Ess	Pikkarainenin	phˈikː.kɑː.rˌɑj.ne.n>in
Piltonen+N+Prop+Sem/Sur+Pl+Ill	Piltoneniidda	phˈilː.l̥to.ne.n>ijt.tɑ
Pipinen+N+Prop+Sem/Sur+Sg+Loc	Pipinenis	phˈi.pi.ne.n>is
Piskonen+N+Prop+Sem/Sur+Pl+Nom	Piskosat	phˈisː.ko>.sɑh
Pohjanen+N+Prop+Sem/Sur+Sg+Acc	Pohjasa	phˈoh.jɑː>.sɑ
Poikolainen+N+Prop+Sem/Sur+Ess	Poikolainenin	phˈojː.çko.lˌɑj.ne.n>in
Poikonen+N+Prop+Sem/Sur+Pl+Gen	Poikosiid	phˈojː.çko>.sijh
Poikulainen+N+Prop+Sem/Sur+Sg+Loc	Poikulaisis	phˈojː.çku.lɑj>.sis
Pokkinen+N+Prop+Sem/Sur+Sg+Loc	Pokkisis	phˈok.ki>.sis
Poranen+N+Prop+Sem/Sur+Ess	Poranenin	phˈo.rɑː.ne.n>in
Poranen+N+Prop+Sem/Sur+Sg+Acc	Poranen	phˈo.rɑː.nen>
Poutanen+N+Prop+Sem/Sur+Sg+Acc	Poutasa	phˈou.tɑ>.sɑ
Poutasuo+N+Prop+Sem/Sur+Sg+Loc	Poutasuos	phˈou.tɑ#suo>s
Poutiainen+N+Prop+Sem/Sur+Ess	Poutiainenin	phˈou.ti.ˌɑj.ne.n>in
Prittinen+N+Prop+Sem/Sur+Pl+Nom	Prittisat	prˈit.ti>.sɑh
Prittinen+N+Prop+Sem/Sur+Sg+Acc	Prittisa	prˈit.ti>.sɑ
Prittinen+N+Prop+Sem/Sur+Pl+Gen	Prittineniid	prˈit.ti.ne.n>ijh
Prittinen+N+Prop+Sem/Sur+Sg+Acc	Prittinen	prˈit.ti.nen>
Prittinen+N+Prop+Sem/Sur+Sg+Gen+Allegro	Prittinen	prˈit.ti.nen>
Prittinen+N+Prop+Sem/Sur+Sg+Gen	Prittinena	prˈit.ti.ne.n>ɑ
Puhakainen+N+Prop+Sem/Sur+Pl+Nom	Puhakainenat	phˈu.hɑː.kˌɑj.ne.n>ɑh
Pulkkanen+N+Prop+Sem/Sur+Pl+Nom	Pulkkasat	phˈull̥ː.kɑː>.sɑh
Pullinen+N+Prop+Sem/Sur+Sg+Com	Pullisiin	phˈul.li>.sijn
Pullinen+N+Prop+Sem/Sur+Ess	Pullinenin	phˈul.li.ne.n>in
Pullinen+N+Prop+Sem/Sur+Pl+Gen	Pullineniid	phˈul.li.ne.n>ijh
Punkkinen+N+Prop+Sem/Sur+Sg+Nom	Punkkinen	phˈuŋŋ̊.ki.nen>
Pussinen+N+Prop+Sem/Sur+Sg+Gen	Pussisa	phˈus.si>.sɑ
Pussinen+N+Prop+Sem/Sur+Sg+Gen	Pussinena	phˈus.si.ne.n>ɑ
Puukko+N+Prop+Sem/Sur+Ess	Puukkon	phˈu.uk.ko>n
Pyhäluoto+N+Prop+Sem/Sur+Pl+Com	Pyhäluotoiguin	phˈy.hæ#lˌŭo.to>i.gujn
Pykäläinen+N+Prop+Sem/Sur+Pl+Nom	Pykäläisat	phˈy.kæ.læj>.sɑh
Pykäläinen+N+Prop+Sem/Sur+Sg+Nom	Pykäläinen	phˈy.kæ.lˌæj.nen>
Pynnönen+N+Prop+Sem/Sur+Sg+Com	Pynnösiin	phˈyn.nø>.sijn
Pystynen+N+Prop+Sem/Sur+Pl+Nom	Pystynenat	phˈysː.ty.ne.n>ɑh
Pyysalo+N+Prop+Sem/Sur+Sg+Gen	Pyysalo	phˈy.y#sˌɑ.lo>
Päivinen+N+Prop+Sem/Sur+Sg+Gen	Päivisa	phˈæjː.vi>.sɑ
Päivinen+N+Prop+Sem/Sur+Ess	Päivinenin	phˈæjː.vi.ne.n>in
Pänkäläinen+N+Prop+Sem/Sur+Sg+Gen+Allegro	Pänkäläinen	phˈæŋŋ.ŋ̊kæ.lˌæj.nen>
Pänkäläinen+N+Prop+Sem/Sur+Sg+Acc	Pänkäläinena	phˈæŋŋ.ŋ̊kæ.lˌæj.ne.n>ɑ
Pänkäläinen+N+Prop+Sem/Sur+Sg+Gen	Pänkäläinena	phˈæŋŋ.ŋ̊kæ.lˌæj.ne.n>ɑ
Pärssinen+N+Prop+Sem/Sur+Ess	Pärssisin	phˈærs.si>.sin
Pätynen+N+Prop+Sem/Sur+Pl+Nom	Pätysat	phˈæ.ty>.sɑh
Pätynen+N+Prop+Sem/Sur+Pl+Gen	Pätysiid	phˈæ.ty>.sijh
Pätynen+N+Prop+Sem/Sur+Sg+Gen	Pätysa	phˈæ.ty>.sɑ
Pätynen+N+Prop+Sem/Sur+Sg+Gen	Pätynena	phˈæ.ty.ne.n>ɑ
Pääkkönen+N+Prop+Sem/Sur+Sg+Acc	Pääkkönen	phˈæ.æk.kˌø.nen>
Päätalo+N+Prop+Sem/Sur+Sg+Ill	Päätaloi	phˈæ.æ#thˌɑ.lo>i
Pöyhönen+N+Prop+Sem/Sur+Sg+Ill	Pöyhösii	phˈø.y.hø>.sij
Pöyhönen+N+Prop+Sem/Sur+Pl+Nom	Pöyhönenat	phˈø.y.hˌø.ne.n>ɑh
Rahkonen+N+Prop+Sem/Sur+Sg+Ill	Rahkosii	rˈɑh.ko>.sij
Rajanen+N+Prop+Sem/Sur+Pl+Nom	Rajasat	rˈɑ.jɑː>.sɑh
Rakkolainen+N+Prop+Sem/Sur+Pl+Nom	Rakkolaisat	rˈɑk.ko.lɑj>.sɑh
Rakkolainen+N+Prop+Sem/Sur+Ess	Rakkolainenin	rˈɑk.ko.lˌɑj.ne.n>in
Rautiainen+N+Prop+Sem/Sur+Sg+Gen+Allegro	Rautiainen	rˈɑu.ti.ˌɑj.nen>
Reinikainen+N+Prop+Sem/Sur+Sg+Gen	Reinikainena	rˈej.ni.kˌɑj.ne.n>ɑ
Rekonen+N+Prop+Sem/Sur+Ess	Rekosin	rˈe.ko>.sin
Rekonen+N+Prop+Sem/Sur+Pl+Com	Rekosiiguin	rˈe.ko>.sij.gujn
Reponen+N+Prop+Sem/Sur+Pl+Nom	Reposat	rˈe.po>.sɑh
Reponen+N+Prop+Sem/Sur+Pl+Com	Reposiiguin	rˈe.po>.sij.gujn
Reponen+N+Prop+Sem/Sur+Ess	Reponenin	rˈe.po.ne.n>in
Reponen+N+Prop+Sem/Sur+Sg+Acc	Reponen	rˈe.po.nen>
Reunanen+N+Prop+Sem/Sur+Ess	Reunasin	rˈeu.nɑ>.sin
Reunanen+N+Prop+Sem/Sur+Pl+Gen	Reunasiid	rˈeu.nɑ>.sijh
Reunanen+N+Prop+Sem/Sur+Pl+Acc	Reunaneniid	rˈeu.nɑ.ne.n>ijh
Reunanen+N+Prop+Sem/Sur+Sg+Gen	Reunanena	rˈeu.nɑ.ne.n>ɑ
Ridanpää+N+Prop+Ess	Ridanpään	rˈi.dɑːn#phˌæ.æ>n
Ridanpää+N+Prop+Der/laš+A+AttrCmp+Der/vuđot+A+Der/vuohta+N+Sg+Ill	Ridanpäälašvuđotvuhtii	rˈi.dɑːn#phˌæ.æ>.lɑʃ»vˌu.ðoh»vˌuh.tij
Riepponen+N+Prop+Sem/Sur+Pl+Loc	Riepposiin	rˈĭep.po>.sijn
Rimpinen+N+Prop+Sem/Sur+Ess	Rimpisin	rˈimː.m̥pi>.sin
Rissanen+N+Prop+Sem/Sur+Pl+Ill	Rissasiidda	rˈisː.sɑː>.sijt.tɑ
Rissanen+N+Prop+Sem/Sur+Sg+Acc	Rissanena	rˈisː.sɑː.ne.n>ɑ
Riuttanen+N+Prop+Sem/Sur+Pl+Nom	Riuttasat	rˈi.ut.tɑ>.sɑh
Riuttanen+N+Prop+Sem/Sur+Pl+Nom	Riuttanenat	rˈi.ut.tˌɑ.ne.n>ɑh
Roikonen+N+Prop+Sem/Sur+Sg+Com	Roikosiin	rˈojː.çko>.sijn
Roivainen+N+Prop+Sem/Sur+Pl+Nom	Roivainenat	rˈojː.vɑːj.ne.n>ɑh
Rokkanen+N+Prop+Sem/Sur+Pl+Nom	Rokkasat	rˈokː.kɑː>.sɑh
Rossinen+N+Prop+Sem/Sur+Sg+Ill	Rossisii	rˈos.si>.sij
Rouvinen+N+Prop+Sem/Sur+Pl+Com	Rouvisiiguin	rˈou.vi>.sij.gujn
Rouvinen+N+Prop+Sem/Sur+Pl+Ill	Rouvineniidda	rˈou.vi.ne.n>ijt.tɑ
Ruhanen+N+Prop+Sem/Sur+Pl+Gen	Ruhasiid	rˈu.hɑː>.sijh
Ruhanen+N+Prop+Sem/Sur+Sg+Acc	Ruhanen	rˈu.hɑː.nen>
Ruokanen+N+Prop+Sem/Sur+Sg+Com	Ruokasiin	rˈuo.kɑ>.sijn
Rupponen+N+Prop+Sem/Sur+Pl+Nom	Rupponenat	rˈup.po.ne.n>ɑh
Rusanen+N+Prop+Sem/Sur+Pl+Nom	Rusasat	rˈu.sɑː>.sɑh
Rusanen+N+Prop+Sem/Sur+Pl+Nom	Rusanenat	rˈu.sɑː.ne.n>ɑh
Rutanen+N+Prop+Sem/Sur+Ess	Rutasin	rˈu.tɑː>.sin
Rutanen+N+Prop+Sem/Sur+Sg+Gen	Rutasa	rˈu.tɑː>.sɑ
Rutanen+N+Prop+Sem/Sur+Ess	Rutanenin	rˈu.tɑː.ne.n>in
Ruusumaa+N+Prop+Sem/Sur+Ess	Ruusumaan	rˈu.u.su#mˌɑ.ɑ>n
Ryhänen+N+Prop+Sem/Sur+Ess	Ryhäsin	rˈy.hæ>.sin
Ryhänen+N+Prop+Sem/Sur+Pl+Nom	Ryhäsat	rˈy.hæ>.sɑh
Ryhänen+N+Prop+Sem/Sur+Sg+Ill	Ryhänenii	rˈy.hæ.ne.n>ij
Rytkönen+N+Prop+Sem/Sur+Pl+Gen	Rytkösiid	rˈytː.hkø>.sijh
Rytkönen+N+Prop+Sem/Sur+Sg+Gen	Rytkösa	rˈytː.hkø>.sɑ
Ryynänen+N+Prop+Sem/Sur+Pl+Com	Ryynäsiiguin	rˈy.y.næ>.sij.gujn
Ryynänen+N+Prop+Sem/Sur+Sg+Ill	Ryynänenii	rˈy.y.nˌæ.ne.n>ij
Räisänen+N+Prop+Sem/Sur+Pl+Com	Räisäneniiguin	rˈæjː.sæ.ne.n>ij.gujn
Räisänen+N+Prop+Sem/Sur+Sg+Com	Räisäneniin	rˈæjː.sæ.ne.n>ijn
Räkköläinen+N+Prop+Sem/Sur+Ess	Räkköläinenin	rˈæk.kø.lˌæj.ne.n>in
Räkköläinen+N+Prop+Sem/Sur+Sg+Com	Räkköläineniin	rˈæk.kø.lˌæj.ne.n>ijn
Rämänen+N+Prop+Sem/Sur+Sg+Ill	Rämäsii	rˈæ.mæ>.sij
Rämänen+N+Prop+Sem/Sur+Sg+Ill	Rämänenii	rˈæ.mæ.ne.n>ij
Räsänen+N+Prop+Sem/Sur+Sg+Com	Räsäneniin	rˈæ.sæ.ne.n>ijn
Rönkkönen+N+Prop+Sem/Sur+Ess	Rönkkösin	rˈøŋŋ̊.kø>.sin
Rönkkönen+N+Prop+Sem/Sur+Sg+Ill	Rönkkönenii	rˈøŋŋ̊.kø.ne.n>ij
Röntynen+N+Prop+Sem/Sur+Pl+Nom	Röntysat	rˈønː.n̥ty>.sɑh
Röntynen+N+Prop+Sem/Sur+Pl+Com	Röntyneniiguin	rˈønː.n̥ty.ne.n>ij.gujn
Röpelinen+N+Prop+Sem/Sur+Sg+Acc	Röpelinen	rˈø.pe.lˌi.nen>
Röppänen+N+Prop+Sem/Sur+Sg+Gen	Röppäsa	rˈøp.pæ>.sɑ
Röppänen+N+Prop+Sem/Sur+Sg+Com	Röppäsiin	rˈøp.pæ>.sijn
Saarivuoma+N+Prop+Sg+Nom	Saarivuoma	sˈɑ.ɑ.ri#vˌuo.mɑ>
Saharinen+N+Prop+Sem/Sur+Pl+Nom	Saharisat	sˈɑ.hɑː.ri>.sɑh
Santanen+N+Prop+Sem/Sur+Pl+Nom	Santasat	sˈɑnː.n̥tɑ>.sɑh
Santonen+N+Prop+Sem/Sur+Pl+Com	Santosiiguin	sˈɑnː.n̥to>.sij.gujn
Sappinen+N+Prop+Sem/Sur+Pl+Com	Sappineniiguin	sˈɑp.pi.ne.n>ij.gujn
Sarjanen+N+Prop+Sem/Sur+Pl+Gen	Sarjaneniid	sˈɑrə.jɑ.ne.n>ijh
Seilonen+N+Prop+Sem/Sur+Pl+Loc	Seilosiin	sˈejː.lo>.sijn
Seilonen+N+Prop+Sem/Sur+Sg+Com	Seiloneniin	sˈejː.lo.ne.n>ijn
Seppäläinen+N+Prop+Sem/Sur+Ess	Seppäläisin	sˈep.pæ.læj>.sin
Seppäläinen+N+Prop+Sem/Sur+Sg+Nom	Seppäläinen	sˈep.pæ.lˌæj.nen>
Seuranen+N+Prop+Sem/Sur+Sg+Acc	Seuranen	sˈeu.rɑ.nen>
Seuranen+N+Prop+Sem/Sur+Sg+Nom	Seuranen	sˈeu.rɑ.nen>
Siekkinen+N+Prop+Sem/Sur+Pl+Loc	Siekkineniin	sˈiek.ki.ne.n>ijn
Sihvonen+N+Prop+Sem/Sur+Pl+Com	Sihvosiiguin	sˈih.vo>.sij.gujn
Sikanen+N+Prop+Sem/Sur+Ess	Sikasin	sˈi.kɑː>.sin
Simanainen+N+Prop+Sem/Sur+Ess	Simanaisin	sˈi.mɑː.nɑj>.sin
Simanainen+N+Prop+Sem/Sur+Pl+Nom	Simanaisat	sˈi.mɑː.nɑj>.sɑh
Simanainen+N+Prop+Sem/Sur+Pl+Nom	Simanainenat	sˈi.mɑː.nˌɑj.ne.n>ɑh
Sipponen+N+Prop+Sem/Sur+Pl+Nom	Sipponenat	sˈip.po.ne.n>ɑh
Sipponen+N+Prop+Sem/Sur+Sg+Gen+Allegro	Sipponen	sˈip.po.nen>
Sironen+N+Prop+Sem/Sur+Pl+Gen	Sirosiid	sˈi.ro>.sijh
Sissonen+N+Prop+Sem/Sur+Ess	Sissonenin	sˈis.so.ne.n>in
Sistonen+N+Prop+Sem/Sur+Pl+Loc	Sistosiin	sˈisː.to>.sijn
Siukonen+N+Prop+Sem/Sur+Pl+Acc	Siukosiid	sˈi.u.ko>.sijh
Sohkanen+N+Prop+Sem/Sur+Pl+Nom	Sohkasat	sˈohː.kɑː>.sɑh
Sohkanen+N+Prop+Sem/Sur+Ess	Sohkanenin	sˈohː.kɑː.ne.n>in
Soininen+N+Prop+Sem/Sur+Ess	Soinisin	sˈoj.ni>.sin
Solonen+N+Prop+Sem/Sur+Sg+Loc	Solosis	sˈo.lo>.sis
Sopanen+N+Prop+Sem/Sur+Pl+Nom	Sopasat	sˈo.pɑː>.sɑh
Sorjonen+N+Prop+Sem/Sur+Pl+Nom	Sorjonenat	sˈorə.jo.ne.n>ɑh
Sormunen+N+Prop+Sem/Sur+Pl+Com	Sormusiiguin	sˈor.mu>.sij.gujn
Sormunen+N+Prop+Sem/Sur+Pl+Ill	Sormuneniidda	sˈor.mu.ne.n>ijt.tɑ
Sulonen+N+Prop+Sem/Sur+Pl+Com	Sulosiiguin	sˈu.lo>.sij.gujn
Sulonen+N+Prop+Sem/Sur+Pl+Gen	Suloneniid	sˈu.lo.ne.n>ijh
Summanen+N+Prop+Sem/Sur+Sg+Gen	Summasa	sˈumː.mɑː>.sɑ
Sutelainen+N+Prop+Sem/Sur+Sg+Acc	Sutelainen	sˈu.te.lˌɑj.nen>
Sutinen+N+Prop+Sem/Sur+Sg+Com	Sutisiin	sˈu.ti>.sijn
Sutinen+N+Prop+Sem/Sur+Sg+Ill	Sutisii	sˈu.ti>.sij
Syrjäläinen+N+Prop+Sem/Sur+Sg+Loc	Syrjäläisis	sˈyrə.jæ.læj>.sis
Syrjäläinen+N+Prop+Sem/Sur+Pl+Gen	Syrjäläineniid	sˈyrə.jæ.lˌæj.ne.n>ijh
Syrjänen+N+Prop+Sem/Sur+Pl+Acc	Syrjäsiid	sˈyrə.jæ>.sijh
Syrjänen+N+Prop+Sem/Sur+Pl+Nom	Syrjänenat	sˈyrə.jæ.ne.n>ɑh
Sysmäläinen+N+Prop+Sem/Sur+Sg+Loc	Sysmäläisis	sˈysː.mæ.læj>.sis
Sysmäläinen+N+Prop+Sem/Sur+Ess	Sysmäläinenin	sˈysː.mæ.lˌæj.ne.n>in
Sysmäläinen+N+Prop+Sem/Sur+Sg+Nom	Sysmäläinen	sˈysː.mæ.lˌæj.nen>
Sysmäläinen+N+Prop+Sem/Sur+Sg+Loc	Sysmäläinenis	sˈysː.mæ.lˌæj.ne.n>is
Syvänen+N+Prop+Sem/Sur+Sg+Ill	Syväsii	sˈy.væ>.sij
Säkkinen+N+Prop+Sem/Sur+Ess	Säkkisin	sˈæk.ki>.sin
Säkkinen+N+Prop+Sem/Sur+Pl+Nom	Säkkisat	sˈæk.ki>.sɑh
Säkkinen+N+Prop+Sem/Sur+Sg+Gen	Säkkinena	sˈæk.ki.ne.n>ɑ
Sällinen+N+Prop+Sem/Sur+Ess	Sällisin	sˈæl.li>.sin
Sällinen+N+Prop+Sem/Sur+Sg+Ill	Sällisii	sˈæl.li>.sij
Särkinen+N+Prop+Der/laš+A+Sg+Nom+PxDu2	Särkilažžade	sˈærə.hki.lˌɑdː.tʃɑ.de
Säämänen+N+Prop+Sem/Sur+Ess	Säämänenin	sˈæ.æ.mˌæ.ne.n>in
Säämänen+N+Prop+Sem/Sur+Sg+Ill	Säämänenii	sˈæ.æ.mˌæ.ne.n>ij
Sääski+N+Prop+Sem/Sur+Ess	Sääskin	sˈæ.æs.ki>n
Sääskilahti+N+Prop+Sem/Sur+Sg+Gen	Sääskilahti	sˈæ.æs.ki#lˌɑh.ti>
Sääskilahti+N+Prop+Sem/Sur+Sg+Ill	Sääskilahtii	sˈæ.æs.ki#lˌɑh.ti>i
Taavitsainen+N+Prop+Sem/Sur+Pl+Loc	Taavitsaisiin	thˈɑ.ɑ.vˌit.sɑj>.sijn
Talonen+N+Prop+Sem/Sur+Pl+Nom	Talosat	thˈɑ.lo>.sɑh
Talvinen+N+Prop+Sem/Sur+Pl+Nom	Talvinenat	thˈɑlə.vi.ne.n>ɑh
Tammivuori+N+Prop+Sem/Sur+Pl+Nom	Tammivuorit	thˈɑm.mi#vˌuo.ri>h
Tanhuanpää+N+Prop+Sg+Loc	Tanhuanpääs	thˈɑn.hu.ɑn#phˌæ.æ>s
Taskinen+N+Prop+Sem/Sur+Sg+Com	Taskisiin	thˈɑsː.ki>.sijn
Temonen+N+Prop+Sem/Sur+Sg+Ill	Temonenii	thˈe.mo.ne.n>ij
Tenkanen+N+Prop+Sem/Sur+Sg+Nom	Tenkanen	thˈeŋŋ.ŋ̊kɑ.nen>
Tepponen+N+Prop+Sem/Sur+Sg+Gen	Tepposa	thˈep.po>.sɑ
Tepponen+N+Prop+Sem/Sur+Pl+Nom	Tepponenat	thˈep.po.ne.n>ɑh
Termonen+N+Prop+Sem/Sur+Ess	Termosin	thˈer.mo>.sin
Teräväinen+N+Prop+Sem/Sur+Sg+Com	Teräväineniin	thˈe.ræ.vˌæj.ne.n>ijn
Tihinen+N+Prop+Sem/Sur+Sg+Loc	Tihisis	thˈi.hi>.sis
Tikkinen+N+Prop+Sem/Sur+Pl+Nom	Tikkinenat	thˈik.ki.ne.n>ɑh
Timoskainen+N+Prop+Sem/Sur+Pl+Acc	Timoskaisiid	thˈiː.mos.kɑj>.sijh
Tirronen+N+Prop+Sem/Sur+Sg+Acc	Tirrosa	thˈir.ro>.sɑ
Tolvanen+N+Prop+Sem/Sur+Sg+Gen	Tolvasa	thˈolə.vɑ>.sɑ
Tomminen+N+Prop+Sem/Sur+Sg+Loc	Tommisis	thˈom.mi>.sis
Toppinen+N+Prop+Sem/Sur+Pl+Nom	Toppisat	thˈop.pi>.sɑh
Toppinen+N+Prop+Sem/Sur+Sg+Loc	Toppinenis	thˈop.pi.ne.n>is
Torvinen+N+Prop+Sem/Sur+Sg+Gen	Torvisa	thˈorə.vi>.sɑ
Toukonen+N+Prop+Sem/Sur+Sg+Nom	Toukonen	thˈou.ko.nen>
Tourunen+N+Prop+Sem/Sur+Pl+Com	Touruneniiguin	thˈou.ru.ne.n>ij.gujn
Truhponen+N+Prop+Sem/Sur+Sg+Loc	Truhposis	trˈuh.po>.sis
Truhponen+N+Prop+Sem/Sur+Ess	Truhponenin	trˈuh.po.ne.n>in
Truhponen+N+Prop+Sem/Sur+Pl+Acc	Truhponeniid	trˈuh.po.ne.n>ijh
Truhponen+N+Prop+Sem/Sur+Sg+Ill	Truhponenii	trˈuh.po.ne.n>ij
Tsutsunen+N+Prop+Sem/Sur+Pl+Nom	Tsutsusat	tsˈut.su>.sɑh
Tsutsunen+N+Prop+Sem/Sur+Pl+Nom	Tsutsunenat	tsˈut.su.ne.n>ɑh
Tsutsunen+N+Prop+Sem/Sur+Pl+Acc	Tsutsuneniid	tsˈut.su.ne.n>ijh
Tsutsunen+N+Prop+Sem/Sur+Sg+Acc	Tsutsunena	tsˈut.su.ne.n>ɑ
Tsutsunen+N+Prop+Sem/Sur+Sg+Com	Tsutsuneniin	tsˈut.su.ne.n>ijn
Tsutsunen+N+Prop+Sem/Sur+Sg+Ill	Tsutsunenii	tsˈut.su.ne.n>ij
Tuhkanen+N+Prop+Sem/Sur+Pl+Nom	Tuhkasat	thˈuhː.kɑː>.sɑh
Tuikkanen+N+Prop+Sem/Sur+Sg+Loc	Tuikkanenis	thˈujçç.kɑː.ne.n>is
Tuppurainen+N+Prop+Sem/Sur+Sg+Acc	Tuppurainen	thˈup.pu.rˌɑj.nen>
Tykkyläinen+N+Prop+Sem/Sur+Ess	Tykkyläinenin	thˈyk.ky.lˌæj.ne.n>in
Tykkyläinen+N+Prop+Sem/Sur+Pl+Nom	Tykkyläinenat	thˈyk.ky.lˌæj.ne.n>ɑh
Tykkyläinen+N+Prop+Sem/Sur+Sg+Ill	Tykkyläinenii	thˈyk.ky.lˌæj.ne.n>ij
Tyllinen+N+Prop+Sem/Sur+Pl+Ill	Tyllisiidda	thˈyl.li>.sijt.tɑ
Tyllinen+N+Prop+Sem/Sur+Sg+Nom	Tyllinen	thˈyl.li.nen>
Tynninen+N+Prop+Sem/Sur+Sg+Ill	Tynnisii	thˈyn.ni>.sij
Tyrväinen+N+Prop+Sem/Sur+Pl+Nom	Tyrväisat	thˈyrə.væj>.sɑh
Tyrväinen+N+Prop+Sem/Sur+Sg+Loc	Tyrväinenis	thˈyrə.væj.ne.n>is
Tähkänen+N+Prop+Sem/Sur+Sg+Gen+Allegro	Tähkänen	thˈæh.kæ.nen>
Tähkänen+N+Prop+Sem/Sur+Sg+Nom	Tähkänen	thˈæh.kæ.nen>
Tähkäpää+N+Prop+Sg+Loc	Tähkäpääs	thˈæh.kæ#phˌæ.æ>s
Tähkäpää+N+Prop+Der/laš+A+Sg+Loc+PxSg2	Tähkäpäälaččastat	thˈæh.kæ#phˌæ.æ>.lɑt.tʃɑs.tɑh
Tähkäpää+N+Prop+Der/laš+A+Sg+Nom	Tähkäpäälaš	thˈæh.kæ#phˌæ.æ>.lɑʃ
Tähkäpää+N+Prop+Der/laš+A+Sg+Ill+PxSg1	Tähkäpäälažžasan	thˈæh.kæ#phˌæ.æ>.lɑdː.tʃɑ.sɑn
Tähkäpää+N+Prop+Der/laš+A+Sg+Ill	Tähkäpäälažžii	thˈæh.kæ#phˌæ.æ>.lɑdː.tʃij
Tähtinen+N+Prop+Sem/Sur+Pl+Nom	Tähtisat	thˈæh.ti>.sɑh
Tähtinen+N+Prop+Sem/Sur+Pl+Com	Tähtisiiguin	thˈæh.ti>.sij.gujn
Tähtinen+N+Prop+Sem/Sur+Sg+Com	Tähtisiin	thˈæh.ti>.sijn
Töhönen+N+Prop+Sem/Sur+Sg+Acc	Töhösa	thˈø.hø>.sɑ
Töhönen+N+Prop+Sem/Sur+Sg+Ill	Töhönenii	thˈø.hø.ne.n>ij
Törhönen+N+Prop+Sem/Sur+Pl+Nom	Törhönenat	thˈør.hø.ne.n>ɑh
Törönen+N+Prop+Sem/Sur+Pl+Acc	Törösiid	thˈø.rø>.sijh
Uimonen+N+Prop+Sem/Sur+Ess	Uimosin	ˈuj.mo>.sin
Uimonen+N+Prop+Sem/Sur+Pl+Loc	Uimosiin	ˈuj.mo>.sijn
Uimonen+N+Prop+Sem/Sur+Sg+Acc	Uimosa	ˈuj.mo>.sɑ
Uimonen+N+Prop+Sem/Sur+Sg+Ill	Uimosii	ˈuj.mo>.sij
Uimonen+N+Prop+Sem/Sur+Ess	Uimonenin	ˈuj.mo.ne.n>in
Uimonen+N+Prop+Sem/Sur+Pl+Nom	Uimonenat	ˈuj.mo.ne.n>ɑh
Ukkonen+N+Prop+Sem/Sur+Ess	Ukkosin	ˈuk.ko>.sin
Ukkonen+N+Prop+Sem/Sur+Sg+Gen	Ukkosa	ˈuk.ko>.sɑ
Ukkonen+N+Prop+Sem/Sur+Sg+Com	Ukkosiin	ˈuk.ko>.sijn
Ukkonen+N+Prop+Sem/Sur+Ess	Ukkonenin	ˈuk.ko.ne.n>in
Ukkonen+N+Prop+Sem/Sur+Pl+Loc	Ukkoneniin	ˈuk.ko.ne.n>ijn
Ukkonen+N+Prop+Sem/Sur+Sg+Loc	Ukkonenis	ˈuk.ko.ne.n>is
Ullmanen+N+Prop+Sem/Sur+Pl+Nom	Ullmasat	ˈulː.mɑː>.sɑh
Ullmanen+N+Prop+Sem/Sur+Pl+Com	Ullmasiiguin	ˈulː.mɑː>.sij.gujn
Ullmanen+N+Prop+Sem/Sur+Pl+Gen	Ullmasiid	ˈulː.mɑː>.sijh
Ullmanen+N+Prop+Sem/Sur+Sg+Loc	Ullmasis	ˈulː.mɑː>.sis
Ullmanen+N+Prop+Sem/Sur+Ess	Ullmanenin	ˈulː.mɑː.ne.n>in
Ullmanen+N+Prop+Sem/Sur+Pl+Nom	Ullmanenat	ˈulː.mɑː.ne.n>ɑh
Untinen+N+Prop+Sem/Sur+Ess	Untinenin	ˈunː.n̥ti.ne.n>in
Untinen+N+Prop+Sem/Sur+Pl+Nom	Untinenat	ˈunː.n̥ti.ne.n>ɑh
Untinen+N+Prop+Sem/Sur+Pl+Ill	Untineniidda	ˈunː.n̥ti.ne.n>ijt.tɑ
Untinen+N+Prop+Sem/Sur+Sg+Acc	Untinen	ˈunː.n̥ti.nen>
Untinen+N+Prop+Sem/Sur+Sg+Ill	Untinenii	ˈunː.n̥ti.ne.n>ij
Untinen+N+Prop+Sem/Sur+Sg+Loc	Untinenis	ˈunː.n̥ti.ne.n>is
Uosukainen+N+Prop+Sem/Sur+Sg+Acc	Uosukaisa	ˈuo.su.kɑj>.sɑ
Uosukainen+N+Prop+Sem/Sur+Sg+Gen	Uosukaisa	ˈuo.su.kɑj>.sɑ
Uosukainen+N+Prop+Sem/Sur+Pl+Acc	Uosukaineniid	ˈuo.su.kˌɑj.ne.n>ijh
Uosukainen+N+Prop+Sem/Sur+Sg+Acc	Uosukainena	ˈuo.su.kˌɑj.ne.n>ɑ
Uotinen+N+Prop+Sem/Sur+Pl+Nom	Uotisat	ˈuo.ti>.sɑh
Uotinen+N+Prop+Sem/Sur+Sg+Loc	Uotisis	ˈuo.ti>.sis
Uotinen+N+Prop+Sem/Sur+Sg+Nom	Uotinen	ˈuo.ti.nen>
Urhonen+N+Prop+Sem/Sur+Pl+Ill	Urhosiidda	ˈur.ho>.sijt.tɑ
Urhonen+N+Prop+Sem/Sur+Pl+Nom	Urhonenat	ˈur.ho.ne.n>ɑh
Uronen+N+Prop+Sem/Sur+Ess	Urosin	ˈu.ro>.sin
Uronen+N+Prop+Sem/Sur+Pl+Nom	Urosat	ˈu.ro>.sɑh
Uronen+N+Prop+Sem/Sur+Sg+Acc	Uronena	ˈu.ro.ne.n>ɑ
Urpalainen+N+Prop+Sem/Sur+Pl+Nom	Urpalainenat	ˈurə.hpɑ.lˌɑj.ne.n>ɑh
Utriainen+N+Prop+Sem/Sur+Ess	Utriainenin	ˈut.ri.ˌɑj.ne.n>in
Utriainen+N+Prop+Sem/Sur+Pl+Nom	Utriainenat	ˈut.ri.ˌɑj.ne.n>ɑh
Utriainen+N+Prop+Sem/Sur+Pl+Acc	Utriaineniid	ˈut.ri.ˌɑj.ne.n>ijh
Utriainen+N+Prop+Sem/Sur+Sg+Gen+Allegro	Utriainen	ˈut.ri.ˌɑj.nen>
Utriainen+N+Prop+Sem/Sur+Sg+Loc	Utriainenis	ˈut.ri.ˌɑj.ne.n>is
Utunen+N+Prop+Sem/Sur+Pl+Nom	Utusat	ˈu.tu>.sɑh
Utunen+N+Prop+Sem/Sur+Pl+Acc	Utusiid	ˈu.tu>.sijh
Utunen+N+Prop+Sem/Sur+Pl+Gen	Utusiid	ˈu.tu>.sijh
Utunen+N+Prop+Sem/Sur+Sg+Acc	Utusa	ˈu.tu>.sɑ
Utunen+N+Prop+Sem/Sur+Sg+Ill	Utusii	ˈu.tu>.sij
Utunen+N+Prop+Sem/Sur+Sg+Loc	Utusis	ˈu.tu>.sis
Utunen+N+Prop+Sem/Sur+Ess	Utunenin	ˈu.tu.ne.n>in
Utunen+N+Prop+Sem/Sur+Sg+Gen	Utunena	ˈu.tu.ne.n>ɑ
Uuksulainen+N+Prop+Sem/Sur+Ess	Uuksulaisin	ˈuːkː.su.lɑj>.sin
Uuksulainen+N+Prop+Sem/Sur+Pl+Gen	Uuksulaisiid	ˈuːkː.su.lɑj>.sijh
Uuksulainen+N+Prop+Sem/Sur+Pl+Nom	Uuksulainenat	ˈuːkː.su.lˌɑj.ne.n>ɑh
Uuksulainen+N+Prop+Sem/Sur+Sg+Acc	Uuksulainen	ˈuːkː.su.lˌɑj.nen>
Uuksulainen+N+Prop+Sem/Sur+Sg+Gen+Allegro	Uuksulainen	ˈuːkː.su.lˌɑj.nen>
Uuksulainen+N+Prop+Sem/Sur+Sg+Acc	Uuksulainena	ˈuːkː.su.lˌɑj.ne.n>ɑ
Uutinen+N+Prop+Sem/Sur+Ess	Uutisin	ˈuː.ti>.sin
Uutinen+N+Prop+Sem/Sur+Sg+Com	Uutisiin	ˈuː.ti>.sijn
Vahvanen+N+Prop+Sem/Sur+Sg+Loc	Vahvasis	vˈɑh.vɑː>.sis
Vakkilainen+N+Prop+Sem/Sur+Sg+Gen	Vakkilainena	vˈɑk.ki.lˌɑj.ne.n>ɑ
Vakkilainen+N+Prop+Sem/Sur+Sg+Com	Vakkilaineniin	vˈɑk.ki.lˌɑj.ne.n>ijn
Valkonen+N+Prop+Sem/Sur+Sg+Nom	Valkonen	vˈɑlə.hko.nen>
Vasarainen+N+Prop+Der/laš+A+Sg+Nom+PxSg2	Vasarailažžat	vˈɑ.sɑː.rˌɑjː.lɑdː.tʃɑh
Vaskelainen+N+Prop+Sem/Sur+Sg+Gen	Vaskelainena	vˈɑsː.ke.lˌɑj.ne.n>ɑ
Vaskelainen+N+Prop+Sem/Sur+Sg+Ill	Vaskelainenii	vˈɑsː.ke.lˌɑj.ne.n>ij
Vedenpää+N+Prop+Sg+Nom	Vedenpää	vˈeː.den#phˌæ.æ>
Vehviläinen+N+Prop+Sem/Sur+Sg+Gen	Vehviläisa	vˈeh.vi.læj>.sɑ
Vellonen+N+Prop+Sem/Sur+Pl+Nom	Vellonenat	vˈel.lo.ne.n>ɑh
Venäläinen+N+Prop+Sem/Sur+Ess	Venäläisin	vˈe.næ.læj>.sin
Vertanen+N+Prop+Sem/Sur+Ess	Vertasin	vˈerə.htɑ>.sin
Vesterinen+N+Prop+Sem/Sur+Ess	Vesterisin	vˈesː.te.ri>.sin
Vesterinen+N+Prop+Sem/Sur+Sg+Gen+Allegro	Vesterinen	vˈesː.te.rˌi.nen>
Veteläinen+N+Prop+Sem/Sur+Sg+Ill	Veteläisii	vˈe.te.læj>.sij
Vienonen+N+Prop+Sem/Sur+Sg+Gen	Vienosa	vˈĭe.no>.sɑ
Viinikainen+N+Prop+Sem/Sur+Pl+Ill	Viinikaisiidda	vˈij.ni.kɑj>.sijt.tɑ
Viitanen+N+Prop+Sem/Sur+Sg+Com	Viitaneniin	vˈijː.çtɑ.ne.n>ijn
Villanen+N+Prop+Sem/Sur+Ess	Villasin	vˈilː.lɑː>.sin
Vilokkinen+N+Prop+Sem/Sur+Ess	Vilokkisin	vˈiː.lok.ki>.sin
Vitikainen+N+Prop+Sem/Sur+Pl+Nom	Vitikaisat	vˈi.ti.kɑj>.sɑh
Vitikainen+N+Prop+Sem/Sur+Pl+Nom	Vitikainenat	vˈi.ti.kˌɑj.ne.n>ɑh
Volanen+N+Prop+Sem/Sur+Pl+Loc	Volaneniin	vˈo.lɑː.ne.n>ijn
Volotinen+N+Prop+Sem/Sur+Sg+Gen+Allegro	Volotinen	vˈo.lo.tˌi.nen>
Vornanen+N+Prop+Sem/Sur+Ess	Vornasin	vˈor.nɑː>.sin
Vottonen+N+Prop+Sem/Sur+Sg+Gen	Vottonena	vˈot.to.ne.n>ɑ
Vottonen+N+Prop+Sem/Sur+Sg+Loc	Vottonenis	vˈot.to.ne.n>is
Voutilainen+N+Prop+Sem/Sur+Sg+Acc	Voutilaisa	vˈou.ti.lɑj>.sɑ
Vuohelainen+N+Prop+Sem/Sur+Ess	Vuohelainenin	vˈŭo.he.lˌɑj.ne.n>in
Vuohelainen+N+Prop+Sem/Sur+Pl+Nom	Vuohelainenat	vˈŭo.he.lˌɑj.ne.n>ɑh
Vuokko+N+Prop+Sem/Fem+Sg+Gen	Vuokko	vˈŭok.ko>
Vuokko+N+Prop+Sem/Fem+Der/Dimin+Sg+Nom	Vuokkoš	vˈŭok.ko>ʃ
Vuorelainen+N+Prop+Sem/Sur+Ess	Vuorelaisin	vˈŭo.re.lɑj>.sin
Vuoskäive+N+Prop+Sg+Com	Vuoskäiviin	vˈŭosː.kæj.vi>in
Vuotso+N+Prop+Sg+Nom	Vuotso	vˈŭot.so>
Vyyryläinen+N+Prop+Sem/Sur+Ess	Vyyryläisin	vˈy.y.rˌy.læj>.sin
Vyyryläinen+N+Prop+Sem/Sur+Pl+Loc	Vyyryläisiin	vˈy.y.rˌy.læj>.sijn
Vyyryläinen+N+Prop+Sem/Sur+Sg+Gen	Vyyryläisa	vˈy.y.rˌy.læj>.sɑ
Vyyryläinen+N+Prop+Sem/Sur+Ess	Vyyryläinenin	vˈy.y.rˌy.læj.ne.n>in
Vyyryläinen+N+Prop+Sem/Sur+Sg+Gen+Allegro	Vyyryläinen	vˈy.y.rˌy.læj.nen>
Vyyryläinen+N+Prop+Sem/Sur+Sg+Loc	Vyyryläinenis	vˈy.y.rˌy.læj.ne.n>is
Vähänen+N+Prop+Sem/Sur+Sg+Acc	Vähäsa	vˈæ.hæ>.sɑ
Vähänen+N+Prop+Sem/Sur+Pl+Ill	Vähäneniidda	vˈæ.hæ.ne.n>ijt.tɑ
Väisänen+N+Prop+Sem/Sur+Sg+Acc	Väisänena	vˈæjː.sæ.ne.n>ɑ
Väkeväinen+N+Prop+Sem/Sur+Sg+Ill	Väkeväinenii	vˈæ.ke.vˌæj.ne.n>ij
Välinen+N+Prop+Sem/Sur+Sg+Com	Välisiin	vˈæ.li>.sijn
Vänttinen+N+Prop+Sem/Sur+Sg+Loc	Vänttisis	vˈænn̥.ti>.sis
Vänttinen+N+Prop+Sem/Sur+Sg+Gen	Vänttinena	vˈænn̥.ti.ne.n>ɑ
Värtinen+N+Prop+Sem/Sur+Pl+Nom	Värtisat	vˈærə.hti>.sɑh
Värtinen+N+Prop+Sem/Sur+Pl+Nom	Värtinenat	vˈærə.hti.ne.n>ɑh
Vääränen+N+Prop+Sem/Sur+Sg+Gen	Vääränena	vˈæ.æ.rˌæ.ne.n>ɑ
Walkeapää+N+Prop+Sem/Sur+Ess	Walkeapään	βˈɑlə.hkeæ#phˌæ.æ>n
Walkeapää+N+Prop+Sem/Sur+Pl+Acc	Walkeapääid	βˈɑlə.hkeæ#phˌæ.æ>id
Walkeapää+N+Prop+Sem/Sur+Pl+Com	Walkeapääiguin	βˈɑlə.hkeæ#phˌæ.æ>i.gujn
Walkeapää+N+Prop+Sem/Sur+Pl+Ill	Walkeapääide	βˈɑlə.hkeæ#phˌæ.æ>i.de
Walkeapää+N+Prop+Sem/Sur+Pl+Loc	Walkeapääin	βˈɑlə.hkeæ#phˌæ.æ>in
Walkeapää+N+Prop+Sem/Sur+Pl+Nom	Walkeapäät	βˈɑlə.hkeæ#phˌæ.æ>h
Walkeapää+N+Prop+Sem/Sur+Sg+Acc	Walkeapää	βˈɑlə.hkeæ#phˌæ.æ>
Walkeapää+N+Prop+Sem/Sur+Sg+Gen	Walkeapää	βˈɑlə.hkeæ#phˌæ.æ>
Walkeapää+N+Prop+Sem/Sur+Sg+Nom	Walkeapää	βˈɑlə.hkeæ#phˌæ.æ>
Walkeapää+N+Prop+Sem/Sur+Sg+Com	Walkeapääin	βˈɑlə.hkeæ#phˌæ.æ>in
Walkeapää+N+Prop+Sem/Sur+Sg+Ill	Walkeapääi	βˈɑlə.hkeæ#phˌæ.æ>i
Walkeapää+N+Prop+Sem/Sur+Sg+Loc	Walkeapääs	βˈɑlə.hkeæ#phˌæ.æ>s
Wirtanen+N+Prop+Sem/Sur+Ess	Wirtasin	βˈirə.htɑ>.sin
Wirtanen+N+Prop+Sem/Sur+Pl+Nom	Wirtasat	βˈirə.htɑ>.sɑh
Wirtanen+N+Prop+Sem/Sur+Pl+Acc	Wirtasiid	βˈirə.htɑ>.sijh
Wirtanen+N+Prop+Sem/Sur+Pl+Gen	Wirtasiid	βˈirə.htɑ>.sijh
Wirtanen+N+Prop+Sem/Sur+Pl+Ill	Wirtasiidda	βˈirə.htɑ>.sijt.tɑ
Wirtanen+N+Prop+Sem/Sur+Pl+Loc	Wirtasiin	βˈirə.htɑ>.sijn
Wirtanen+N+Prop+Sem/Sur+Sg+Acc	Wirtasa	βˈirə.htɑ>.sɑ
Wirtanen+N+Prop+Sem/Sur+Sg+Gen	Wirtasa	βˈirə.htɑ>.sɑ
Wirtanen+N+Prop+Sem/Sur+Sg+Ill	Wirtasii	βˈirə.htɑ>.sij
Wirtanen+N+Prop+Sem/Sur+Sg+Loc	Wirtasis	βˈirə.htɑ>.sis
Wirtanen+N+Prop+Sem/Sur+Ess	Wirtanenin	βˈirə.htɑ.ne.n>in
Wirtanen+N+Prop+Sem/Sur+Pl+Com	Wirtaneniiguin	βˈirə.htɑ.ne.n>ij.gujn
Wirtanen+N+Prop+Sem/Sur+Pl+Ill	Wirtaneniidda	βˈirə.htɑ.ne.n>ijt.tɑ
Wirtanen+N+Prop+Sem/Sur+Pl+Loc	Wirtaneniin	βˈirə.htɑ.ne.n>ijn
Wirtanen+N+Prop+Sem/Sur+Sg+Gen	Wirtanena	βˈirə.htɑ.ne.n>ɑ
Yletyinen+N+Prop+Sem/Sur+Ess	Yletyisin	ˈy.le.tyj>.sin
Yletyinen+N+Prop+Sem/Sur+Sg+Acc	Yletyinen	ˈy.le.tˌyj.nen>
Yletyinen+N+Prop+Sem/Sur+Sg+Gen+Allegro	Yletyinen	ˈy.le.tˌyj.nen>
Yletyinen+N+Prop+Sem/Sur+Sg+Acc	Yletyinena	ˈy.le.tˌyj.ne.n>ɑ
Ylhäinen+N+Prop+Ess	Ylhäisin	ˈylə.hæj>.sin
Ylhäinen+N+Prop+Sg+Nom	Ylhäinen	ˈylə.hæj.nen>
Ylhäinen+N+Prop+Sg+Acc	Ylhäinena	ˈylə.hæj.ne.n>ɑ
Ylhäinen+N+Prop+Sg+Ill	Ylhäinenii	ˈylə.hæj.ne.n>ij
Ylhäinen+N+Prop+Der/laš+A+Sg+Nom+PxSg3	Ylhäilažžas	ˈylə.hæj.lˌɑdː.tʃɑs
Ylhäinen+N+Prop+Der/laš+A+Ess+PxDu1	Ylhäilažžaneame	ˈylə.hæj.lˌɑdː.tʃɑ.nˌĕæ.me
Ylhäinen+N+Prop+Der/laš+A+Ess+PxSg1	Ylhäilažžanan	ˈylə.hæj.lˌɑdː.tʃɑ.nɑn
Ylhäinen+N+Prop+Der/laš+A+Sg+Gen	Ylhäinenlačča	ˈylə.hæj.nˌen.lɑt.tʃɑ
Ylhäinen+N+Prop+Der/laš+A+Attr+Der/vuohta+N+Pl+Loc+PxDu3	Ylhäinenlašvuođaineaskka	ˈylə.hæj.nˌen.lɑʃ»vˌuo.ðɑ>i.neæs.kɑ
Ylinen+N+Prop+Sem/Sur+Pl+Loc	Ylineniin	ˈy.li.ne.n>ijn
Ylipelkonen+N+Prop+Sem/Sur+Pl+Nom	Ylipelkosat	ˈy.li.pˌelə.hko>.sɑh
Ylipelkonen+N+Prop+Sem/Sur+Pl+Acc	Ylipelkosiid	ˈy.li.pˌelə.hko>.sijh
Ylipelkonen+N+Prop+Sem/Sur+Pl+Loc	Ylipelkoneniin	ˈy.li.pˌelə.hko.ne.n>ijn
Ylänen+N+Prop+Sem/Sur+Ess	Yläsin	ˈy.læ>.sin
Ylänen+N+Prop+Sem/Sur+Pl+Loc	Yläsiin	ˈy.læ>.sijn
Ylänen+N+Prop+Sem/Sur+Sg+Loc	Yläsis	ˈy.læ>.sis
Ylänen+N+Prop+Sem/Sur+Ess	Ylänenin	ˈy.læ.ne.n>in
Ylänen+N+Prop+Sem/Sur+Sg+Acc	Ylänena	ˈy.læ.ne.n>ɑ
Yläoutinen+N+Prop+Sem/Sur+Pl+Loc	Yläoutisiin	ˈy.læ#ˌou.ti>.sijn
Yläoutinen+N+Prop+Sem/Sur+Sg+Nom	Yläoutinen	ˈy.læ#ˌou.ti.nen>
Ylönen+N+Prop+Sem/Sur+Pl+Nom	Ylösat	ˈy.lø>.sɑh
Ylönen+N+Prop+Sem/Sur+Sg+Acc	Ylösa	ˈy.lø>.sɑ
Ylönen+N+Prop+Sem/Sur+Sg+Ill	Ylösii	ˈy.lø>.sij
Ylönen+N+Prop+Sem/Sur+Ess	Ylönenin	ˈy.lø.ne.n>in
Ylönen+N+Prop+Sem/Sur+Pl+Nom	Ylönenat	ˈy.lø.ne.n>ɑh
Yrjänäinen+N+Prop+Sem/Sur+Ess	Yrjänäisin	ˈyrə.jæ.næj>.sin
Yrjänäinen+N+Prop+Sem/Sur+Pl+Nom	Yrjänäisat	ˈyrə.jæ.næj>.sɑh
Yrjänäinen+N+Prop+Sem/Sur+Pl+Acc	Yrjänäisiid	ˈyrə.jæ.næj>.sijh
Yrjänäinen+N+Prop+Sem/Sur+Sg+Acc	Yrjänäisa	ˈyrə.jæ.næj>.sɑ
Yrjänäinen+N+Prop+Sem/Sur+Sg+Gen	Yrjänäisa	ˈyrə.jæ.næj>.sɑ
Yrjänäinen+N+Prop+Sem/Sur+Sg+Com	Yrjänäisiin	ˈyrə.jæ.næj>.sijn
Yrjänäinen+N+Prop+Sem/Sur+Sg+Ill	Yrjänäisii	ˈyrə.jæ.næj>.sij
Yrjänäinen+N+Prop+Sem/Sur+Ess	Yrjänäinenin	ˈyrə.jæ.nˌæj.ne.n>in
Yrjänäinen+N+Prop+Sem/Sur+Pl+Nom	Yrjänäinenat	ˈyrə.jæ.nˌæj.ne.n>ɑh
Yrjänäinen+N+Prop+Sem/Sur+Sg+Gen+Allegro	Yrjänäinen	ˈyrə.jæ.nˌæj.nen>
Yrjänäinen+N+Prop+Sem/Sur+Sg+Acc	Yrjänäinena	ˈyrə.jæ.nˌæj.ne.n>ɑ
Yrjänäinen+N+Prop+Sem/Sur+Sg+Com	Yrjänäineniin	ˈyrə.jæ.nˌæj.ne.n>ijn
Yrjönen+N+Prop+Sem/Sur+Ess	Yrjösin	ˈyrə.jø>.sin
Yrjönen+N+Prop+Sem/Sur+Pl+Nom	Yrjösat	ˈyrə.jø>.sɑh
Yrjönen+N+Prop+Sem/Sur+Sg+Acc	Yrjösa	ˈyrə.jø>.sɑ
Yrjönen+N+Prop+Sem/Sur+Sg+Ill	Yrjösii	ˈyrə.jø>.sij
Yrjönen+N+Prop+Sem/Sur+Ess	Yrjönenin	ˈyrə.jø.ne.n>in
Yrjönen+N+Prop+Sem/Sur+Pl+Ill	Yrjöneniidda	ˈyrə.jø.ne.n>ijt.tɑ
Yrjönen+N+Prop+Sem/Sur+Sg+Acc	Yrjönena	ˈyrə.jø.ne.n>ɑ
Yrjönen+N+Prop+Sem/Sur+Sg+Gen	Yrjönena	ˈyrə.jø.ne.n>ɑ
Yrjönen+N+Prop+Sem/Sur+Sg+Com	Yrjöneniin	ˈyrə.jø.ne.n>ijn
Äijänen+N+Prop+Sem/Sur+Ess	Äijäsin	ˈæj.jæ>.sin
Äijänen+N+Prop+Sem/Sur+Pl+Nom	Äijäsat	ˈæj.jæ>.sɑh
Äijänen+N+Prop+Sem/Sur+Pl+Loc	Äijäsiin	ˈæj.jæ>.sijn
Äijänen+N+Prop+Sem/Sur+Sg+Acc	Äijäsa	ˈæj.jæ>.sɑ
Äijänen+N+Prop+Sem/Sur+Sg+Gen	Äijäsa	ˈæj.jæ>.sɑ
Äijänen+N+Prop+Sem/Sur+Sg+Ill	Äijäsii	ˈæj.jæ>.sij
Äijänen+N+Prop+Sem/Sur+Sg+Loc	Äijäsis	ˈæj.jæ>.sis
Äijänen+N+Prop+Sem/Sur+Ess	Äijänenin	ˈæj.jæ.ne.n>in
Äijänen+N+Prop+Sem/Sur+Pl+Nom	Äijänenat	ˈæj.jæ.ne.n>ɑh
Äijänen+N+Prop+Sem/Sur+Pl+Gen	Äijäneniid	ˈæj.jæ.ne.n>ijh
Äijänen+N+Prop+Sem/Sur+Pl+Loc	Äijäneniin	ˈæj.jæ.ne.n>ijn
Äijänen+N+Prop+Sem/Sur+Sg+Acc	Äijänen	ˈæj.jæ.nen>
Äyräväinen+N+Prop+Sem/Sur+Ess	Äyräväisin	ˈæy.ræ.væj>.sin
Äyräväinen+N+Prop+Sem/Sur+Pl+Nom	Äyräväisat	ˈæy.ræ.væj>.sɑh
Äyräväinen+N+Prop+Sem/Sur+Pl+Com	Äyräväisiiguin	ˈæy.ræ.væj>.sij.gujn
Äyräväinen+N+Prop+Sem/Sur+Pl+Loc	Äyräväisiin	ˈæy.ræ.væj>.sijn
Äyräväinen+N+Prop+Sem/Sur+Sg+Com	Äyräväisiin	ˈæy.ræ.væj>.sijn
Äyräväinen+N+Prop+Sem/Sur+Sg+Ill	Äyräväisii	ˈæy.ræ.væj>.sij
Äyräväinen+N+Prop+Sem/Sur+Sg+Loc	Äyräväisis	ˈæy.ræ.væj>.sis
Äyräväinen+N+Prop+Sem/Sur+Ess	Äyräväinenin	ˈæy.ræ.vˌæj.ne.n>in
Äyräväinen+N+Prop+Sem/Sur+Pl+Nom	Äyräväinenat	ˈæy.ræ.vˌæj.ne.n>ɑh
Äyräväinen+N+Prop+Sem/Sur+Pl+Ill	Äyräväineniidda	ˈæy.ræ.vˌæj.ne.n>ijt.tɑ
Äyräväinen+N+Prop+Sem/Sur+Sg+Nom	Äyräväinen	ˈæy.ræ.vˌæj.nen>
Äyräväinen+N+Prop+Sem/Sur+Sg+Acc	Äyräväinena	ˈæy.ræ.vˌæj.ne.n>ɑ
Äyräväinen+N+Prop+Sem/Sur+Sg+Gen	Äyräväinena	ˈæy.ræ.vˌæj.ne.n>ɑ
Äyräväinen+N+Prop+Sem/Sur+Sg+Com	Äyräväineniin	ˈæy.ræ.vˌæj.ne.n>ijn
Äyräväinen+N+Prop+Sem/Sur+Sg+Ill	Äyräväinenii	ˈæy.ræ.vˌæj.ne.n>ij
Äyräväinen+N+Prop+Sem/Sur+Sg+Loc	Äyräväinenis	ˈæy.ræ.vˌæj.ne.n>is
Aaltonen+N+Prop+Sem/Sur+Ess	Aaltosin	ˈɑːlː.l̥to>.sin
Aaltonen+N+Prop+Sem/Sur+Sg+Com	Aaltosiin	ˈɑːlː.l̥to>.sijn
Aaltonen+N+Prop+Sem/Sur+Sg+Nom	Aaltonen	ˈɑːlː.l̥to.nen>
Aaltonen+N+Prop+Sem/Sur+Sg+Gen	Aaltonena	ˈɑːlː.l̥to.ne.n>ɑ
Ahponen+N+Prop+Sem/Sur+Pl+Loc	Ahponeniin	ˈɑh.po.ne.n>ijn
Ahtinen+N+Prop+Sem/Sur+Ess	Ahtinenin	ˈɑh.ti.ne.n>in
Ahtinen+N+Prop+Sem/Sur+Sg+Gen+Allegro	Ahtinen	ˈɑh.ti.nen>
Ahvenainen+N+Prop+Sem/Sur+Sg+Ill	Ahvenainenii	ˈɑh.ve.nˌɑj.ne.n>ij
Ahvonen+N+Prop+Sem/Sur+Sg+Gen+Allegro	Ahvonen	ˈɑh.vo.nen>
Ainovarppanen+N+Prop+Ess	Ainovarppasin	ˈɑj.no.vˌɑrr̥.pɑ>.sin
Ainovarppanen+N+Prop+Sg+Acc	Ainovarppasa	ˈɑj.no.vˌɑrr̥.pɑ>.sɑ
Ainovarppanen+N+Prop+Sg+Gen	Ainovarppasa	ˈɑj.no.vˌɑrr̥.pɑ>.sɑ
Ainovarppanen+N+Prop+Sg+Loc	Ainovarppasis	ˈɑj.no.vˌɑrr̥.pɑ>.sis
Ainovarppanen+N+Prop+Sg+Gen	Ainovarppanena	ˈɑj.no.vˌɑrr̥.pɑ.ne.n>ɑ
Ainovarppanen+N+Prop+Der/laš+A+Pl+Gen	Ainovarppanenlaččaid	ˈɑj.no.vˌɑrr̥.pɑ.nˌen.lɑt.tʃɑjh
Ainovarppanen+N+Prop+Der/laš+A+Pl+Nom	Ainovarppanenlaččat	ˈɑj.no.vˌɑrr̥.pɑ.nˌen.lɑt.tʃɑh
Ainovarppanen+N+Prop+Der/laš+A+Sg+Nom+PxPl2	Ainovarppanenlažžadet	ˈɑj.no.vˌɑrr̥.pɑ.nˌen.lɑdː.tʃɑ.deh
Akkanen+N+Prop+Sem/Sur+Pl+Nom	Akkasat	ˈɑkː.kɑː>.sɑh
Akkanen+N+Prop+Sem/Sur+Sg+Acc	Akkasa	ˈɑkː.kɑː>.sɑ
Akkanen+N+Prop+Sem/Sur+Sg+Ill	Akkasii	ˈɑkː.kɑː>.sij
Akkanen+N+Prop+Sem/Sur+Pl+Gen	Akkaneniid	ˈɑkː.kɑː.ne.n>ijh
Akkanen+N+Prop+Sem/Sur+Pl+Ill	Akkaneniidda	ˈɑkː.kɑː.ne.n>ijt.tɑ
Akkanen+N+Prop+Sem/Sur+Pl+Loc	Akkaneniin	ˈɑkː.kɑː.ne.n>ijn
Akkanen+N+Prop+Sem/Sur+Sg+Gen+Allegro	Akkanen	ˈɑkː.kɑː.nen>
Alhainen+N+Prop+Der/laš+A+Sg+Nom+PxSg3	Alhailažžas	ˈɑlə.hɑj.lˌɑdː.tʃɑs
Alinen+N+Prop+Sem/Sur+Ess	Alisin	ˈɑ.li>.sin
Allonen+N+Prop+Sem/Sur+Sg+Acc	Allosa	ˈɑl.lo>.sɑ
Alonen+N+Prop+Sem/Sur+Ess	Alosin	ˈɑ.lo>.sin
Annunen+N+Prop+Sem/Sur+Pl+Loc	Annusiin	ˈɑn.nu>.sijn
Annunen+N+Prop+Sem/Sur+Pl+Nom	Annunenat	ˈɑn.nu.ne.n>ɑh
Annunen+N+Prop+Sem/Sur+Pl+Loc	Annuneniin	ˈɑn.nu.ne.n>ijn
Annunen+N+Prop+Sem/Sur+Sg+Acc	Annunen	ˈɑn.nu.nen>
Annunen+N+Prop+Sem/Sur+Sg+Gen	Annunena	ˈɑn.nu.ne.n>ɑ
Anteroinen+N+Prop+Sem/Sur+Pl+Nom	Anteroisat	ˈɑnː.n̥te.roj>.sɑh
Anteroinen+N+Prop+Sem/Sur+Sg+Gen	Anteroinena	ˈɑnː.n̥te.rˌoj.ne.n>ɑ
Anteroinen+N+Prop+Sem/Sur+Sg+Loc	Anteroinenis	ˈɑnː.n̥te.rˌoj.ne.n>is
Antikainen+N+Prop+Sem/Sur+Pl+Acc	Antikaisiid	ˈɑnː.n̥ti.kɑj>.sijh
Anttilainen+N+Prop+Sem/Sur+Sg+Acc	Anttilaisa	ˈɑnn̥.ti.lɑj>.sɑ
Anttinen+N+Prop+Sem/Sur+Sg+Nom	Anttinen	ˈɑnn̥.ti.nen>
Anttolainen+N+Prop+Sem/Sur+Ess	Anttolaisin	ˈɑnn̥.to.lɑj>.sin
Arponen+N+Prop+Sem/Sur+Pl+Nom	Arponenat	ˈɑrə.hpo.ne.n>ɑh
Arvinen+N+Prop+Sem/Sur+Pl+Gen	Arvisiid	ˈɑrə.vi>.sijh
Arvinen+N+Prop+Sem/Sur+Ess	Arvinenin	ˈɑrə.vi.ne.n>in
Arvonen+N+Prop+Sem/Sur+Pl+Com	Arvosiiguin	ˈɑrə.vo>.sij.gujn
Arvonen+N+Prop+Sem/Sur+Ess	Arvonenin	ˈɑrə.vo.ne.n>in
Asikainen+N+Prop+Sem/Sur+Sg+Gen	Asikaisa	ˈɑ.si.kɑj>.sɑ
Asikainen+N+Prop+Sem/Sur+Sg+Gen+Allegro	Asikainen	ˈɑ.si.kˌɑj.nen>
Astikainen+N+Prop+Sem/Sur+Ess	Astikaisin	ˈɑsː.ti.kɑj>.sin
Astikainen+N+Prop+Sem/Sur+Sg+Ill	Astikaisii	ˈɑsː.ti.kɑj>.sij
Astikainen+N+Prop+Sem/Sur+Pl+Com	Astikaineniiguin	ˈɑsː.ti.kˌɑj.ne.n>ij.gujn
Astikainen+N+Prop+Sem/Sur+Sg+Gen	Astikainena	ˈɑsː.ti.kˌɑj.ne.n>ɑ
Auranen+N+Prop+Sem/Sur+Pl+Acc	Aurasiid	ˈɑu.rɑ>.sijh
Auranen+N+Prop+Sem/Sur+Pl+Loc	Auraneniin	ˈɑu.rɑ.ne.n>ijn
Auranen+N+Prop+Sem/Sur+Sg+Acc	Auranen	ˈɑu.rɑ.nen>
Auranen+N+Prop+Sem/Sur+Sg+Gen+Allegro	Auranen	ˈɑu.rɑ.nen>
Auvinen+N+Prop+Sem/Sur+Pl+Ill	Auvisiidda	ˈɑu.vi>.sijt.tɑ
Auvinen+N+Prop+Sem/Sur+Sg+Gen+Allegro	Auvinen	ˈɑu.vi.nen>
Avikainen+N+Prop+Sem/Sur+Pl+Nom	Avikaisat	ˈɑ.vi.kɑj>.sɑh
Avikainen+N+Prop+Sem/Sur+Pl+Ill	Avikaisiidda	ˈɑ.vi.kɑj>.sijt.tɑ
Avikainen+N+Prop+Sem/Sur+Sg+Acc	Avikaisa	ˈɑ.vi.kɑj>.sɑ
Avikainen+N+Prop+Sem/Sur+Sg+Gen	Avikaisa	ˈɑ.vi.kɑj>.sɑ
Avikainen+N+Prop+Sem/Sur+Pl+Nom	Avikainenat	ˈɑ.vi.kˌɑj.ne.n>ɑh
Avikainen+N+Prop+Sem/Sur+Sg+Gen+Allegro	Avikainen	ˈɑ.vi.kˌɑj.nen>
Björninen+N+Prop+Sem/Sur+Ess	Björnisin	bjˈør.ni>.sin
Björninen+N+Prop+Sem/Sur+Pl+Nom	Björnisat	bjˈør.ni>.sɑh
Björninen+N+Prop+Sem/Sur+Pl+Acc	Björnisiid	bjˈør.ni>.sijh
Björninen+N+Prop+Sem/Sur+Pl+Com	Björnisiiguin	bjˈør.ni>.sij.gujn
Björninen+N+Prop+Sem/Sur+Pl+Gen	Björnisiid	bjˈør.ni>.sijh
Björninen+N+Prop+Sem/Sur+Pl+Ill	Björnisiidda	bjˈør.ni>.sijt.tɑ
Björninen+N+Prop+Sem/Sur+Pl+Loc	Björnisiin	bjˈør.ni>.sijn
Björninen+N+Prop+Sem/Sur+Sg+Acc	Björnisa	bjˈør.ni>.sɑ
Björninen+N+Prop+Sem/Sur+Sg+Gen	Björnisa	bjˈør.ni>.sɑ
Björninen+N+Prop+Sem/Sur+Sg+Com	Björnisiin	bjˈør.ni>.sijn
Björninen+N+Prop+Sem/Sur+Sg+Ill	Björnisii	bjˈør.ni>.sij
Björninen+N+Prop+Sem/Sur+Sg+Loc	Björnisis	bjˈør.ni>.sis
Björninen+N+Prop+Sem/Sur+Ess	Björninenin	bjˈør.ni.ne.n>in
Björninen+N+Prop+Sem/Sur+Pl+Nom	Björninenat	bjˈør.ni.ne.n>ɑh
Björninen+N+Prop+Sem/Sur+Pl+Acc	Björnineniid	bjˈør.ni.ne.n>ijh
Björninen+N+Prop+Sem/Sur+Pl+Ill	Björnineniidda	bjˈør.ni.ne.n>ijt.tɑ
Björninen+N+Prop+Sem/Sur+Sg+Acc	Björninen	bjˈør.ni.nen>
Björninen+N+Prop+Sem/Sur+Sg+Gen+Allegro	Björninen	bjˈør.ni.nen>
Björninen+N+Prop+Sem/Sur+Sg+Nom	Björninen	bjˈør.ni.nen>
Björninen+N+Prop+Sem/Sur+Sg+Acc	Björninena	bjˈør.ni.ne.n>ɑ
Björninen+N+Prop+Sem/Sur+Sg+Gen	Björninena	bjˈør.ni.ne.n>ɑ
Björninen+N+Prop+Sem/Sur+Sg+Com	Björnineniin	bjˈør.ni.ne.n>ijn
Björninen+N+Prop+Sem/Sur+Sg+Ill	Björninenii	bjˈør.ni.ne.n>ij
Björninen+N+Prop+Sem/Sur+Sg+Loc	Björninenis	bjˈør.ni.ne.n>is
Eerikäinen+N+Prop+Sem/Sur+Pl+Nom	Eerikäisat	ˈeː.ri.kæj>.sɑh
Eerikäinen+N+Prop+Sem/Sur+Pl+Acc	Eerikäisiid	ˈeː.ri.kæj>.sijh
Eerikäinen+N+Prop+Sem/Sur+Pl+Gen	Eerikäineniid	ˈeː.ri.kˌæj.ne.n>ijh
Eerikäinen+N+Prop+Sem/Sur+Sg+Ill	Eerikäinenii	ˈeː.ri.kˌæj.ne.n>ij
Ehrukainen+N+Prop+Sem/Sur+Sg+Ill	Ehrukaisii	ˈeh.ru.kɑj>.sij
Ehrukainen+N+Prop+Sem/Sur+Pl+Ill	Ehrukaineniidda	ˈeh.ru.kˌɑj.ne.n>ijt.tɑ
Ehrukainen+N+Prop+Sem/Sur+Pl+Loc	Ehrukaineniin	ˈeh.ru.kˌɑj.ne.n>ijn
Ekonen+N+Prop+Sem/Sur+Ess	Ekosin	ˈe.ko>.sin
Ekonen+N+Prop+Sem/Sur+Pl+Nom	Ekosat	ˈe.ko>.sɑh
Ekonen+N+Prop+Sem/Sur+Pl+Com	Ekosiiguin	ˈe.ko>.sij.gujn
Ekonen+N+Prop+Sem/Sur+Sg+Acc	Ekosa	ˈe.ko>.sɑ
Ekonen+N+Prop+Sem/Sur+Pl+Nom	Ekonenat	ˈe.ko.ne.n>ɑh
Ekonen+N+Prop+Sem/Sur+Sg+Gen+Allegro	Ekonen	ˈe.ko.nen>
Ekonen+N+Prop+Sem/Sur+Sg+Acc	Ekonena	ˈe.ko.ne.n>ɑ
Ellonen+N+Prop+Sem/Sur+Sg+Gen	Ellonena	ˈel.lo.ne.n>ɑ
Elonen+N+Prop+Sem/Sur+Ess	Elosin	ˈe.lo>.sin
Elonen+N+Prop+Sem/Sur+Pl+Nom	Elosat	ˈe.lo>.sɑh
Elonen+N+Prop+Sem/Sur+Pl+Acc	Elosiid	ˈe.lo>.sijh
Elonen+N+Prop+Sem/Sur+Pl+Acc	Eloneniid	ˈe.lo.ne.n>ijh
Eronen+N+Prop+Sem/Sur+Ess	Erosin	ˈe.ro>.sin
Eronen+N+Prop+Sem/Sur+Sg+Com	Eroneniin	ˈe.ro.ne.n>ijn
Eronen+N+Prop+Sem/Sur+Sg+Loc	Eronenis	ˈe.ro.ne.n>is
Eränen+N+Prop+Sem/Sur+Pl+Nom	Eräsat	ˈe.ræ>.sɑh
Eränen+N+Prop+Sem/Sur+Pl+Nom	Eränenat	ˈe.ræ.ne.n>ɑh
Eskelinen+N+Prop+Sem/Sur+Pl+Nom	Eskelisat	ˈesː.ke.li>.sɑh
Eskelinen+N+Prop+Sem/Sur+Pl+Acc	Eskelisiid	ˈesː.ke.li>.sijh
Eskelinen+N+Prop+Sem/Sur+Sg+Loc	Eskelisis	ˈesː.ke.li>.sis
Eskelinen+N+Prop+Sem/Sur+Pl+Nom	Eskelinenat	ˈesː.ke.lˌi.ne.n>ɑh
Eskelinen+N+Prop+Sem/Sur+Sg+Nom	Eskelinen	ˈesː.ke.lˌi.nen>
Eskelinen+N+Prop+Sem/Sur+Sg+Gen	Eskelinena	ˈesː.ke.lˌi.ne.n>ɑ
Eskelinen+N+Prop+Sem/Sur+Sg+Com	Eskelineniin	ˈesː.ke.lˌi.ne.n>ijn
Eskelinen+N+Prop+Sem/Sur+Sg+Ill	Eskelinenii	ˈesː.ke.lˌi.ne.n>ij
Eskonen+N+Prop+Sem/Sur+Pl+Nom	Eskosat	ˈesː.ko>.sɑh
Eskonen+N+Prop+Sem/Sur+Sg+Acc	Eskosa	ˈesː.ko>.sɑ
Eskonen+N+Prop+Sem/Sur+Sg+Loc	Eskosis	ˈesː.ko>.sis
Eskonen+N+Prop+Sem/Sur+Sg+Ill	Eskonenii	ˈesː.ko.ne.n>ij
Eteläinen+N+Prop+Sem/Sur+Pl+Nom	Eteläisat	ˈe.te.læj>.sɑh
Eteläpää+N+Prop+Der/laš+A+Attr	Eteläpäälaš	ˈe.te.læ#phˌæ.æ>.lɑʃ
Eteläpää+N+Prop+Der/laš+A+Sg+Ill	Eteläpäälažžii	ˈe.te.læ#phˌæ.æ>.lɑdː.tʃij
Ettanen+N+Prop+Sem/Sur+Pl+Nom	Ettasat	ˈetː.tɑː>.sɑh
Ettanen+N+Prop+Sem/Sur+Sg+Acc	Ettasa	ˈetː.tɑː>.sɑ
Ettanen+N+Prop+Sem/Sur+Ess	Ettanenin	ˈetː.tɑː.ne.n>in
Halonen+N+Prop+Sem/Sur+Ess	Halonenin	hˈɑ.lo.ne.n>in
Hamunen+N+Prop+Sem/Sur+Sg+Ill	Hamusii	hˈɑ.mu>.sij
Hamunen+N+Prop+Sem/Sur+Ess	Hamunenin	hˈɑ.mu.ne.n>in
Harjunen+N+Prop+Sem/Sur+Ess	Harjusin	hˈɑrə.ju>.sin
Hatunen+N+Prop+Sem/Sur+Sg+Com	Hatuneniin	hˈɑ.tu.ne.n>ijn
Havunen+N+Prop+Sem/Sur+Ess	Havunenin	hˈɑ.vu.ne.n>in
Heimonen+N+Prop+Sem/Sur+Sg+Nom	Heimonen	hˈej.mo.nen>
Heiskanen+N+Prop+Sem/Sur+Ess	Heiskasin	hˈejː.skɑ>.sin
Helppolainen+N+Prop+Sem/Sur+Pl+Acc	Helppolaineniid	hˈell̥.po.lˌɑj.ne.n>ijh
Henninen+N+Prop+Sem/Sur+Ess	Hennisin	hˈen.ni>.sin
Henninen+N+Prop+Sem/Sur+Pl+Gen	Hennineniid	hˈen.ni.ne.n>ijh
Henninen+N+Prop+Sem/Sur+Sg+Ill	Henninenii	hˈen.ni.ne.n>ij
Hermunen+N+Prop+Sem/Sur+Ess	Hermusin	hˈer.mu>.sin
Herttuainen+N+Prop+Sem/Sur+Pl+Nom	Herttuaisat	hˈerr̥.tu.ɑj>.sɑh
Hessulainen+N+Prop+Sem/Sur+Ess	Hessulaisin	hˈes.su.lɑj>.sin
Hiironen+N+Prop+Sem/Sur+Pl+Nom	Hiirosat	hˈijː.ro>.sɑh
Hippeläinen+N+Prop+Sem/Sur+Pl+Ill	Hippeläisiidda	hˈip.pe.læj>.sijt.tɑ
Hippeläinen+N+Prop+Sem/Sur+Ess	Hippeläinenin	hˈip.pe.lˌæj.ne.n>in
Hirvonen+N+Prop+Sem/Sur+Pl+Nom	Hirvonenat	hˈirə.vo.ne.n>ɑh
Hirvonen+N+Prop+Sem/Sur+Sg+Gen	Hirvonena	hˈirə.vo.ne.n>ɑ
Hokkinen+N+Prop+Sem/Sur+Pl+Nom	Hokkisat	hˈok.ki>.sɑh
Hokkinen+N+Prop+Sem/Sur+Sg+Acc	Hokkisa	hˈok.ki>.sɑ
Hokkinen+N+Prop+Sem/Sur+Pl+Gen	Hokkineniid	hˈok.ki.ne.n>ijh
Holttinen+N+Prop+Sem/Sur+Pl+Ill	Holttisiidda	hˈoll̥.ti>.sijt.tɑ
Holttinen+N+Prop+Sem/Sur+Sg+Acc	Holttinen	hˈoll̥.ti.nen>
Honkanen+N+Prop+Sem/Sur+Sg+Gen	Honkasa	hˈoŋŋ.ŋ̊kɑ>.sɑ
Hopiavuori+N+Prop+Der/laš+A+Pl+Ill	Hopiavuorilaččaide	hˈo.pi.ɑ#vˌuo.ri>.lɑt.tʃɑj.de
Hopiavuori+N+Prop+Der/laš+A+Sg+Loc+PxPl1	Hopiavuorilaččasteamet	hˈo.pi.ɑ#vˌuo.ri>.lɑt.tʃɑs.tĕæ.meh
Horttanainen+N+Prop+Sem/Sur+Sg+Ill	Horttanaisii	hˈorr̥ː.tɑː.nɑj>.sij
Hottinen+N+Prop+Sem/Sur+Ess	Hottisin	hˈot.ti>.sin
Huiskonen+N+Prop+Sem/Sur+Pl+Gen	Huiskosiid	hˈujː.sko>.sijh
Hujanen+N+Prop+Sem/Sur+Pl+Ill	Hujaneniidda	hˈu.jɑː.ne.n>ijt.tɑ
Hukkanen+N+Prop+Sem/Sur+Pl+Nom	Hukkasat	hˈukː.kɑː>.sɑh
Huomo+N+Prop+Sem/Sur+Sg+Loc	Huomos	hˈŭo.mo>s
Huotarinen+N+Prop+Sem/Sur+Sg+Loc	Huotarinenis	hˈuo.tɑ.rˌi.ne.n>is
Hurmalainen+N+Prop+Sem/Sur+Sg+Gen	Hurmalainena	hˈur.mɑː.lˌɑj.ne.n>ɑ
Huttunen+N+Prop+Sem/Sur+Sg+Nom	Huttunen	hˈut.tu.nen>
Huumo+N+Prop+Sem/Sur+Sg+Ill	Huumoi	hˈu.u.mo>i
Huurinainen+N+Prop+Sem/Sur+Sg+Acc	Huurinainena	hˈu.u.rˌi.nɑj.ne.n>ɑ
Hyppänen+N+Prop+Sem/Sur+Sg+Gen+Allegro	Hyppänen	hˈyp.pæ.nen>
Hyvönen+N+Prop+Sem/Sur+Ess	Hyvösin	hˈy.vø>.sin
Hyyryläinen+N+Prop+Sem/Sur+Sg+Gen	Hyyryläisa	hˈy.y.rˌy.læj>.sɑ
Hyötyläinen+N+Prop+Sem/Sur+Pl+Gen	Hyötyläisiid	hˈy.ø.tˌy.læj>.sijh
Hälinen+N+Prop+Sem/Sur+Sg+Acc	Hälisa	hˈæ.li>.sɑ
Hämynen+N+Prop+Sem/Sur+Sg+Loc	Hämysis	hˈæ.my>.sis
Härkönen+N+Prop+Sem/Sur+Sg+Ill	Härkösii	hˈærə.hkø>.sij
Hätinen+N+Prop+Sem/Sur+Pl+Nom	Hätisat	hˈæ.ti>.sɑh
Häyrinen+N+Prop+Sem/Sur+Ess	Häyrisin	hˈæ.y.ri>.sin
Ihanainen+N+Prop+Sem/Sur+Pl+Ill	Ihanaineniidda	ˈi.hɑː.nˌɑj.ne.n>ijt.tɑ
Ihonen+N+Prop+Sem/Sur+Sg+Com	Ihosiin	ˈi.ho>.sijn
Ihonen+N+Prop+Sem/Sur+Sg+Loc	Ihosis	ˈi.ho>.sis
Iivanainen+N+Prop+Sem/Sur+Pl+Nom	Iivanaisat	ˈijː.vɑː.nɑj>.sɑh
Iivanainen+N+Prop+Sem/Sur+Pl+Com	Iivanaisiiguin	ˈijː.vɑː.nɑj>.sij.gujn
Iivanainen+N+Prop+Sem/Sur+Ess	Iivanainenin	ˈijː.vɑː.nˌɑj.ne.n>in
Iivanainen+N+Prop+Sem/Sur+Sg+Gen+Allegro	Iivanainen	ˈijː.vɑː.nˌɑj.nen>
Ikonen+N+Prop+Sem/Sur+Pl+Loc	Ikosiin	ˈi.ko>.sijn
Ikonen+N+Prop+Sem/Sur+Pl+Com	Ikoneniiguin	ˈi.ko.ne.n>ij.gujn
Ikäheimonen+N+Prop+Sem/Sur+Pl+Com	Ikäheimosiiguin	ˈi.kæ.hˌej.mo>.sij.gujn
Ikäheimonen+N+Prop+Sem/Sur+Sg+Gen+Allegro	Ikäheimonen	ˈi.kæ.hˌej.mo.nen>
Ikäläinen+N+Prop+Sem/Sur+Pl+Nom	Ikäläisat	ˈi.kæ.læj>.sɑh
Illikainen+N+Prop+Sem/Sur+Pl+Nom	Illikaisat	ˈil.li.kɑj>.sɑh
Illikainen+N+Prop+Sem/Sur+Sg+Gen	Illikaisa	ˈil.li.kɑj>.sɑ
Illikainen+N+Prop+Sem/Sur+Sg+Com	Illikaineniin	ˈil.li.kˌɑj.ne.n>ijn
Ilmarinen+N+Prop+Sem/Sur+Ess	Ilmarisin	ˈilə.mɑ.ri>.sin
Ilmonen+N+Prop+Sem/Sur+Sg+Acc	Ilmosa	ˈilə.mo>.sɑ
Iltanen+N+Prop+Sem/Sur+Pl+Com	Iltaneniiguin	ˈilː.l̥tɑ.ne.n>ij.gujn
Iltanen+N+Prop+Sem/Sur+Sg+Loc	Iltanenis	ˈilː.l̥tɑ.ne.n>is
Ilvonen+N+Prop+Sem/Sur+Sg+Com	Ilvosiin	ˈilə.vo>.sijn
Immonen+N+Prop+Sem/Sur+Pl+Com	Immosiiguin	ˈim.mo>.sij.gujn
Immonen+N+Prop+Sem/Sur+Pl+Gen	Immosiid	ˈim.mo>.sijh
Immonen+N+Prop+Sem/Sur+Sg+Acc	Immosa	ˈim.mo>.sɑ
Immonen+N+Prop+Sem/Sur+Sg+Nom	Immonen	ˈim.mo.nen>
Immonen+N+Prop+Sem/Sur+Sg+Acc	Immonena	ˈim.mo.ne.n>ɑ
Imponen+N+Prop+Sem/Sur+Sg+Acc	Imposa	ˈimː.m̥po>.sɑ
Imponen+N+Prop+Sem/Sur+Ess	Imponenin	ˈimː.m̥po.ne.n>in
Inkeroinen+N+Prop+Sg+Gen	Inkeroinena	ˈiŋŋ.ŋ̊ke.rˌoj.ne.n>ɑ
Inkiläinen+N+Prop+Sem/Sur+Sg+Acc	Inkiläinena	ˈiŋŋ.ŋ̊ki.lˌæj.ne.n>ɑ
Inkiläinen+N+Prop+Sem/Sur+Sg+Com	Inkiläineniin	ˈiŋŋ.ŋ̊ki.lˌæj.ne.n>ijn
Inkiläinen+N+Prop+Sem/Sur+Sg+Loc	Inkiläinenis	ˈiŋŋ.ŋ̊ki.lˌæj.ne.n>is
Inkinen+N+Prop+Sem/Sur+Pl+Nom	Inkisat	ˈiŋŋ.ŋ̊ki>.sɑh
Inkonen+N+Prop+Sem/Sur+Sg+Gen	Inkonena	ˈiŋŋ.ŋ̊ko.ne.n>ɑ
Innanen+N+Prop+Sem/Sur+Sg+Acc	Innanena	ˈinː.nɑː.ne.n>ɑ
Intonen+N+Prop+Sem/Sur+Ess	Intosin	ˈinː.n̥to>.sin
Intonen+N+Prop+Sem/Sur+Sg+Ill	Intosii	ˈinː.n̥to>.sij
Intonen+N+Prop+Sem/Sur+Pl+Nom	Intonenat	ˈinː.n̥to.ne.n>ɑh
Isoherranen+N+Prop+Sem/Sur+Ess	Isoherrasin	ˈi.so.hˌer.rɑ>.sin
Isokääntä+N+Prop+Sg+Ill	Isokääntäi	ˈi.so#khˌæ.ænː.n̥tæ>i
Issakainen+N+Prop+Sem/Sur+Sg+Loc	Issakaisis	ˈisː.sɑː.kɑj>.sis
Issakainen+N+Prop+Sem/Sur+Ess	Issakainenin	ˈisː.sɑː.kˌɑj.ne.n>in
Issakainen+N+Prop+Sem/Sur+Pl+Acc	Issakaineniid	ˈisː.sɑː.kˌɑj.ne.n>ijh
Issakainen+N+Prop+Sem/Sur+Sg+Nom	Issakainen	ˈisː.sɑː.kˌɑj.nen>
Itkonen+N+Prop+Sem/Sur+Ess	Itkosin	ˈitː.hko>.sin
Itkonen+N+Prop+Sem/Sur+Pl+Nom	Itkosat	ˈitː.hko>.sɑh
Itkonen+N+Prop+Sem/Sur+Ess	Itkonenin	ˈitː.hko.ne.n>in
Itkonen+N+Prop+Sem/Sur+Pl+Nom	Itkonenat	ˈitː.hko.ne.n>ɑh
Itkonen+N+Prop+Sem/Sur+Pl+Com	Itkoneniiguin	ˈitː.hko.ne.n>ij.gujn
Itkonen+N+Prop+Sem/Sur+Pl+Ill	Itkoneniidda	ˈitː.hko.ne.n>ijt.tɑ
Jaatinen+N+Prop+Sem/Sur+Pl+Nom	Jaatisat	jˈɑ.ɑ.ti>.sɑh
Jakonen+N+Prop+Sem/Sur+Pl+Com	Jakoneniiguin	jˈɑ.ko.ne.n>ij.gujn
Jalkanen+N+Prop+Sem/Sur+Sg+Ill	Jalkasii	jˈɑlə.hkɑ>.sij
Jalkanen+N+Prop+Sem/Sur+Sg+Gen+Allegro	Jalkanen	jˈɑlə.hkɑ.nen>
Janatuinen+N+Prop+Sem/Sur+Pl+Gen	Janatuisiid	jˈɑ.nɑː.tuj>.sijh
Jarveläinen+N+Prop+Sem/Sur+Ess	Jarveläinenin	jˈɑrə.ve.lˌæj.ne.n>in
Jauhiainen+N+Prop+Sem/Sur+Sg+Ill	Jauhiaisii	jˈɑu.hi.ɑj>.sij
Jauhiainen+N+Prop+Sem/Sur+Pl+Nom	Jauhiainenat	jˈɑu.hi.ˌɑj.ne.n>ɑh
Javanainen+N+Prop+Sem/Sur+Pl+Gen	Javanaisiid	jˈɑ.vɑː.nɑj>.sijh
Javanainen+N+Prop+Sem/Sur+Sg+Acc	Javanaisa	jˈɑ.vɑː.nɑj>.sɑ
Javanainen+N+Prop+Sem/Sur+Sg+Acc	Javanainen	jˈɑ.vɑː.nˌɑj.nen>
Jehkonen+N+Prop+Sem/Sur+Pl+Nom	Jehkosat	jˈeh.ko>.sɑh
Jehkonen+N+Prop+Sem/Sur+Pl+Loc	Jehkosiin	jˈeh.ko>.sijn
Jehkonen+N+Prop+Sem/Sur+Sg+Acc	Jehkonen	jˈeh.ko.nen>
Jehkonen+N+Prop+Sem/Sur+Sg+Nom	Jehkonen	jˈeh.ko.nen>
Jeppänen+N+Prop+Sem/Sur+Pl+Com	Jeppäsiiguin	jˈep.pæ>.sij.gujn
Jeppänen+N+Prop+Sem/Sur+Sg+Acc	Jeppänena	jˈep.pæ.ne.n>ɑ
Jeskanen+N+Prop+Sem/Sur+Pl+Loc	Jeskasiin	jˈesː.kɑː>.sijn
Jetsonen+N+Prop+Sem/Sur+Sg+Acc	Jetsonen	jˈet.so.nen>
Jetsonen+N+Prop+Sem/Sur+Sg+Com	Jetsoneniin	jˈet.so.ne.n>ijn
Jokelainen+N+Prop+Sem/Sur+Pl+Nom	Jokelainenat	jˈo.ke.lˌɑj.ne.n>ɑh
Jolkkonen+N+Prop+Sem/Sur+Pl+Acc	Jolkkosiid	jˈoll̥.ko>.sijh
Jomppanen+N+Prop+Sem/Sur+Pl+Acc	Jomppasiid	jˈomm̥ː.pɑː>.sijh
Jomppanen+N+Prop+Sem/Sur+Sg+Com	Jomppaneniin	jˈomm̥ː.pɑː.ne.n>ijn
Jormalainen+N+Prop+Sem/Sur+Sg+Loc	Jormalaisis	jˈor.mɑː.lɑj>.sis
Joronen+N+Prop+Sem/Sur+Ess	Joronenin	jˈo.ro.ne.n>in
Joronen+N+Prop+Sem/Sur+Sg+Acc	Joronena	jˈo.ro.ne.n>ɑ
Joukainen+N+Prop+Sem/Sur+Ess	Joukainenin	jˈou.kɑj.ne.n>in
Joukainen+N+Prop+Sem/Sur+Sg+Gen+Allegro	Joukainen	jˈou.kɑj.nen>
Jukarainen+N+Prop+Sem/Sur+Pl+Nom	Jukaraisat	jˈu.kɑː.rɑj>.sɑh
Jukarainen+N+Prop+Sem/Sur+Sg+Loc	Jukaraisis	jˈu.kɑː.rɑj>.sis
Jukarainen+N+Prop+Sem/Sur+Ess	Jukarainenin	jˈu.kɑː.rˌɑj.ne.n>in
Julkunen+N+Prop+Sem/Sur+Pl+Gen	Julkusiid	jˈulə.hku>.sijh
Julkunen+N+Prop+Sem/Sur+Sg+Ill	Julkusii	jˈulə.hku>.sij
Julkunen+N+Prop+Sem/Sur+Sg+Acc	Julkunen	jˈulə.hku.nen>
Jumppanen+N+Prop+Sem/Sur+Pl+Gen	Jumppasiid	jˈumm̥ː.pɑː>.sijh
Juntunen+N+Prop+Sem/Sur+Sg+Com	Juntusiin	jˈunː.n̥tu>.sijn
Juntunen+N+Prop+Sem/Sur+Sg+Acc	Juntunena	jˈunː.n̥tu.ne.n>ɑ
Jurvanen+N+Prop+Sem/Sur+Ess	Jurvasin	jˈurə.vɑ>.sin
Juuso+N+Prop+Sem/Sur+Sg+Ill	Juusoi	jˈu.u.so>i
Juutinen+N+Prop+Sem/Sur+Pl+Nom	Juutisat	jˈu.u.ti>.sɑh
Juvonen+N+Prop+Sem/Sur+Sg+Gen	Juvonena	jˈu.vo.ne.n>ɑ
Jyrkinen+N+Prop+Sem/Sur+Ess	Jyrkisin	jˈyrə.hki>.sin
Jyrkinen+N+Prop+Sem/Sur+Pl+Ill	Jyrkisiidda	jˈyrə.hki>.sijt.tɑ
Jyrkinen+N+Prop+Sem/Sur+Pl+Nom	Jyrkinenat	jˈyrə.hki.ne.n>ɑh
Jyrkinen+N+Prop+Sem/Sur+Pl+Gen	Jyrkineniid	jˈyrə.hki.ne.n>ijh
Jyrkinen+N+Prop+Sem/Sur+Sg+Ill	Jyrkinenii	jˈyrə.hki.ne.n>ij
Jyrkiäinen+N+Prop+Sem/Sur+Pl+Ill	Jyrkiäisiidda	jˈyrə.hki.æj>.sijt.tɑ
Jyrkiäinen+N+Prop+Sem/Sur+Sg+Acc	Jyrkiäisa	jˈyrə.hki.æj>.sɑ
Jyrkiäinen+N+Prop+Sem/Sur+Sg+Ill	Jyrkiäisii	jˈyrə.hki.æj>.sij
Jyrkiäinen+N+Prop+Sem/Sur+Ess	Jyrkiäinenin	jˈyrə.hki.ˌæj.ne.n>in
Jyrkiäinen+N+Prop+Sem/Sur+Sg+Gen	Jyrkiäinena	jˈyrə.hki.ˌæj.ne.n>ɑ
Jäppinen+N+Prop+Sem/Sur+Pl+Nom	Jäppisat	jˈæp.pi>.sɑh
Jäppinen+N+Prop+Sem/Sur+Sg+Acc	Jäppinena	jˈæp.pi.ne.n>ɑ
Jäppinen+N+Prop+Sem/Sur+Sg+Com	Jäppineniin	jˈæp.pi.ne.n>ijn
Järvenpää+N+Prop+Ess	Järvenpään	jˈærə.ven#phˌæ.æ>n
Järvenpää+N+Prop+Der/laš+A+Pl+Nom	Järvenpäälaččat	jˈærə.ven#phˌæ.æ>.lɑt.tʃɑh
Järvenpää+N+Prop+Der/laš+A+Sg+Ill	Järvenpäälažžii	jˈærə.ven#phˌæ.æ>.lɑdː.tʃij
Kahilainen+N+Prop+Sem/Sur+Sg+Acc	Kahilainena	khˈɑ.hi.lˌɑj.ne.n>ɑ
Kakkinen+N+Prop+Sem/Sur+Pl+Gen	Kakkisiid	khˈɑk.ki>.sijh
Kaljunen+N+Prop+Sem/Sur+Pl+Acc	Kaljusiid	khˈɑʎ.ʎu>.sijh
Kankainen+N+Prop+Sem/Sur+Pl+Gen	Kankaisiid	khˈɑŋŋ.ŋ̊kɑj>.sijh
Kassinen+N+Prop+Sem/Sur+Sg+Loc	Kassisis	khˈɑs.si>.sis
Kejonen+N+Prop+Sem/Sur+Pl+Nom	Kejonenat	khˈe.jo.ne.n>ɑh
Kekarainen+N+Prop+Sem/Sur+Ess	Kekarainenin	khˈe.kɑː.rˌɑj.ne.n>in
Kekkonen+N+Prop+Sem/Sur+Sg+Com	Kekkosiin	khˈek.ko>.sijn
Ketonen+N+Prop+Sem/Sur+Ess	Ketosin	khˈe.to>.sin
Kipinoinen+N+Prop+Sem/Sur+Sg+Gen	Kipinoinena	khˈi.pi.nˌoj.ne.n>ɑ
Kirjavainen+N+Prop+Sem/Sur+Sg+Acc	Kirjavainen	khˈirə.jɑ.vˌɑj.nen>
Kiskonen+N+Prop+Sem/Sur+Ess	Kiskosin	khˈisː.ko>.sin
Kiskonen+N+Prop+Sem/Sur+Sg+Com	Kiskoneniin	khˈisː.ko.ne.n>ijn
Kitunen+N+Prop+Sem/Sur+Sg+Ill	Kitunenii	khˈi.tu.ne.n>ij
Kiukkonen+N+Prop+Sem/Sur+Pl+Ill	Kiukkosiidda	khˈi.uk.ko>.sijt.tɑ
Kiukkonen+N+Prop+Sem/Sur+Sg+Gen	Kiukkosa	khˈi.uk.ko>.sɑ
Kiukkonen+N+Prop+Sem/Sur+Pl+Nom	Kiukkonenat	khˈi.uk.kˌo.ne.n>ɑh
Klemettinen+N+Prop+Sem/Sur+Ess	Klemettisin	klˈeː.met.ti>.sin
Klemettinen+N+Prop+Sem/Sur+Pl+Nom	Klemettisat	klˈeː.met.ti>.sɑh
Klemettinen+N+Prop+Sem/Sur+Sg+Gen	Klemettisa	klˈeː.met.ti>.sɑ
Klemettinen+N+Prop+Sem/Sur+Sg+Loc	Klemettisis	klˈeː.met.ti>.sis
Klemettinen+N+Prop+Sem/Sur+Sg+Com	Klemettineniin	klˈeː.met.tˌi.ne.n>ijn
Knuutinen+N+Prop+Sem/Sur+Sg+Ill	Knuutisii	knˈu.u.ti>.sij
Knuutinen+N+Prop+Sem/Sur+Pl+Com	Knuutineniiguin	knˈu.u.tˌi.ne.n>ij.gujn
Knuutinen+N+Prop+Sem/Sur+Pl+Gen	Knuutineniid	knˈu.u.tˌi.ne.n>ijh
Knuutinen+N+Prop+Sem/Sur+Sg+Gen+Allegro	Knuutinen	knˈu.u.tˌi.nen>
Knuutinen+N+Prop+Sem/Sur+Sg+Acc	Knuutinena	knˈu.u.tˌi.ne.n>ɑ
Kohonen+N+Prop+Sem/Sur+Sg+Gen	Kohosa	khˈo.ho>.sɑ
Kononen+N+Prop+Sem/Sur+Sg+Ill	Konosii	khˈo.no>.sij
Kostiainen+N+Prop+Sem/Sur+Ess	Kostiaisin	khˈosː.ti.ɑj>.sin
Kovalainen+N+Prop+Sem/Sur+Pl+Nom	Kovalainenat	khˈo.vɑː.lˌɑj.ne.n>ɑh
Kuhanen+N+Prop+Sem/Sur+Pl+Com	Kuhaneniiguin	khˈu.hɑː.ne.n>ij.gujn
Kuivinen+N+Prop+Sem/Sur+Sg+Acc	Kuivinen	khˈujː.vi.nen>
Kukkurainen+N+Prop+Sem/Sur+Pl+Nom	Kukkurainenat	khˈuk.ku.rˌɑj.ne.n>ɑh
Kumpulainen+N+Prop+Sem/Sur+Sg+Acc	Kumpulainena	khˈumː.m̥pu.lˌɑj.ne.n>ɑ
Kuntonen+N+Prop+Sem/Sur+Pl+Gen	Kuntosiid	khˈunː.n̥to>.sijh
Kykkänen+N+Prop+Sem/Sur+Sg+Loc	Kykkänenis	khˈyk.kæ.ne.n>is
Kyröläinen+N+Prop+Sem/Sur+Ess	Kyröläisin	khˈy.rø.læj>.sin
Kyröläinen+N+Prop+Sem/Sur+Sg+Com	Kyröläisiin	khˈy.rø.læj>.sijn
Kähönen+N+Prop+Sem/Sur+Sg+Nom	Kähönen	khˈæ.hø.nen>
Käiväräinen+N+Prop+Sem/Sur+Ess	Käiväräisin	khˈæjː.væ.ræj>.sin
Kälviäinen+N+Prop+Sem/Sur+Sg+Acc	Kälviäinen	khˈælə.vi.ˌæj.nen>
Känkänen+N+Prop+Sem/Sur+Sg+Acc	Känkäsa	khˈæŋŋ.ŋ̊kæ>.sɑ
Käpynen+N+Prop+Sem/Sur+Sg+Loc	Käpysis	khˈæ.py>.sis
Kärkinen+N+Prop+Sem/Sur+Sg+Loc	Kärkinenis	khˈærə.hki.ne.n>is
Könönen+N+Prop+Sem/Sur+Ess	Könösin	khˈø.nø>.sin
Könönen+N+Prop+Sem/Sur+Pl+Ill	Könösiidda	khˈø.nø>.sijt.tɑ
Könönen+N+Prop+Sem/Sur+Sg+Loc	Könösis	khˈø.nø>.sis
Könönen+N+Prop+Sem/Sur+Sg+Acc	Könönen	khˈø.nø.nen>
Lahtinen+N+Prop+Sem/Sur+Sg+Com	Lahtisiin	lˈɑh.ti>.sijn
Lahtonen+N+Prop+Sem/Sur+Ess	Lahtosin	lˈɑh.to>.sin
Lajunen+N+Prop+Sem/Sur+Sg+Acc	Lajunena	lˈɑ.ju.ne.n>ɑ
Lamminpää+N+Prop+Ess	Lamminpään	lˈɑmː.min#phˌæ.æ>n
Lankinen+N+Prop+Sem/Sur+Ess	Lankinenin	lˈɑŋŋ.ŋ̊ki.ne.n>in
Lankinen+N+Prop+Sem/Sur+Sg+Com	Lankineniin	lˈɑŋŋ.ŋ̊ki.ne.n>ijn
Larinen+N+Prop+Sem/Sur+Sg+Ill	Larisii	lˈɑ.ri>.sij
Lavikainen+N+Prop+Sem/Sur+Ess	Lavikainenin	lˈɑ.vi.kˌɑj.ne.n>in
Lehtonen+N+Prop+Sem/Sur+Pl+Com	Lehtosiiguin	lˈeh.to>.sij.gujn
Lehvonen+N+Prop+Sem/Sur+Pl+Nom	Lehvonenat	lˈeh.vo.ne.n>ɑh
Leivonen+N+Prop+Sem/Sur+Sg+Gen+Allegro	Leivonen	lˈejː.vo.nen>
Lemmetyinen+N+Prop+Sem/Sur+Sg+Com	Lemmetyineniin	lˈem.me.tˌyj.ne.n>ijn
Leskinen+N+Prop+Sem/Sur+Pl+Nom	Leskisat	lˈesː.ki>.sɑh
Lihavainen+N+Prop+Sem/Sur+Ess	Lihavainenin	lˈi.hɑː.vˌɑj.ne.n>in
Lihtonen+N+Prop+Sem/Sur+Pl+Nom	Lihtosat	lˈih.to>.sɑh
Liikkanen+N+Prop+Sem/Sur+Sg+Nom	Liikkanen	lˈijçç.kɑː.nen>
Likssjuo+N+Prop+Der/laš+A+Ess+PxSg2	Likssjuolažžanat	lˈiks.sjuo>.lɑdː.tʃɑ.nɑh
Linnanen+N+Prop+Sem/Sur+Sg+Gen	Linnasa	lˈinː.nɑː>.sɑ
Lipsanen+N+Prop+Sem/Sur+Ess	Lipsasin	lˈip.sɑː>.sin
Littunen+N+Prop+Sem/Sur+Ess	Littusin	lˈit.tu>.sin
Liukkonen+N+Prop+Sem/Sur+Pl+Nom	Liukkonenat	lˈi.uk.kˌo.ne.n>ɑh
Liukkonen+N+Prop+Sem/Sur+Sg+Acc	Liukkonen	lˈi.uk.kˌo.nen>
Loginen+N+Prop+Sem/Sur+Pl+Nom	Loginenat	lˈo.gi.ne.n>ɑh
Loginen+N+Prop+Sem/Sur+Sg+Gen+Allegro	Loginen	lˈo.gi.nen>
Loikkanen+N+Prop+Sem/Sur+Sg+Com	Loikkaneniin	lˈojçç.kɑː.ne.n>ijn
Loponen+N+Prop+Sem/Sur+Sg+Gen	Loposa	lˈo.po>.sɑ
Lottanen+N+Prop+Sem/Sur+Sg+Gen	Lottasa	lˈotː.tɑː>.sɑ
Louhelainen+N+Prop+Sem/Sur+Pl+Nom	Louhelainenat	lˈou.he.lˌɑj.ne.n>ɑh
Loukiainen+N+Prop+Sem/Sur+Pl+Nom	Loukiainenat	lˈou.ki.ˌɑj.ne.n>ɑh
Luhtanen+N+Prop+Sem/Sur+Pl+Nom	Luhtasat	lˈuhː.tɑː>.sɑh
Luhtanen+N+Prop+Sem/Sur+Pl+Nom	Luhtanenat	lˈuhː.tɑː.ne.n>ɑh
Luhtanen+N+Prop+Sem/Sur+Sg+Gen	Luhtanena	lˈuhː.tɑː.ne.n>ɑ
Lukkaroinen+N+Prop+Sem/Sur+Sg+Acc	Lukkaroinen	lˈukː.kɑː.rˌoj.nen>
Lukkaroinen+N+Prop+Sem/Sur+Sg+Gen	Lukkaroinena	lˈukː.kɑː.rˌoj.ne.n>ɑ
Luttinen+N+Prop+Sem/Sur+Ess	Luttisin	lˈut.ti>.sin
Luttinen+N+Prop+Sem/Sur+Ess	Luttinenin	lˈut.ti.ne.n>in
Luukkainen+N+Prop+Sem/Sur+Ess	Luukkainenin	lˈu.uk.kˌɑj.ne.n>in
Lyhykäinen+N+Prop+Sem/Sur+Sg+Gen	Lyhykäisa	lˈy.hy.kæj>.sɑ
Lyhykäinen+N+Prop+Sem/Sur+Pl+Nom	Lyhykäinenat	lˈy.hy.kˌæj.ne.n>ɑh
Lyijynen+N+Prop+Sem/Sur+Ess	Lyijynenin	lˈyj.jy.ne.n>in
Lyytikäinen+N+Prop+Sem/Sur+Pl+Com	Lyytikäisiiguin	lˈy.y.tˌi.kæj>.sij.gujn
Lyytikäinen+N+Prop+Sem/Sur+Sg+Ill	Lyytikäinenii	lˈy.y.tˌi.kæj.ne.n>ij
Lyytinen+N+Prop+Sem/Sur+Sg+Loc	Lyytinenis	lˈy.y.tˌi.ne.n>is
Lähteinen+N+Prop+Sem/Sur+Ess	Lähteisin	lˈæh.tej>.sin
Lähteinen+N+Prop+Sem/Sur+Pl+Nom	Lähteisat	lˈæh.tej>.sɑh
Lähteinen+N+Prop+Sem/Sur+Pl+Ill	Lähteisiidda	lˈæh.tej>.sijt.tɑ
Lähteinen+N+Prop+Sem/Sur+Sg+Gen	Lähteinena	lˈæh.tej.ne.n>ɑ
Löppönen+N+Prop+Sem/Sur+Sg+Gen	Löppösa	lˈøp.pø>.sɑ
Löppönen+N+Prop+Sem/Sur+Sg+Ill	Löppösii	lˈøp.pø>.sij
Löppönen+N+Prop+Sem/Sur+Pl+Nom	Löppönenat	lˈøp.pø.ne.n>ɑh
Lötjönen+N+Prop+Sem/Sur+Ess	Lötjösin	lˈøt.jø>.sin
Lötjönen+N+Prop+Sem/Sur+Sg+Acc	Lötjösa	lˈøt.jø>.sɑ
Löytönen+N+Prop+Sem/Sur+Ess	Löytösin	lˈø.y.tø>.sin
Löytönen+N+Prop+Sem/Sur+Sg+Gen+Allegro	Löytönen	lˈø.y.tˌø.nen>
Maljanen+N+Prop+Sem/Sur+Sg+Acc	Maljasa	mˈɑʎ.ʎɑː>.sɑ
Mankonen+N+Prop+Sem/Sur+Ess	Mankonenin	mˈɑŋŋ.ŋ̊ko.ne.n>in
Markkinen+N+Prop+Sem/Sur+Sg+Acc	Markkinena	mˈɑrr̥.ki.ne.n>ɑ
Markkinen+N+Prop+Sem/Sur+Sg+Com	Markkineniin	mˈɑrr̥.ki.ne.n>ijn
Mehtonen+N+Prop+Sem/Sur+Sg+Acc	Mehtonena	mˈeh.to.ne.n>ɑ
Mellanen+N+Prop+Sem/Sur+Ess	Mellanenin	mˈelː.lɑː.ne.n>in
Mensonen+N+Prop+Sem/Sur+Ess	Mensosin	mˈenː.so>.sin
Mensonen+N+Prop+Sem/Sur+Sg+Ill	Mensonenii	mˈenː.so.ne.n>ij
Meronen+N+Prop+Sem/Sur+Pl+Nom	Meronenat	mˈe.ro.ne.n>ɑh
Mertanen+N+Prop+Sem/Sur+Pl+Nom	Mertanenat	mˈerə.htɑ.ne.n>ɑh
Meskanen+N+Prop+Sem/Sur+Sg+Ill	Meskasii	mˈesː.kɑː>.sij
Metsänen+N+Prop+Sem/Sur+Sg+Gen	Metsäsa	mˈet.sæ>.sɑ
Mieskonen+N+Prop+Sem/Sur+Sg+Acc	Mieskonena	mˈĭesː.ko.ne.n>ɑ
Miinalainen+N+Prop+Sem/Sur+Pl+Nom	Miinalainenat	mˈij.nɑː.lˌɑj.ne.n>ɑh
Mikkanen+N+Prop+Sem/Sur+Pl+Ill	Mikkasiidda	mˈikː.kɑː>.sijt.tɑ
Mikkanen+N+Prop+Sem/Sur+Sg+Acc	Mikkanena	mˈikː.kɑː.ne.n>ɑ
Moilanen+N+Prop+Sem/Sur+Pl+Acc	Moilasiid	mˈojː.lɑː>.sijh
Moisanen+N+Prop+Sem/Sur+Ess	Moisasin	mˈojː.sɑː>.sin
Mononen+N+Prop+Sem/Sur+Ess	Monosin	mˈo.no>.sin
Montonen+N+Prop+Sem/Sur+Pl+Acc	Montosiid	mˈonː.n̥to>.sijh
Montonen+N+Prop+Sem/Sur+Ess	Montonenin	mˈonː.n̥to.ne.n>in
Montonen+N+Prop+Sem/Sur+Sg+Gen	Montonena	mˈonː.n̥to.ne.n>ɑ
Muhonen+N+Prop+Sem/Sur+Pl+Nom	Muhonenat	mˈu.ho.ne.n>ɑh
Muhonen+N+Prop+Sem/Sur+Sg+Ill	Muhonenii	mˈu.ho.ne.n>ij
Muinonen+N+Prop+Sem/Sur+Sg+Acc	Muinosa	mˈuj.no>.sɑ
Mujunen+N+Prop+Sem/Sur+Sg+Gen	Mujunena	mˈu.ju.ne.n>ɑ
Muonio+N+Prop+Sg+Nom	Muonio	mˈuo.nio>
Muranen+N+Prop+Sem/Sur+Sg+Acc	Muranena	mˈu.rɑː.ne.n>ɑ
Mustonen+N+Prop+Sem/Sur+Pl+Gen	Mustosiid	mˈusː.to>.sijh
Mutanen+N+Prop+Sem/Sur+Pl+Nom	Mutasat	mˈu.tɑː>.sɑh
Muukkonen+N+Prop+Sem/Sur+Sg+Ill	Muukkosii	mˈu.uk.ko>.sij
Muurinen+N+Prop+Sem/Sur+Pl+Nom	Muurisat	mˈu.u.ri>.sɑh
Mynttinen+N+Prop+Sem/Sur+Ess	Mynttisin	mˈynn̥.ti>.sin
Mynttinen+N+Prop+Sem/Sur+Sg+Loc	Mynttinenis	mˈynn̥.ti.ne.n>is
Myyryläinen+N+Prop+Sem/Sur+Pl+Nom	Myyryläisat	mˈy.y.rˌy.læj>.sɑh
Myyryläinen+N+Prop+Sem/Sur+Pl+Gen	Myyryläisiid	mˈy.y.rˌy.læj>.sijh
Mähönen+N+Prop+Sem/Sur+Pl+Nom	Mähösat	mˈæ.hø>.sɑh
Mähönen+N+Prop+Sem/Sur+Sg+Gen	Mähösa	mˈæ.hø>.sɑ
Mähönen+N+Prop+Sem/Sur+Sg+Acc	Mähönen	mˈæ.hø.nen>
Mähönen+N+Prop+Sem/Sur+Sg+Gen	Mähönena	mˈæ.hø.ne.n>ɑ
Mäkeläinen+N+Prop+Sem/Sur+Ess	Mäkeläinenin	mˈæ.ke.lˌæj.ne.n>in
Mäkipää+N+Prop+Sg+Gen	Mäkipää	mˈæ.ki#phˌæ.æ>
Mälkönen+N+Prop+Sem/Sur+Sg+Loc	Mälkösis	mˈælə.hkø>.sis
Mäntynen+N+Prop+Sem/Sur+Pl+Com	Mäntysiiguin	mˈænː.n̥ty>.sij.gujn
Mäntynen+N+Prop+Sem/Sur+Sg+Loc	Mäntynenis	mˈænː.n̥ty.ne.n>is
Määttänen+N+Prop+Sem/Sur+Ess	Määttäsin	mˈæ.æt.tæ>.sin
Mökkönen+N+Prop+Sem/Sur+Sg+Loc	Mökkösis	mˈøk.kø>.sis
Mökkönen+N+Prop+Sem/Sur+Sg+Gen	Mökkönena	mˈøk.kø.ne.n>ɑ
Mölkänen+N+Prop+Sem/Sur+Sg+Nom	Mölkänen	mˈølə.hkæ.nen>
Mönkkönen+N+Prop+Sem/Sur+Pl+Nom	Mönkkösat	mˈøŋŋ̊.kø>.sɑh
Mönttinen+N+Prop+Sem/Sur+Sg+Acc	Mönttinen	mˈønn̥.ti.nen>
Mönttinen+N+Prop+Sem/Sur+Sg+Acc	Mönttinena	mˈønn̥.ti.ne.n>ɑ
Möttönen+N+Prop+Sem/Sur+Pl+Nom	Möttösat	mˈøt.tø>.sɑh
Möttönen+N+Prop+Sem/Sur+Sg+Com	Möttösiin	mˈøt.tø>.sijn
Möykkynen+N+Prop+Sem/Sur+Sg+Com	Möykkysiin	mˈø.yk.ky>.sijn
Möykkynen+N+Prop+Sem/Sur+Sg+Com	Möykkyneniin	mˈø.yk.kˌy.ne.n>ijn
Narinen+N+Prop+Sem/Sur+Ess	Narisin	nˈɑ.ri>.sin
Narinen+N+Prop+Sem/Sur+Pl+Nom	Narisat	nˈɑ.ri>.sɑh
Narinen+N+Prop+Sem/Sur+Sg+Acc	Narisa	nˈɑ.ri>.sɑ
Narinen+N+Prop+Sem/Sur+Pl+Nom	Narinenat	nˈɑ.ri.ne.n>ɑh
Narinen+N+Prop+Sem/Sur+Sg+Gen+Allegro	Narinen	nˈɑ.ri.nen>
Natunen+N+Prop+Sem/Sur+Sg+Gen	Natusa	nˈɑ.tu>.sɑ
Natunen+N+Prop+Sem/Sur+Ess	Natunenin	nˈɑ.tu.ne.n>in
Natunen+N+Prop+Sem/Sur+Pl+Gen	Natuneniid	nˈɑ.tu.ne.n>ijh
Natunen+N+Prop+Sem/Sur+Sg+Gen+Allegro	Natunen	nˈɑ.tu.nen>
Natunen+N+Prop+Sem/Sur+Sg+Ill	Natunenii	nˈɑ.tu.ne.n>ij
Natunen+N+Prop+Sem/Sur+Sg+Loc	Natunenis	nˈɑ.tu.ne.n>is
Nenonen+N+Prop+Sem/Sur+Sg+Gen	Nenosa	nˈe.no>.sɑ
Nenonen+N+Prop+Sem/Sur+Sg+Loc	Nenosis	nˈe.no>.sis
Nenonen+N+Prop+Sem/Sur+Ess	Nenonenin	nˈe.no.ne.n>in
Nenonen+N+Prop+Sem/Sur+Pl+Nom	Nenonenat	nˈe.no.ne.n>ɑh
Nenonen+N+Prop+Sem/Sur+Pl+Gen	Nenoneniid	nˈe.no.ne.n>ijh
Neuvonen+N+Prop+Sem/Sur+Pl+Com	Neuvosiiguin	nˈeu.vo>.sij.gujn
Neuvonen+N+Prop+Sem/Sur+Sg+Loc	Neuvonenis	nˈeu.vo.ne.n>is
Nevalainen+N+Prop+Sem/Sur+Sg+Acc	Nevalainena	nˈe.vɑː.lˌɑj.ne.n>ɑ
Nevanpää+N+Prop+Der/laš+A+Sg+Ill	Nevanpäälažžii	nˈe.vɑːn#phˌæ.æ>.lɑdː.tʃij
Niiranen+N+Prop+Sem/Sur+Ess	Niiranenin	nˈijː.rɑː.ne.n>in
Niitovuopio+N+Prop+Sem/Sur+Sg+Acc	Niitovuopio	nˈijː.çto.vˌuo.pio>
Nisonen+N+Prop+Sem/Sur+Ess	Nisosin	nˈi.so>.sin
Nissinen+N+Prop+Sem/Sur+Ess	Nissisin	nˈis.si>.sin
Nissinen+N+Prop+Sem/Sur+Sg+Acc	Nissisa	nˈis.si>.sɑ
Nissinen+N+Prop+Sem/Sur+Pl+Loc	Nissineniin	nˈis.si.ne.n>ijn
Nissinen+N+Prop+Sem/Sur+Sg+Acc	Nissinen	nˈis.si.nen>
Niukkanen+N+Prop+Sem/Sur+Ess	Niukkanenin	nˈi.uk.kˌɑ.ne.n>in
Niutanen+N+Prop+Sem/Sur+Pl+Nom	Niutasat	nˈi.u.tɑ>.sɑh
Nivalainen+N+Prop+Sem/Sur+Pl+Nom	Nivalainenat	nˈi.vɑː.lˌɑj.ne.n>ɑh
Nivalainen+N+Prop+Sem/Sur+Pl+Gen	Nivalaineniid	nˈi.vɑː.lˌɑj.ne.n>ijh
Nojonen+N+Prop+Sem/Sur+Pl+Acc	Nojoneniid	nˈo.jo.ne.n>ijh
Nojonen+N+Prop+Sem/Sur+Pl+Loc	Nojoneniin	nˈo.jo.ne.n>ijn
Nojonen+N+Prop+Sem/Sur+Sg+Acc	Nojonena	nˈo.jo.ne.n>ɑ
Nokelainen+N+Prop+Sem/Sur+Ess	Nokelaisin	nˈo.ke.lɑj>.sin
Nokelainen+N+Prop+Sem/Sur+Sg+Ill	Nokelaisii	nˈo.ke.lɑj>.sij
Noronen+N+Prop+Sem/Sur+Ess	Noronenin	nˈo.ro.ne.n>in
Nortunen+N+Prop+Sem/Sur+Ess	Nortunenin	nˈorə.htu.ne.n>in
Nousiainen+N+Prop+Sg+Ill	Nousiainenii	nˈou.si.ˌɑj.ne.n>ij
Nousiainen+N+Prop+Der/laš+A+Sg+Nom+PxDu2	Nousiailažžade	nˈou.si.ˌɑjː.lɑdː.tʃˌɑ.de
Nousiainen+N+Prop+Der/laš+A+Sg+Nom+PxPl3	Nousiailažžaset	nˈou.si.ˌɑjː.lɑdː.tʃˌɑ.seh
Nousiainen+N+Prop+Der/laš+A+Pl+Loc+PxPl2	Nousiainenlaččaineattet	nˈou.si.ˌɑj.nen.lˌɑt.tʃɑj.n>ĕæt.teh
Nukarinen+N+Prop+Sem/Sur+Pl+Ill	Nukarisiidda	nˈu.kɑː.ri>.sijt.tɑ
Nummenpää+N+Prop+Der/laš+A+Attr	Nummenpäälaš	nˈum.men#phˌæ.æ>.lɑʃ
Nupponen+N+Prop+Sem/Sur+Ess	Nupposin	nˈup.po>.sin
Nupponen+N+Prop+Sem/Sur+Sg+Gen	Nupposa	nˈup.po>.sɑ
Nupponen+N+Prop+Sem/Sur+Sg+Nom	Nupponen	nˈup.po.nen>
Nurhonen+N+Prop+Sem/Sur+Ess	Nurhosin	nˈur.ho>.sin
Nurhonen+N+Prop+Sem/Sur+Pl+Gen	Nurhoneniid	nˈur.ho.ne.n>ijh
Nurminen+N+Prop+Sem/Sur+Sg+Loc	Nurmisis	nˈur.mi>.sis
Nurminen+N+Prop+Sem/Sur+Pl+Nom	Nurminenat	nˈur.mi.ne.n>ɑh
Nuutilainen+N+Prop+Sem/Sur+Ess	Nuutilainenin	nˈu.u.tˌi.lɑj.ne.n>in
Nuutinen+N+Prop+Sem/Sur+Pl+Nom	Nuutinenat	nˈu.u.tˌi.ne.n>ɑh
Nykänen+N+Prop+Sem/Sur+Ess	Nykänenin	nˈy.kæ.ne.n>in
Nyyssönen+N+Prop+Sem/Sur+Ess	Nyyssösin	nˈy.ys.sø>.sin
Nyyssönen+N+Prop+Sem/Sur+Pl+Com	Nyyssösiiguin	nˈy.ys.sø>.sij.gujn
Nyyssönen+N+Prop+Sem/Sur+Sg+Acc	Nyyssösa	nˈy.ys.sø>.sɑ
Nyyssönen+N+Prop+Sem/Sur+Pl+Nom	Nyyssönenat	nˈy.ys.sˌø.ne.n>ɑh
Näsänen+N+Prop+Sem/Sur+Ess	Näsäsin	nˈæ.sæ>.sin
Näätänen+N+Prop+Sem/Sur+Pl+Nom	Näätäsat	nˈæ.æ.tæ>.sɑh
Näätänen+N+Prop+Sem/Sur+Sg+Gen+Allegro	Näätänen	nˈæ.æ.tˌæ.nen>
Näätänen+N+Prop+Sem/Sur+Sg+Gen	Näätänena	nˈæ.æ.tˌæ.ne.n>ɑ
Ohtonen+N+Prop+Sem/Sur+Ess	Ohtosin	ˈoh.to>.sin
Ohtonen+N+Prop+Sem/Sur+Pl+Nom	Ohtosat	ˈoh.to>.sɑh
Ohtonen+N+Prop+Sem/Sur+Sg+Acc	Ohtosa	ˈoh.to>.sɑ
Ohtonen+N+Prop+Sem/Sur+Sg+Com	Ohtosiin	ˈoh.to>.sijn
Ohtonen+N+Prop+Sem/Sur+Ess	Ohtonenin	ˈoh.to.ne.n>in
Ohtonen+N+Prop+Sem/Sur+Pl+Com	Ohtoneniiguin	ˈoh.to.ne.n>ij.gujn
Ohtonen+N+Prop+Sem/Sur+Sg+Gen+Allegro	Ohtonen	ˈoh.to.nen>
Oikarainen+N+Prop+Ess	Oikarainenin	ˈojː.çkɑ.rˌɑj.ne.n>in
Oikkonen+N+Prop+Sem/Sur+Sg+Loc	Oikkonenis	ˈojç.ko.ne.n>is
Oinonen+N+Prop+Sem/Sur+Sg+Ill	Oinosii	ˈoj.no>.sij
Oinonen+N+Prop+Sem/Sur+Pl+Nom	Oinonenat	ˈoj.no.ne.n>ɑh
Oivanen+N+Prop+Sem/Sur+Sg+Ill	Oivasii	ˈojː.vɑː>.sij
Oivanen+N+Prop+Sem/Sur+Pl+Ill	Oivaneniidda	ˈojː.vɑː.ne.n>ijt.tɑ
Ojanen+N+Prop+Sem/Sur+Sg+Loc	Ojasis	ˈo.jɑː>.sis
Ojanen+N+Prop+Sem/Sur+Pl+Nom	Ojanenat	ˈo.jɑː.ne.n>ɑh
Ojanen+N+Prop+Sem/Sur+Sg+Gen	Ojanena	ˈo.jɑː.ne.n>ɑ
Ojansuu+N+Prop+Sem/Sur+Pl+Nom	Ojansuut	ˈo.jɑːn#sˌu.u>h
Ojansuu+N+Prop+Sem/Sur+Sg+Loc	Ojansuus	ˈo.jɑːn#sˌu.u>s
Okkonen+N+Prop+Sem/Sur+Sg+Acc	Okkosa	ˈok.ko>.sɑ
Okkonen+N+Prop+Sem/Sur+Sg+Gen	Okkosa	ˈok.ko>.sɑ
Okkonen+N+Prop+Sem/Sur+Pl+Nom	Okkonenat	ˈok.ko.ne.n>ɑh
Oksanen+N+Prop+Sem/Sur+Sg+Ill	Oksasii	ˈokː.sɑː>.sij
Oksanen+N+Prop+Sem/Sur+Ess	Oksanenin	ˈokː.sɑː.ne.n>in
Olkinuora+N+Prop+Sem/Sur+Ess	Olkinuoran	ˈolə.hki.nˌuo.rɑ>n
Olkkonen+N+Prop+Sem/Sur+Sg+Loc	Olkkonenis	ˈoll̥.ko.ne.n>is
Ollilainen+N+Prop+Sem/Sur+Ess	Ollilaisin	ˈol.li.lɑj>.sin
Ollilainen+N+Prop+Sem/Sur+Pl+Nom	Ollilaisat	ˈol.li.lɑj>.sɑh
Ollilainen+N+Prop+Sem/Sur+Pl+Acc	Ollilaineniid	ˈol.li.lˌɑj.ne.n>ijh
Ollilainen+N+Prop+Sem/Sur+Sg+Gen	Ollilainena	ˈol.li.lˌɑj.ne.n>ɑ
Ollinen+N+Prop+Sem/Sur+Pl+Ill	Ollisiidda	ˈol.li>.sijt.tɑ
Ollonen+N+Prop+Sem/Sur+Sg+Nom	Ollonen	ˈol.lo.nen>
Oranen+N+Prop+Sem/Sur+Pl+Gen	Orasiid	ˈo.rɑː>.sijh
Oranen+N+Prop+Sem/Sur+Sg+Acc	Oranena	ˈo.rɑː.ne.n>ɑ
Oravainen+N+Prop+Der/laš+A+Pl+Nom	Oravainenlaččat	ˈo.rɑː.vˌɑj.nen.lˌɑt.tʃɑh
Otranen+N+Prop+Sem/Sur+Ess	Otrasin	ˈot.rɑː>.sin
Otranen+N+Prop+Sem/Sur+Pl+Acc	Otrasiid	ˈot.rɑː>.sijh
Otranen+N+Prop+Sem/Sur+Sg+Loc	Otrasis	ˈot.rɑː>.sis
Otranen+N+Prop+Sem/Sur+Pl+Nom	Otranenat	ˈot.rɑː.ne.n>ɑh
Otranen+N+Prop+Sem/Sur+Sg+Nom	Otranen	ˈot.rɑː.nen>
Ottavainen+N+Prop+Sem/Sur+Pl+Loc	Ottavaisiin	ˈotː.tɑː.vɑj>.sijn
Ottavainen+N+Prop+Sem/Sur+Sg+Loc	Ottavaisis	ˈotː.tɑː.vɑj>.sis
Ottavainen+N+Prop+Sem/Sur+Pl+Nom	Ottavainenat	ˈotː.tɑː.vˌɑj.ne.n>ɑh
Ottavainen+N+Prop+Sem/Sur+Sg+Gen	Ottavainena	ˈotː.tɑː.vˌɑj.ne.n>ɑ
Outinen+N+Prop+Sem/Sur+Pl+Nom	Outisat	ˈou.ti>.sɑh
Outinen+N+Prop+Sem/Sur+Pl+Acc	Outisiid	ˈou.ti>.sijh
Outinen+N+Prop+Sem/Sur+Sg+Acc	Outisa	ˈou.ti>.sɑ
Outinen+N+Prop+Sem/Sur+Sg+Gen	Outisa	ˈou.ti>.sɑ
Outinen+N+Prop+Sem/Sur+Sg+Com	Outisiin	ˈou.ti>.sijn
Outinen+N+Prop+Sem/Sur+Sg+Ill	Outisii	ˈou.ti>.sij
Outinen+N+Prop+Sem/Sur+Ess	Outinenin	ˈou.ti.ne.n>in
Outinen+N+Prop+Sem/Sur+Pl+Nom	Outinenat	ˈou.ti.ne.n>ɑh
Outinen+N+Prop+Sem/Sur+Pl+Loc	Outineniin	ˈou.ti.ne.n>ijn
Outinen+N+Prop+Sem/Sur+Sg+Gen+Allegro	Outinen	ˈou.ti.nen>
Outinen+N+Prop+Sem/Sur+Sg+Nom	Outinen	ˈou.ti.nen>
Outinen+N+Prop+Sem/Sur+Sg+Acc	Outinena	ˈou.ti.ne.n>ɑ
Pakanen+N+Prop+Sem/Sur+Ess	Pakanenin	phˈɑ.kɑː.ne.n>in
Pakkanen+N+Prop+Sem/Sur+Pl+Loc	Pakkaneniin	phˈɑkː.kɑː.ne.n>ijn
Pakonen+N+Prop+Sem/Sur+Sg+Gen	Pakosa	phˈɑ.ko>.sɑ
Palonen+N+Prop+Sem/Sur+Pl+Nom	Palosat	phˈɑ.lo>.sɑh
Pappinen+N+Prop+Der/laš+A+Sg+Acc+PxDu1	Pappinenlažžame	phˈɑp.pi.nˌen.lɑdː.tʃˌɑ.me
Parantainen+N+Prop+Sem/Sur+Pl+Gen	Parantaisiid	phˈɑ.rɑːnː.n̥tɑj>.sijh
Parkkonen+N+Prop+Sem/Sur+Pl+Acc	Parkkosiid	phˈɑrr̥.ko>.sijh
Parviainen+N+Prop+Sem/Sur+Sg+Loc	Parviainenis	phˈɑrə.vi.ˌɑj.ne.n>is
Patanen+N+Prop+Sem/Sur+Sg+Loc	Patanenis	phˈɑ.tɑː.ne.n>is
Pehkonen+N+Prop+Sem/Sur+Sg+Loc	Pehkosis	phˈeh.ko>.sis
Peiponen+N+Prop+Sem/Sur+Ess	Peiposin	phˈejː.çpo>.sin
Pekkarinen+N+Prop+Sem/Sur+Pl+Com	Pekkarineniiguin	phˈekː.kɑː.rˌi.ne.n>ij.gujn
Pekonen+N+Prop+Sem/Sur+Pl+Com	Pekosiiguin	phˈe.ko>.sij.gujn
Pessinen+N+Prop+Sem/Sur+Pl+Nom	Pessisat	phˈes.si>.sɑh
Peuhkurinen+N+Prop+Sem/Sur+Ess	Peuhkurisin	phˈeuh.ku.ri>.sin
Peuhkurinen+N+Prop+Sem/Sur+Sg+Ill	Peuhkurisii	phˈeuh.ku.ri>.sij
Peuhkurinen+N+Prop+Sem/Sur+Ess	Peuhkurinenin	phˈeuh.ku.rˌi.ne.n>in
Piaskainen+N+Prop+Sem/Sur+Ess	Piaskainenin	phˈi.ɑs.kˌɑj.ne.n>in
Pieviläinen+N+Prop+Sem/Sur+Sg+Ill	Pieviläisii	phˈie.vi.læj>.sij
Piilonen+N+Prop+Sem/Sur+Sg+Ill	Piilosii	phˈijː.lo>.sij
Piilonen+N+Prop+Sem/Sur+Pl+Gen	Piiloneniid	phˈijː.lo.ne.n>ijh
Pikkarainen+N+Prop+Sem/Sur+Pl+Acc	Pikkaraisiid	phˈikː.kɑː.rɑj>.sijh
Piltonen+N+Prop+Sem/Sur+Sg+Acc	Piltonena	phˈilː.l̥to.ne.n>ɑ
Pirttinen+N+Prop+Sem/Sur+Sg+Ill	Pirttisii	phˈirr̥.ti>.sij
Piskonen+N+Prop+Sem/Sur+Sg+Com	Piskoneniin	phˈisː.ko.ne.n>ijn
Poikonen+N+Prop+Sem/Sur+Ess	Poikosin	phˈojː.çko>.sin
Poikulainen+N+Prop+Sem/Sur+Pl+Acc	Poikulaisiid	phˈojː.çku.lɑj>.sijh
Poranen+N+Prop+Sem/Sur+Pl+Gen	Poraneniid	phˈo.rɑː.ne.n>ijh
Poranen+N+Prop+Sem/Sur+Pl+Loc	Poraneniin	phˈo.rɑː.ne.n>ijn
Prittinen+N+Prop+Sem/Sur+Ess	Prittisin	prˈit.ti>.sin
Prittinen+N+Prop+Sem/Sur+Pl+Loc	Prittisiin	prˈit.ti>.sijn
Prittinen+N+Prop+Sem/Sur+Sg+Gen	Prittisa	prˈit.ti>.sɑ
Prittinen+N+Prop+Sem/Sur+Ess	Prittinenin	prˈit.ti.ne.n>in
Prittinen+N+Prop+Sem/Sur+Pl+Gen	Prittineniid	prˈit.ti.ne.n>ijh
Prittinen+N+Prop+Sem/Sur+Sg+Gen+Allegro	Prittinen	prˈit.ti.nen>
Prittinen+N+Prop+Sem/Sur+Sg+Nom	Prittinen	prˈit.ti.nen>
Prittinen+N+Prop+Sem/Sur+Sg+Acc	Prittinena	prˈit.ti.ne.n>ɑ
Puikkonen+N+Prop+Sem/Sur+Pl+Nom	Puikkonenat	phˈujç.ko.ne.n>ɑh
Pulkkinen+N+Prop+Sem/Sur+Pl+Acc	Pulkkisiid	phˈull̥.ki>.sijh
Punkkinen+N+Prop+Sem/Sur+Pl+Nom	Punkkinenat	phˈuŋŋ̊.ki.ne.n>ɑh
Punkkinen+N+Prop+Sem/Sur+Sg+Gen+Allegro	Punkkinen	phˈuŋŋ̊.ki.nen>
Puolakanaho+N+Prop+Sem/Sur+Ess	Puolakanahon	phˈuo.lɑ.kɑn#ˌɑ.ho>n
Pykäläinen+N+Prop+Sem/Sur+Sg+Ill	Pykäläisii	phˈy.kæ.læj>.sij
Pylvänäinen+N+Prop+Sem/Sur+Ess	Pylvänäisin	phˈylə.væ.næj>.sin
Pynnönen+N+Prop+Sem/Sur+Sg+Gen	Pynnösa	phˈyn.nø>.sɑ
Pyrhönen+N+Prop+Sem/Sur+Ess	Pyrhösin	phˈyr.hø>.sin
Pyrhönen+N+Prop+Sem/Sur+Sg+Acc	Pyrhösa	phˈyr.hø>.sɑ
Pystynen+N+Prop+Sem/Sur+Pl+Gen	Pystyneniid	phˈysː.ty.ne.n>ijh
Pyykkönen+N+Prop+Sem/Sur+Sg+Ill	Pyykkönenii	phˈy.yk.kˌø.ne.n>ij
Päivinen+N+Prop+Sem/Sur+Pl+Nom	Päivisat	phˈæjː.vi>.sɑh
Päivinen+N+Prop+Sem/Sur+Ess	Päivinenin	phˈæjː.vi.ne.n>in
Pänkäläinen+N+Prop+Sem/Sur+Ess	Pänkäläisin	phˈæŋŋ.ŋ̊kæ.læj>.sin
Pärssinen+N+Prop+Sem/Sur+Sg+Gen+Allegro	Pärssinen	phˈærs.si.nen>
Pätynen+N+Prop+Sem/Sur+Pl+Nom	Pätynenat	phˈæ.ty.ne.n>ɑh
Päätalo+N+Prop+Sem/Sur+Sg+Loc	Päätalos	phˈæ.æ#thˌɑ.lo>s
Pönkänen+N+Prop+Sem/Sur+Sg+Loc	Pönkäsis	phˈøŋŋ.ŋ̊kæ>.sis
Pöppönen+N+Prop+Sem/Sur+Pl+Nom	Pöppösat	phˈøp.pø>.sɑh
Pöppönen+N+Prop+Sem/Sur+Pl+Nom	Pöppönenat	phˈøp.pø.ne.n>ɑh
Pöyhönen+N+Prop+Sem/Sur+Ess	Pöyhösin	phˈø.y.hø>.sin
Pöyhönen+N+Prop+Sem/Sur+Pl+Nom	Pöyhösat	phˈø.y.hø>.sɑh
Pöyhönen+N+Prop+Sem/Sur+Pl+Ill	Pöyhösiidda	phˈø.y.hø>.sijt.tɑ
Pöyhönen+N+Prop+Sem/Sur+Pl+Loc	Pöyhösiin	phˈø.y.hø>.sijn
Pöyhönen+N+Prop+Sem/Sur+Ess	Pöyhönenin	phˈø.y.hˌø.ne.n>in
Pöyhönen+N+Prop+Sem/Sur+Sg+Com	Pöyhöneniin	phˈø.y.hˌø.ne.n>ijn
Raivonen+N+Prop+Sem/Sur+Pl+Nom	Raivonenat	rˈɑjː.vo.ne.n>ɑh
Raninen+N+Prop+Sem/Sur+Ess	Raninenin	rˈɑ.ni.ne.n>in
Rankinen+N+Prop+Sem/Sur+Pl+Nom	Rankisat	rˈɑŋŋ.ŋ̊ki>.sɑh
Rantonen+N+Prop+Sem/Sur+Sg+Acc	Rantonena	rˈɑnː.n̥to.ne.n>ɑ
Reinikainen+N+Prop+Sem/Sur+Pl+Ill	Reinikaisiidda	rˈej.ni.kɑj>.sijt.tɑ
Reinikainen+N+Prop+Sem/Sur+Pl+Nom	Reinikainenat	rˈej.ni.kˌɑj.ne.n>ɑh
Reinikainen+N+Prop+Sem/Sur+Pl+Ill	Reinikaineniidda	rˈej.ni.kˌɑj.ne.n>ijt.tɑ
Rekonen+N+Prop+Sem/Sur+Sg+Gen	Rekosa	rˈe.ko>.sɑ
Rekonen+N+Prop+Sem/Sur+Pl+Gen	Rekoneniid	rˈe.ko.ne.n>ijh
Reunanen+N+Prop+Sem/Sur+Sg+Loc	Reunanenis	rˈeu.nɑ.ne.n>is
Rimpinen+N+Prop+Sem/Sur+Ess	Rimpinenin	rˈimː.m̥pi.ne.n>in
Rimpinen+N+Prop+Sem/Sur+Sg+Ill	Rimpinenii	rˈimː.m̥pi.ne.n>ij
Rinkinen+N+Prop+Sem/Sur+Ess	Rinkinenin	rˈiŋŋ.ŋ̊ki.ne.n>in
Rintaluoma+N+Prop+Sem/Sur+Sg+Loc	Rintaluomas	rˈinː.n̥tɑ#lˌuo.mɑ>s
Ristolainen+N+Prop+Sem/Sur+Ess	Ristolainenin	rˈisː.to.lˌɑj.ne.n>in
Ritvanen+N+Prop+Sem/Sur+Pl+Ill	Ritvaneniidda	rˈit.vɑː.ne.n>ijt.tɑ
Roikanen+N+Prop+Sem/Sur+Sg+Acc	Roikasa	rˈojː.çkɑ>.sɑ
Romppainen+N+Prop+Sem/Sur+Ess	Romppaisin	rˈomm̥ː.pɑːj>.sin
Romunen+N+Prop+Sem/Sur+Sg+Acc	Romunen	rˈo.mu.nen>
Romunen+N+Prop+Sem/Sur+Sg+Ill	Romunenii	rˈo.mu.ne.n>ij
Ronkanen+N+Prop+Sem/Sur+Sg+Acc	Ronkanen	rˈoŋŋ.ŋ̊kɑ.nen>
Rouvinen+N+Prop+Sem/Sur+Sg+Acc	Rouvisa	rˈou.vi>.sɑ
Ruhanen+N+Prop+Sem/Sur+Pl+Nom	Ruhasat	rˈu.hɑː>.sɑh
Rummukainen+N+Prop+Sem/Sur+Sg+Acc	Rummukainen	rˈum.mu.kˌɑj.nen>
Ruokonen+N+Prop+Sem/Sur+Sg+Acc	Ruokosa	rˈŭo.ko>.sɑ
Ruotanen+N+Prop+Sem/Sur+Pl+Nom	Ruotanenat	rˈuo.tɑ.ne.n>ɑh
Rusanen+N+Prop+Sem/Sur+Ess	Rusanenin	rˈu.sɑː.ne.n>in
Ryhänen+N+Prop+Sem/Sur+Pl+Ill	Ryhäsiidda	rˈy.hæ>.sijt.tɑ
Ryhänen+N+Prop+Sem/Sur+Sg+Acc	Ryhäsa	rˈy.hæ>.sɑ
Rytkönen+N+Prop+Sem/Sur+Ess	Rytkösin	rˈytː.hkø>.sin
Rytkönen+N+Prop+Sem/Sur+Pl+Ill	Rytkösiidda	rˈytː.hkø>.sijt.tɑ
Ryynänen+N+Prop+Sem/Sur+Pl+Com	Ryynäsiiguin	rˈy.y.næ>.sij.gujn
Räikkönen+N+Prop+Sem/Sur+Sg+Acc	Räikkösa	rˈæjç.kø>.sɑ
Räikkönen+N+Prop+Sem/Sur+Sg+Nom	Räikkönen	rˈæjç.kø.nen>
Räkköläinen+N+Prop+Sem/Sur+Sg+Acc	Räkköläisa	rˈæk.kø.læj>.sɑ
Rämänen+N+Prop+Sem/Sur+Pl+Acc	Rämäsiid	rˈæ.mæ>.sijh
Rämänen+N+Prop+Sem/Sur+Sg+Loc	Rämäsis	rˈæ.mæ>.sis
Räsänen+N+Prop+Sem/Sur+Pl+Nom	Räsäsat	rˈæ.sæ>.sɑh
Räsänen+N+Prop+Sem/Sur+Sg+Com	Räsäsiin	rˈæ.sæ>.sijn
Räsänen+N+Prop+Sem/Sur+Sg+Ill	Räsäsii	rˈæ.sæ>.sij
Räsänen+N+Prop+Sem/Sur+Pl+Nom	Räsänenat	rˈæ.sæ.ne.n>ɑh
Räsänen+N+Prop+Sem/Sur+Pl+Acc	Räsäneniid	rˈæ.sæ.ne.n>ijh
Räsänen+N+Prop+Sem/Sur+Sg+Acc	Räsänen	rˈæ.sæ.nen>
Röntynen+N+Prop+Sem/Sur+Sg+Com	Röntysiin	rˈønː.n̥ty>.sijn
Röntynen+N+Prop+Sem/Sur+Pl+Nom	Röntynenat	rˈønː.n̥ty.ne.n>ɑh
Röpelinen+N+Prop+Sem/Sur+Pl+Acc	Röpelisiid	rˈø.pe.li>.sijh
Röpelinen+N+Prop+Sem/Sur+Ess	Röpelinenin	rˈø.pe.lˌi.ne.n>in
Röpelinen+N+Prop+Sem/Sur+Sg+Acc	Röpelinena	rˈø.pe.lˌi.ne.n>ɑ
Röppänen+N+Prop+Sem/Sur+Ess	Röppäsin	rˈøp.pæ>.sin
Röppänen+N+Prop+Sem/Sur+Pl+Ill	Röppäneniidda	rˈøp.pæ.ne.n>ijt.tɑ
Sappinen+N+Prop+Sem/Sur+Sg+Com	Sappisiin	sˈɑp.pi>.sijn
Sappinen+N+Prop+Sem/Sur+Sg+Acc	Sappinena	sˈɑp.pi.ne.n>ɑ
Saukkonen+N+Prop+Sem/Sur+Sg+Acc	Saukkonena	sˈɑuk.ko.ne.n>ɑ
Savolainen+N+Prop+Sem/Sur+Sg+Nom	Savolainen	sˈɑ.vo.lˌɑj.nen>
Savolainen+N+Prop+Sem/Sur+Sg+Loc	Savolainenis	sˈɑ.vo.lˌɑj.ne.n>is
Seilonen+N+Prop+Sem/Sur+Sg+Loc	Seilonenis	sˈejː.lo.ne.n>is
Seitsonen+N+Prop+Sem/Sur+Sg+Gen	Seitsosa	sˈejt.so>.sɑ
Seitsonen+N+Prop+Sem/Sur+Sg+Com	Seitsosiin	sˈejt.so>.sijn
Selonen+N+Prop+Sem/Sur+Sg+Ill	Selosii	sˈe.lo>.sij
Selonen+N+Prop+Sem/Sur+Sg+Ill	Selonenii	sˈe.lo.ne.n>ij
Seppinen+N+Prop+Sem/Sur+Sg+Acc	Seppinen	sˈep.pi.nen>
Sepponen+N+Prop+Sem/Sur+Sg+Loc	Sepposis	sˈep.po>.sis
Seuranen+N+Prop+Sem/Sur+Pl+Com	Seurasiiguin	sˈeu.rɑ>.sij.gujn
Seuranen+N+Prop+Sem/Sur+Pl+Ill	Seuraneniidda	sˈeu.rɑ.ne.n>ijt.tɑ
Sihvonen+N+Prop+Sem/Sur+Sg+Com	Sihvoneniin	sˈih.vo.ne.n>ijn
Siivonen+N+Prop+Sem/Sur+Sg+Acc	Siivosa	sˈijː.vo>.sɑ
Sirainen+N+Prop+Sem/Sur+Pl+Gen	Siraisiid	sˈi.rɑːj>.sijh
Siuruainen+N+Prop+Sem/Sur+Ess	Siuruaisin	sˈi.u.rˌu.ɑj>.sin
Siuruainen+N+Prop+Sem/Sur+Pl+Nom	Siuruaisat	sˈi.u.rˌu.ɑj>.sɑh
Sohkanen+N+Prop+Sem/Sur+Ess	Sohkasin	sˈohː.kɑː>.sin
Sohkanen+N+Prop+Sem/Sur+Pl+Ill	Sohkasiidda	sˈohː.kɑː>.sijt.tɑ
Sohkanen+N+Prop+Sem/Sur+Pl+Nom	Sohkanenat	sˈohː.kɑː.ne.n>ɑh
Sohkanen+N+Prop+Sem/Sur+Pl+Loc	Sohkaneniin	sˈohː.kɑː.ne.n>ijn
Soininen+N+Prop+Sem/Sur+Pl+Nom	Soinisat	sˈoj.ni>.sɑh
Solonen+N+Prop+Sem/Sur+Sg+Acc	Solosa	sˈo.lo>.sɑ
Soronen+N+Prop+Sem/Sur+Sg+Gen+Allegro	Soronen	sˈo.ro.nen>
Suhonen+N+Prop+Sem/Sur+Sg+Acc	Suhosa	sˈu.ho>.sɑ
Suhonen+N+Prop+Sem/Sur+Pl+Gen	Suhoneniid	sˈu.ho.ne.n>ijh
Sukanen+N+Prop+Sem/Sur+Ess	Sukasin	sˈu.kɑː>.sin
Sulkanen+N+Prop+Sem/Sur+Pl+Nom	Sulkasat	sˈulə.hkɑ>.sɑh
Sulkanen+N+Prop+Sem/Sur+Sg+Acc	Sulkasa	sˈulə.hkɑ>.sɑ
Summanen+N+Prop+Sem/Sur+Pl+Ill	Summaneniidda	sˈumː.mɑː.ne.n>ijt.tɑ
Survonen+N+Prop+Sem/Sur+Pl+Nom	Survonenat	sˈurə.vo.ne.n>ɑh
Sutelainen+N+Prop+Sem/Sur+Sg+Loc	Sutelaisis	sˈu.te.lɑj>.sis
Suuronen+N+Prop+Sem/Sur+Sg+Ill	Suurosii	sˈu.u.ro>.sij
Suursalmi+N+Prop+Der/laš+A+Sg+Nom	Suursalmilaš	sˈu.ur#sˌɑlə.mi>.lɑʃ
Suutarinen+N+Prop+Sem/Sur+Pl+Nom	Suutarinenat	sˈu.u.tˌɑ.ri.ne.n>ɑh
Suvinen+N+Prop+Sem/Sur+Ess	Suvinenin	sˈu.vi.ne.n>in
Syrjäläinen+N+Prop+Sem/Sur+Pl+Gen	Syrjäläisiid	sˈyrə.jæ.læj>.sijh
Syrjänen+N+Prop+Sem/Sur+Sg+Acc	Syrjäsa	sˈyrə.jæ>.sɑ
Sysmäläinen+N+Prop+Sem/Sur+Sg+Acc	Sysmäläisa	sˈysː.mæ.læj>.sɑ
Syvänen+N+Prop+Sem/Sur+Sg+Ill	Syväsii	sˈy.væ>.sij
Säkkinen+N+Prop+Sem/Sur+Ess	Säkkisin	sˈæk.ki>.sin
Säkkinen+N+Prop+Sem/Sur+Sg+Com	Säkkisiin	sˈæk.ki>.sijn
Säkkinen+N+Prop+Sem/Sur+Pl+Ill	Säkkineniidda	sˈæk.ki.ne.n>ijt.tɑ
Sällinen+N+Prop+Sem/Sur+Pl+Acc	Sällisiid	sˈæl.li>.sijh
Sällinen+N+Prop+Sem/Sur+Sg+Acc	Sällisa	sˈæl.li>.sɑ
Särkinen+N+Prop+Sg+Acc	Särkisa	sˈærə.hki>.sɑ
Särkinen+N+Prop+Der/laš+A+Ess+PxSg3	Särkilažžanis	sˈærə.hki.lˌɑdː.tʃɑ.nis
Säämänen+N+Prop+Sem/Sur+Sg+Nom	Säämänen	sˈæ.æ.mˌæ.nen>
Sääski+N+Prop+Sem/Sur+Sg+Com	Sääskiin	sˈæ.æs.ki>in
Takkinen+N+Prop+Sem/Sur+Pl+Ill	Takkisiidda	thˈɑk.ki>.sijt.tɑ
Talvinen+N+Prop+Sem/Sur+Sg+Gen	Talvinena	thˈɑlə.vi.ne.n>ɑ
Tanninen+N+Prop+Sem/Sur+Ess	Tannisin	thˈɑn.ni>.sin
Tarhanen+N+Prop+Sem/Sur+Sg+Nom	Tarhanen	thˈɑr.hɑː.nen>
Tauriainen+N+Prop+Sem/Sur+Pl+Ill	Tauriaisiidda	thˈɑu.ri.ɑj>.sijt.tɑ
Tauriainen+N+Prop+Sem/Sur+Sg+Com	Tauriaineniin	thˈɑu.ri.ˌɑj.ne.n>ijn
Teittinen+N+Prop+Sem/Sur+Ess	Teittisin	thˈejç.ti>.sin
Teivainen+N+Prop+Sem/Sur+Pl+Nom	Teivainenat	thˈejː.vɑːj.ne.n>ɑh
Temonen+N+Prop+Sem/Sur+Pl+Com	Temosiiguin	thˈe.mo>.sij.gujn
Temonen+N+Prop+Sem/Sur+Ess	Temonenin	thˈe.mo.ne.n>in
Tenkanen+N+Prop+Sem/Sur+Pl+Nom	Tenkasat	thˈeŋŋ.ŋ̊kɑ>.sɑh
Tertsunen+N+Prop+Sem/Sur+Sg+Ill	Tertsusii	thˈert.su>.sij
Tervonen+N+Prop+Sem/Sur+Sg+Nom	Tervonen	thˈerə.vo.nen>
Tiainen+N+Prop+Sem/Sur+Sg+Com	Tiaisiin	thˈi.ɑj>.sijn
Tillanen+N+Prop+Sem/Sur+Sg+Nom	Tillanen	thˈilː.lɑː.nen>
Tillonen+N+Prop+Sem/Sur+Ess	Tillosin	thˈil.lo>.sin
Tolppanen+N+Prop+Sem/Sur+Pl+Nom	Tolppanenat	thˈoll̥ː.pɑː.ne.n>ɑh
Tomminen+N+Prop+Sem/Sur+Pl+Nom	Tommisat	thˈom.mi>.sɑh
Toppinen+N+Prop+Sem/Sur+Sg+Acc	Toppisa	thˈop.pi>.sɑ
Toropainen+N+Prop+Sem/Sur+Pl+Nom	Toropainenat	thˈo.ro.pˌɑj.ne.n>ɑh
Toroskainen+N+Prop+Sem/Sur+Sg+Acc	Toroskainen	thˈoː.ros.kˌɑj.nen>
Torssonen+N+Prop+Sem/Sur+Sg+Gen	Torssonena	thˈors.so.ne.n>ɑ
Torvinen+N+Prop+Sem/Sur+Pl+Com	Torvineniiguin	thˈorə.vi.ne.n>ij.gujn
Tourunen+N+Prop+Sem/Sur+Pl+Nom	Tourunenat	thˈou.ru.ne.n>ɑh
Truhponen+N+Prop+Sem/Sur+Pl+Nom	Truhposat	trˈuh.po>.sɑh
Truhponen+N+Prop+Sem/Sur+Sg+Ill	Truhposii	trˈuh.po>.sij
Truhponen+N+Prop+Sem/Sur+Pl+Acc	Truhponeniid	trˈuh.po.ne.n>ijh
Truhponen+N+Prop+Sem/Sur+Sg+Acc	Truhponen	trˈuh.po.nen>
Tsutsunen+N+Prop+Sem/Sur+Pl+Nom	Tsutsusat	tsˈut.su>.sɑh
Tsutsunen+N+Prop+Sem/Sur+Pl+Acc	Tsutsusiid	tsˈut.su>.sijh
Tukiainen+N+Prop+Sem/Sur+Pl+Acc	Tukiaisiid	thˈu.ki.ɑj>.sijh
Tuoriniemi+N+Prop+Sem/Sur+Sg+Loc	Tuoriniemis	thˈuo.ri#nˌie.mi>s
Tuovinen+N+Prop+Sem/Sur+Pl+Acc	Tuovineniid	thˈuo.vi.ne.n>ijh
Tuppurainen+N+Prop+Sem/Sur+Sg+Ill	Tuppurainenii	thˈup.pu.rˌɑj.ne.n>ij
Turpeinen+N+Prop+Sem/Sur+Sg+Acc	Turpeisa	thˈurə.hpej>.sɑ
Turtinen+N+Prop+Sem/Sur+Pl+Nom	Turtinenat	thˈurə.hti.ne.n>ɑh
Tuupainen+N+Prop+Sem/Sur+Pl+Nom	Tuupaisat	thˈu.u.pɑj>.sɑh
Tuuri+N+Prop+Der/laš+A+Pl+Com	Tuurilaččaiguin	thˈu.u.ri>.lɑt.tʃɑj.gujn
Tykkyläinen+N+Prop+Sem/Sur+Sg+Acc	Tykkyläisa	thˈyk.ky.læj>.sɑ
Tyllinen+N+Prop+Sem/Sur+Pl+Nom	Tyllisat	thˈyl.li>.sɑh
Tyllinen+N+Prop+Sem/Sur+Pl+Com	Tyllisiiguin	thˈyl.li>.sij.gujn
Tyrväinen+N+Prop+Sem/Sur+Sg+Acc	Tyrväinena	thˈyrə.væj.ne.n>ɑ
Tyynismaa+N+Prop+Sem/Sur+Sg+Ill	Tyynismaai	thˈy.y.nis#mˌɑ.ɑ>i
Tähkänen+N+Prop+Sem/Sur+Sg+Loc	Tähkäsis	thˈæh.kæ>.sis
Tähkäpää+N+Prop+Der/laš+A+Sg+Com+PxPl2	Tähkäpäälaččaineattet	thˈæh.kæ#phˌæ.æ>.lɑt.tʃɑj.nĕæt.teh
Tähkäpää+N+Prop+Der/laš+A+Sg+Nom	Tähkäpäälaš	thˈæh.kæ#phˌæ.æ>.lɑʃ
Tähtinen+N+Prop+Sem/Sur+Pl+Nom	Tähtinenat	thˈæh.ti.ne.n>ɑh
Töhönen+N+Prop+Sem/Sur+Pl+Nom	Töhösat	thˈø.hø>.sɑh
Töhönen+N+Prop+Sem/Sur+Sg+Com	Töhösiin	thˈø.hø>.sijn
Töhönen+N+Prop+Sem/Sur+Sg+Gen+Allegro	Töhönen	thˈø.hø.nen>
Töhönen+N+Prop+Sem/Sur+Sg+Gen	Töhönena	thˈø.hø.ne.n>ɑ
Törhönen+N+Prop+Sem/Sur+Ess	Törhösin	thˈør.hø>.sin
Uimonen+N+Prop+Sem/Sur+Ess	Uimosin	ˈuj.mo>.sin
Uimonen+N+Prop+Sem/Sur+Pl+Nom	Uimosat	ˈuj.mo>.sɑh
Uimonen+N+Prop+Sem/Sur+Pl+Gen	Uimosiid	ˈuj.mo>.sijh
Uimonen+N+Prop+Sem/Sur+Pl+Ill	Uimosiidda	ˈuj.mo>.sijt.tɑ
Uimonen+N+Prop+Sem/Sur+Pl+Nom	Uimonenat	ˈuj.mo.ne.n>ɑh
Uimonen+N+Prop+Sem/Sur+Sg+Gen+Allegro	Uimonen	ˈuj.mo.nen>
Uimonen+N+Prop+Sem/Sur+Sg+Acc	Uimonena	ˈuj.mo.ne.n>ɑ
Ukkonen+N+Prop+Sem/Sur+Ess	Ukkosin	ˈuk.ko>.sin
Ukkonen+N+Prop+Sem/Sur+Sg+Acc	Ukkonen	ˈuk.ko.nen>
Ullmanen+N+Prop+Sem/Sur+Ess	Ullmasin	ˈulː.mɑː>.sin
Ullmanen+N+Prop+Sem/Sur+Pl+Nom	Ullmasat	ˈulː.mɑː>.sɑh
Ullmanen+N+Prop+Sem/Sur+Sg+Ill	Ullmasii	ˈulː.mɑː>.sij
Ulvinen+N+Prop+Sem/Sur+Pl+Gen	Ulvisiid	ˈulə.vi>.sijh
Ulvinen+N+Prop+Sem/Sur+Sg+Gen	Ulvisa	ˈulə.vi>.sɑ
Untinen+N+Prop+Sem/Sur+Pl+Nom	Untisat	ˈunː.n̥ti>.sɑh
Untinen+N+Prop+Sem/Sur+Pl+Com	Untisiiguin	ˈunː.n̥ti>.sij.gujn
Untinen+N+Prop+Sem/Sur+Sg+Acc	Untisa	ˈunː.n̥ti>.sɑ
Untinen+N+Prop+Sem/Sur+Pl+Com	Untineniiguin	ˈunː.n̥ti.ne.n>ij.gujn
Untinen+N+Prop+Sem/Sur+Sg+Gen+Allegro	Untinen	ˈunː.n̥ti.nen>
Uosukainen+N+Prop+Sem/Sur+Sg+Loc	Uosukaisis	ˈuo.su.kɑj>.sis
Uosukainen+N+Prop+Sem/Sur+Sg+Gen+Allegro	Uosukainen	ˈuo.su.kˌɑj.nen>
Uotinen+N+Prop+Sem/Sur+Sg+Gen	Uotisa	ˈuo.ti>.sɑ
Urhonen+N+Prop+Sem/Sur+Pl+Gen	Urhoneniid	ˈur.ho.ne.n>ijh
Urhonen+N+Prop+Sem/Sur+Sg+Gen+Allegro	Urhonen	ˈur.ho.nen>
Urhonen+N+Prop+Sem/Sur+Sg+Gen	Urhonena	ˈur.ho.ne.n>ɑ
Uronen+N+Prop+Sem/Sur+Ess	Urosin	ˈu.ro>.sin
Uronen+N+Prop+Sem/Sur+Sg+Com	Urosiin	ˈu.ro>.sijn
Uronen+N+Prop+Sem/Sur+Ess	Uronenin	ˈu.ro.ne.n>in
Uronen+N+Prop+Sem/Sur+Pl+Nom	Uronenat	ˈu.ro.ne.n>ɑh
Urpalainen+N+Prop+Sem/Sur+Pl+Nom	Urpalaisat	ˈurə.hpɑ.lɑj>.sɑh
Utriainen+N+Prop+Sem/Sur+Ess	Utriainenin	ˈut.ri.ˌɑj.ne.n>in
Utriainen+N+Prop+Sem/Sur+Pl+Ill	Utriaineniidda	ˈut.ri.ˌɑj.ne.n>ijt.tɑ
Utriainen+N+Prop+Sem/Sur+Sg+Acc	Utriainena	ˈut.ri.ˌɑj.ne.n>ɑ
Utunen+N+Prop+Sem/Sur+Pl+Acc	Utusiid	ˈu.tu>.sijh
Utunen+N+Prop+Sem/Sur+Ess	Utunenin	ˈu.tu.ne.n>in
Utunen+N+Prop+Sem/Sur+Sg+Ill	Utunenii	ˈu.tu.ne.n>ij
Uuksulainen+N+Prop+Sem/Sur+Ess	Uuksulaisin	ˈuːkː.su.lɑj>.sin
Uuksulainen+N+Prop+Sem/Sur+Pl+Nom	Uuksulaisat	ˈuːkː.su.lɑj>.sɑh
Uuksulainen+N+Prop+Sem/Sur+Pl+Gen	Uuksulaisiid	ˈuːkː.su.lɑj>.sijh
Uuksulainen+N+Prop+Sem/Sur+Pl+Gen	Uuksulaineniid	ˈuːkː.su.lˌɑj.ne.n>ijh
Uuksulainen+N+Prop+Sem/Sur+Pl+Ill	Uuksulaineniidda	ˈuːkː.su.lˌɑj.ne.n>ijt.tɑ
Uuksulainen+N+Prop+Sem/Sur+Sg+Gen	Uuksulainena	ˈuːkː.su.lˌɑj.ne.n>ɑ
Uutinen+N+Prop+Sem/Sur+Ess	Uutisin	ˈuː.ti>.sin
Uutinen+N+Prop+Sem/Sur+Pl+Gen	Uutisiid	ˈuː.ti>.sijh
Uutinen+N+Prop+Sem/Sur+Pl+Nom	Uutinenat	ˈuː.ti.ne.n>ɑh
Uutinen+N+Prop+Sem/Sur+Sg+Gen	Uutinena	ˈuː.ti.ne.n>ɑ
Vaakanainen+N+Prop+Sem/Sur+Pl+Ill	Vaakanaineniidda	vˈɑ.ɑ.kˌɑ.nɑj.ne.n>ijt.tɑ
Vainonen+N+Prop+Sem/Sur+Sg+Com	Vainoneniin	vˈɑj.no.ne.n>ijn
Vaittinen+N+Prop+Sem/Sur+Sg+Acc	Vaittisa	vˈɑjç.ti>.sɑ
Vaittinen+N+Prop+Sem/Sur+Pl+Loc	Vaittineniin	vˈɑjç.ti.ne.n>ijn
Vaittinen+N+Prop+Sem/Sur+Sg+Com	Vaittineniin	vˈɑjç.ti.ne.n>ijn
Vakkilainen+N+Prop+Sem/Sur+Pl+Nom	Vakkilaisat	vˈɑk.ki.lɑj>.sɑh
Vanninen+N+Prop+Sem/Sur+Ess	Vanninenin	vˈɑn.ni.ne.n>in
Vapaavuori+N+Prop+Sem/Sur+Pl+Ill	Vapaavuoriide	vˈɑ.pɑː.ɑ#vˌuo.ri>i.de
Varonen+N+Prop+Sem/Sur+Sg+Gen+Allegro	Varonen	vˈɑ.ro.nen>
Vauhkonen+N+Prop+Sem/Sur+Pl+Nom	Vauhkosat	vˈɑuh.ko>.sɑh
Vauhkonen+N+Prop+Sem/Sur+Sg+Acc	Vauhkonen	vˈɑuh.ko.nen>
Vedenpää+N+Prop+Der/laš+A+AttrCmp+Der/rattat+A+Attr	Vedenpäälašrattat	vˈeː.den#phˌæ.æ>.lɑʃ»rˌɑt.tɑh
Vehanen+N+Prop+Sem/Sur+Sg+Gen	Vehasa	vˈe.hɑː>.sɑ
Veitsiluoto+N+Prop+Sg+Gen	Veitsiluoto	vˈejt.si#lˌŭo.to>
Vellonen+N+Prop+Sem/Sur+Pl+Loc	Vellosiin	vˈel.lo>.sijn
Vellonen+N+Prop+Sem/Sur+Ess	Vellonenin	vˈel.lo.ne.n>in
Venäläinen+N+Prop+Sem/Sur+Sg+Gen	Venäläinena	vˈe.næ.lˌæj.ne.n>ɑ
Vepsäläinen+N+Prop+Sem/Sur+Pl+Acc	Vepsäläisiid	vˈep.sæ.læj>.sijh
Vertainen+N+Prop+Sem/Sur+Sg+Acc	Vertaisa	vˈerə.htɑj>.sɑ
Veteläinen+N+Prop+Sem/Sur+Pl+Ill	Veteläisiidda	vˈe.te.læj>.sijt.tɑ
Veteläinen+N+Prop+Sem/Sur+Sg+Acc	Veteläisa	vˈe.te.læj>.sɑ
Vienonen+N+Prop+Sem/Sur+Sg+Loc	Vienonenis	vˈĭe.no.ne.n>is
Vihavainen+N+Prop+Sem/Sur+Sg+Com	Vihavaisiin	vˈi.hɑː.vɑj>.sijn
Vihervuori+N+Prop+Sem/Sur+Ess	Vihervuorin	vˈiː.her#vˌuo.ri>n
Vihervuori+N+Prop+Sem/Sur+Sg+Gen	Vihervuori	vˈiː.her#vˌuo.ri>
Vihtonen+N+Prop+Sem/Sur+Ess	Vihtonenin	vˈih.to.ne.n>in
Viinanen+N+Prop+Sem/Sur+Pl+Com	Viinasiiguin	vˈij.nɑː>.sij.gujn
Viitanen+N+Prop+Sem/Sur+Sg+Gen	Viitasa	vˈijː.çtɑ>.sɑ
Vilhunen+N+Prop+Sem/Sur+Sg+Nom	Vilhunen	vˈilə.hu.nen>
Viljakainen+N+Prop+Sem/Sur+Sg+Acc	Viljakaisa	vˈiʎ.ʎɑː.kɑj>.sɑ
Vitikainen+N+Prop+Sem/Sur+Pl+Acc	Vitikaisiid	vˈi.ti.kɑj>.sijh
Vitikainen+N+Prop+Sem/Sur+Sg+Nom	Vitikainen	vˈi.ti.kˌɑj.nen>
Vitikainen+N+Prop+Sem/Sur+Sg+Ill	Vitikainenii	vˈi.ti.kˌɑj.ne.n>ij
Volanen+N+Prop+Sem/Sur+Ess	Volasin	vˈo.lɑː>.sin
Vornanen+N+Prop+Sem/Sur+Ess	Vornasin	vˈor.nɑː>.sin
Vornanen+N+Prop+Sem/Sur+Pl+Ill	Vornasiidda	vˈor.nɑː>.sijt.tɑ
Vornanen+N+Prop+Sem/Sur+Sg+Acc	Vornanen	vˈor.nɑː.nen>
Voutilainen+N+Prop+Sem/Sur+Sg+Gen+Allegro	Voutilainen	vˈou.ti.lˌɑj.nen>
Vuollo+N+Prop+Sem/Sur+Sg+Loc	Vuollos	vˈŭol.lo>s
Vuontiskero+N+Prop+Sg+Loc	Vuontiskeros	vˈŭonː.n̥tis.kˌe.ro>s
Vuontiskero+N+Prop+Der/laš+A+Pl+Loc+PxPl2	Vuontiskerolaččaineattet	vˈŭonː.n̥tis.kˌe.ro>.lɑt.tʃɑj.nĕæt.teh
Vuorimaa+N+Prop+Sem/Sur+Sg+Ill	Vuorimaai	vˈuo.ri#mˌɑ.ɑ>i
Vyyryläinen+N+Prop+Sem/Sur+Ess	Vyyryläisin	vˈy.y.rˌy.læj>.sin
Vyyryläinen+N+Prop+Sem/Sur+Pl+Nom	Vyyryläisat	vˈy.y.rˌy.læj>.sɑh
Vyyryläinen+N+Prop+Sem/Sur+Sg+Acc	Vyyryläisa	vˈy.y.rˌy.læj>.sɑ
Vyyryläinen+N+Prop+Sem/Sur+Sg+Gen	Vyyryläisa	vˈy.y.rˌy.læj>.sɑ
Vyyryläinen+N+Prop+Sem/Sur+Sg+Com	Vyyryläisiin	vˈy.y.rˌy.læj>.sijn
Vyyryläinen+N+Prop+Sem/Sur+Sg+Loc	Vyyryläisis	vˈy.y.rˌy.læj>.sis
Vyyryläinen+N+Prop+Sem/Sur+Pl+Acc	Vyyryläineniid	vˈy.y.rˌy.læj.ne.n>ijh
Vyyryläinen+N+Prop+Sem/Sur+Sg+Gen+Allegro	Vyyryläinen	vˈy.y.rˌy.læj.nen>
Vähänen+N+Prop+Sem/Sur+Pl+Ill	Vähäsiidda	vˈæ.hæ>.sijt.tɑ
Väisänen+N+Prop+Sem/Sur+Pl+Loc	Väisäsiin	vˈæjː.sæ>.sijn
Väisänen+N+Prop+Sem/Sur+Pl+Nom	Väisänenat	vˈæjː.sæ.ne.n>ɑh
Vänttinen+N+Prop+Sem/Sur+Ess	Vänttisin	vˈænn̥.ti>.sin
Värtinen+N+Prop+Sem/Sur+Ess	Värtisin	vˈærə.hti>.sin
Väyrynen+N+Prop+Sem/Sur+Pl+Loc	Väyrysiin	vˈæ.y.ry>.sijn
Väätäinen+N+Prop+Sem/Sur+Sg+Ill	Väätäinenii	vˈæ.æ.tˌæj.ne.n>ij
Walkeapää+N+Prop+Sem/Sur+Ess	Walkeapään	βˈɑlə.hkeæ#phˌæ.æ>n
Walkeapää+N+Prop+Sem/Sur+Pl+Acc	Walkeapääid	βˈɑlə.hkeæ#phˌæ.æ>id
Walkeapää+N+Prop+Sem/Sur+Pl+Com	Walkeapääiguin	βˈɑlə.hkeæ#phˌæ.æ>i.gujn
Walkeapää+N+Prop+Sem/Sur+Pl+Nom	Walkeapäät	βˈɑlə.hkeæ#phˌæ.æ>h
Walkeapää+N+Prop+Sem/Sur+Sg+Acc	Walkeapää	βˈɑlə.hkeæ#phˌæ.æ>
Walkeapää+N+Prop+Sem/Sur+Sg+Gen	Walkeapää	βˈɑlə.hkeæ#phˌæ.æ>
Walkeapää+N+Prop+Sem/Sur+Sg+Nom	Walkeapää	βˈɑlə.hkeæ#phˌæ.æ>
Walkeapää+N+Prop+Sem/Sur+Sg+Ill	Walkeapääi	βˈɑlə.hkeæ#phˌæ.æ>i
Walkeapää+N+Prop+Sem/Sur+Sg+Loc	Walkeapääs	βˈɑlə.hkeæ#phˌæ.æ>s
Wirtanen+N+Prop+Sem/Sur+Ess	Wirtasin	βˈirə.htɑ>.sin
Wirtanen+N+Prop+Sem/Sur+Pl+Nom	Wirtasat	βˈirə.htɑ>.sɑh
Wirtanen+N+Prop+Sem/Sur+Sg+Acc	Wirtasa	βˈirə.htɑ>.sɑ
Wirtanen+N+Prop+Sem/Sur+Sg+Gen	Wirtasa	βˈirə.htɑ>.sɑ
Wirtanen+N+Prop+Sem/Sur+Sg+Loc	Wirtasis	βˈirə.htɑ>.sis
Wirtanen+N+Prop+Sem/Sur+Ess	Wirtanenin	βˈirə.htɑ.ne.n>in
Wirtanen+N+Prop+Sem/Sur+Pl+Nom	Wirtanenat	βˈirə.htɑ.ne.n>ɑh
Wirtanen+N+Prop+Sem/Sur+Pl+Acc	Wirtaneniid	βˈirə.htɑ.ne.n>ijh
Wirtanen+N+Prop+Sem/Sur+Pl+Com	Wirtaneniiguin	βˈirə.htɑ.ne.n>ij.gujn
Wirtanen+N+Prop+Sem/Sur+Pl+Gen	Wirtaneniid	βˈirə.htɑ.ne.n>ijh
Wirtanen+N+Prop+Sem/Sur+Sg+Nom	Wirtanen	βˈirə.htɑ.nen>
Wirtanen+N+Prop+Sem/Sur+Sg+Gen	Wirtanena	βˈirə.htɑ.ne.n>ɑ
Wirtanen+N+Prop+Sem/Sur+Sg+Com	Wirtaneniin	βˈirə.htɑ.ne.n>ijn
Yletyinen+N+Prop+Sem/Sur+Pl+Nom	Yletyisat	ˈy.le.tyj>.sɑh
Yletyinen+N+Prop+Sem/Sur+Pl+Com	Yletyisiiguin	ˈy.le.tyj>.sij.gujn
Yletyinen+N+Prop+Sem/Sur+Pl+Acc	Yletyineniid	ˈy.le.tˌyj.ne.n>ijh
Yletyinen+N+Prop+Sem/Sur+Pl+Ill	Yletyineniidda	ˈy.le.tˌyj.ne.n>ijt.tɑ
Yletyinen+N+Prop+Sem/Sur+Sg+Acc	Yletyinen	ˈy.le.tˌyj.nen>
Yletyinen+N+Prop+Sem/Sur+Sg+Acc	Yletyinena	ˈy.le.tˌyj.ne.n>ɑ
Yletyinen+N+Prop+Sem/Sur+Sg+Ill	Yletyinenii	ˈy.le.tˌyj.ne.n>ij
Ylhäinen+N+Prop+Ess	Ylhäisin	ˈylə.hæj>.sin
Ylhäinen+N+Prop+Sg+Gen+Allegro	Ylhäinen	ˈylə.hæj.nen>
Ylhäinen+N+Prop+Der/laš+A+Pl+Nom+PxDu1	Ylhäinenlaččaideame	ˈylə.hæj.nˌen.lɑt.tʃɑj.d>ĕæ.me
Ylhäinen+N+Prop+Der/laš+A+AttrCmp+Der/ivnnat+A+Attr	Ylhäinenlašivnnat	ˈylə.hæj.nˌen.lɑʃ»ˌivn.nɑt>
Ylhäinen+N+Prop+Der/laš+A+Sg+Nom+PxDu1	Ylhäinenlažžame	ˈylə.hæj.nˌen.lɑdː.tʃˌɑ.me
Yliluoma+N+Prop+Sem/Sur+Sg+Com	Yliluomain	ˈy.li#lˌuo.mɑ>in
Yliluoma+N+Prop+Sem/Sur+Sg+Loc	Yliluomas	ˈy.li#lˌuo.mɑ>s
Ylinen+N+Prop+Sem/Sur+Sg+Acc	Ylinen	ˈy.li.nen>
Ylipelkonen+N+Prop+Sem/Sur+Pl+Nom	Ylipelkosat	ˈy.li.pˌelə.hko>.sɑh
Ylipelkonen+N+Prop+Sem/Sur+Pl+Nom	Ylipelkonenat	ˈy.li.pˌelə.hko.ne.n>ɑh
Ylipelkonen+N+Prop+Sem/Sur+Sg+Acc	Ylipelkonena	ˈy.li.pˌelə.hko.ne.n>ɑ
Ylänen+N+Prop+Sem/Sur+Sg+Com	Yläsiin	ˈy.læ>.sijn
Ylänen+N+Prop+Sem/Sur+Sg+Gen+Allegro	Ylänen	ˈy.læ.nen>
Ylänen+N+Prop+Sem/Sur+Sg+Loc	Ylänenis	ˈy.læ.ne.n>is
Yläoutinen+N+Prop+Sem/Sur+Ess	Yläoutisin	ˈy.læ#ˌou.ti>.sin
Yläoutinen+N+Prop+Sem/Sur+Pl+Loc	Yläoutisiin	ˈy.læ#ˌou.ti>.sijn
Yläoutinen+N+Prop+Sem/Sur+Sg+Gen	Yläoutisa	ˈy.læ#ˌou.ti>.sɑ
Yläoutinen+N+Prop+Sem/Sur+Pl+Nom	Yläoutinenat	ˈy.læ#ˌou.ti.ne.n>ɑh
Yläoutinen+N+Prop+Sem/Sur+Pl+Acc	Yläoutineniid	ˈy.læ#ˌou.ti.ne.n>ijh
Yläoutinen+N+Prop+Sem/Sur+Sg+Com	Yläoutineniin	ˈy.læ#ˌou.ti.ne.n>ijn
Ylönen+N+Prop+Sem/Sur+Pl+Loc	Ylösiin	ˈy.lø>.sijn
Ylönen+N+Prop+Sem/Sur+Ess	Ylönenin	ˈy.lø.ne.n>in
Ylönen+N+Prop+Sem/Sur+Pl+Loc	Ylöneniin	ˈy.lø.ne.n>ijn
Ylönen+N+Prop+Sem/Sur+Sg+Acc	Ylönena	ˈy.lø.ne.n>ɑ
Ylönen+N+Prop+Sem/Sur+Sg+Gen	Ylönena	ˈy.lø.ne.n>ɑ
Ylönen+N+Prop+Sem/Sur+Sg+Com	Ylöneniin	ˈy.lø.ne.n>ijn
Yrjänäinen+N+Prop+Sem/Sur+Ess	Yrjänäisin	ˈyrə.jæ.næj>.sin
Yrjänäinen+N+Prop+Sem/Sur+Pl+Nom	Yrjänäisat	ˈyrə.jæ.næj>.sɑh
Yrjänäinen+N+Prop+Sem/Sur+Pl+Acc	Yrjänäisiid	ˈyrə.jæ.næj>.sijh
Yrjänäinen+N+Prop+Sem/Sur+Pl+Gen	Yrjänäisiid	ˈyrə.jæ.næj>.sijh
Yrjänäinen+N+Prop+Sem/Sur+Sg+Gen	Yrjänäisa	ˈyrə.jæ.næj>.sɑ
Yrjänäinen+N+Prop+Sem/Sur+Sg+Loc	Yrjänäisis	ˈyrə.jæ.næj>.sis
Yrjänäinen+N+Prop+Sem/Sur+Ess	Yrjänäinenin	ˈyrə.jæ.nˌæj.ne.n>in
Yrjänäinen+N+Prop+Sem/Sur+Pl+Nom	Yrjänäinenat	ˈyrə.jæ.nˌæj.ne.n>ɑh
Yrjänäinen+N+Prop+Sem/Sur+Pl+Com	Yrjänäineniiguin	ˈyrə.jæ.nˌæj.ne.n>ij.gujn
Yrjänäinen+N+Prop+Sem/Sur+Pl+Gen	Yrjänäineniid	ˈyrə.jæ.nˌæj.ne.n>ijh
Yrjänäinen+N+Prop+Sem/Sur+Pl+Loc	Yrjänäineniin	ˈyrə.jæ.nˌæj.ne.n>ijn
Yrjänäinen+N+Prop+Sem/Sur+Sg+Nom	Yrjänäinen	ˈyrə.jæ.nˌæj.nen>
Yrjänäinen+N+Prop+Sem/Sur+Sg+Gen	Yrjänäinena	ˈyrə.jæ.nˌæj.ne.n>ɑ
Yrjönen+N+Prop+Sem/Sur+Ess	Yrjösin	ˈyrə.jø>.sin
Yrjönen+N+Prop+Sem/Sur+Pl+Nom	Yrjösat	ˈyrə.jø>.sɑh
Yrjönen+N+Prop+Sem/Sur+Pl+Com	Yrjösiiguin	ˈyrə.jø>.sij.gujn
Yrjönen+N+Prop+Sem/Sur+Sg+Acc	Yrjösa	ˈyrə.jø>.sɑ
Yrjönen+N+Prop+Sem/Sur+Sg+Loc	Yrjösis	ˈyrə.jø>.sis
Yrjönen+N+Prop+Sem/Sur+Pl+Nom	Yrjönenat	ˈyrə.jø.ne.n>ɑh
Yrjönen+N+Prop+Sem/Sur+Pl+Gen	Yrjöneniid	ˈyrə.jø.ne.n>ijh
Yrjönen+N+Prop+Sem/Sur+Pl+Ill	Yrjöneniidda	ˈyrə.jø.ne.n>ijt.tɑ
Yrjönen+N+Prop+Sem/Sur+Sg+Acc	Yrjönen	ˈyrə.jø.nen>
Yrjönen+N+Prop+Sem/Sur+Sg+Gen+Allegro	Yrjönen	ˈyrə.jø.nen>
Yrjönen+N+Prop+Sem/Sur+Sg+Nom	Yrjönen	ˈyrə.jø.nen>
Yrjönen+N+Prop+Sem/Sur+Sg+Gen	Yrjönena	ˈyrə.jø.ne.n>ɑ
Yrjönen+N+Prop+Sem/Sur+Sg+Ill	Yrjönenii	ˈyrə.jø.ne.n>ij
Yrjönen+N+Prop+Sem/Sur+Sg+Loc	Yrjönenis	ˈyrə.jø.ne.n>is
Äijänen+N+Prop+Sem/Sur+Ess	Äijäsin	ˈæj.jæ>.sin
Äijänen+N+Prop+Sem/Sur+Pl+Nom	Äijäsat	ˈæj.jæ>.sɑh
Äijänen+N+Prop+Sem/Sur+Pl+Com	Äijäsiiguin	ˈæj.jæ>.sij.gujn
Äijänen+N+Prop+Sem/Sur+Pl+Gen	Äijäsiid	ˈæj.jæ>.sijh
Äijänen+N+Prop+Sem/Sur+Sg+Com	Äijäsiin	ˈæj.jæ>.sijn
Äijänen+N+Prop+Sem/Sur+Sg+Ill	Äijäsii	ˈæj.jæ>.sij
Äijänen+N+Prop+Sem/Sur+Sg+Loc	Äijäsis	ˈæj.jæ>.sis
Äijänen+N+Prop+Sem/Sur+Ess	Äijänenin	ˈæj.jæ.ne.n>in
Äijänen+N+Prop+Sem/Sur+Pl+Nom	Äijänenat	ˈæj.jæ.ne.n>ɑh
Äijänen+N+Prop+Sem/Sur+Pl+Com	Äijäneniiguin	ˈæj.jæ.ne.n>ij.gujn
Äijänen+N+Prop+Sem/Sur+Pl+Gen	Äijäneniid	ˈæj.jæ.ne.n>ijh
Äijänen+N+Prop+Sem/Sur+Pl+Loc	Äijäneniin	ˈæj.jæ.ne.n>ijn
Äijänen+N+Prop+Sem/Sur+Sg+Acc	Äijänen	ˈæj.jæ.nen>
Äijänen+N+Prop+Sem/Sur+Sg+Nom	Äijänen	ˈæj.jæ.nen>
Äijänen+N+Prop+Sem/Sur+Sg+Acc	Äijänena	ˈæj.jæ.ne.n>ɑ
Äijänen+N+Prop+Sem/Sur+Sg+Gen	Äijänena	ˈæj.jæ.ne.n>ɑ
Äijänen+N+Prop+Sem/Sur+Sg+Com	Äijäneniin	ˈæj.jæ.ne.n>ijn
Äijänen+N+Prop+Sem/Sur+Sg+Ill	Äijänenii	ˈæj.jæ.ne.n>ij
Äyräväinen+N+Prop+Sem/Sur+Pl+Nom	Äyräväisat	ˈæy.ræ.væj>.sɑh
Äyräväinen+N+Prop+Sem/Sur+Pl+Ill	Äyräväisiidda	ˈæy.ræ.væj>.sijt.tɑ
Äyräväinen+N+Prop+Sem/Sur+Pl+Loc	Äyräväisiin	ˈæy.ræ.væj>.sijn
Äyräväinen+N+Prop+Sem/Sur+Sg+Gen	Äyräväisa	ˈæy.ræ.væj>.sɑ
Äyräväinen+N+Prop+Sem/Sur+Sg+Com	Äyräväisiin	ˈæy.ræ.væj>.sijn
Äyräväinen+N+Prop+Sem/Sur+Sg+Loc	Äyräväisis	ˈæy.ræ.væj>.sis
Äyräväinen+N+Prop+Sem/Sur+Ess	Äyräväinenin	ˈæy.ræ.vˌæj.ne.n>in
Äyräväinen+N+Prop+Sem/Sur+Pl+Nom	Äyräväinenat	ˈæy.ræ.vˌæj.ne.n>ɑh
Äyräväinen+N+Prop+Sem/Sur+Pl+Acc	Äyräväineniid	ˈæy.ræ.vˌæj.ne.n>ijh
Äyräväinen+N+Prop+Sem/Sur+Pl+Gen	Äyräväineniid	ˈæy.ræ.vˌæj.ne.n>ijh
Äyräväinen+N+Prop+Sem/Sur+Pl+Ill	Äyräväineniidda	ˈæy.ræ.vˌæj.ne.n>ijt.tɑ
Äyräväinen+N+Prop+Sem/Sur+Sg+Nom	Äyräväinen	ˈæy.ræ.vˌæj.nen>
Äyräväinen+N+Prop+Sem/Sur+Sg+Acc	Äyräväinena	ˈæy.ræ.vˌæj.ne.n>ɑ
Äyräväinen+N+Prop+Sem/Sur+Sg+Gen	Äyräväinena	ˈæy.ræ.vˌæj.ne.n>ɑ
Äyräväinen+N+Prop+Sem/Sur+Sg+Com	Äyräväineniin	ˈæy.ræ.vˌæj.ne.n>ijn
Äyräväinen+N+Prop+Sem/Sur+Sg+Loc	Äyräväinenis	ˈæy.ræ.vˌæj.ne.n>is
