Ajman+N+Prop+Sem/Sur+Sg+Ill	Ajmanii	ˈɑj.mɑː.nij
Curitiba+N+Prop+Der/laš+A+Sg+Nom	Curitibalaš	tsˈu.ri.tˌi.bɑ.lɑʃ
D'Urvillemearra+N+Prop+Sg+Ill	D'Urvillemerrii	d'ur.vil.le.mer.rij
Dnjepr+N+Prop+Der/laš+A+Sg+Gen+PxDu1	Dnjeprlažžame	dɲˈepr.lɑːdː.tʃˌɑ.me
Gijón+N+Prop+Der/laš+A+Sg+Nom	Gijónalaš	kˈi.juː.nˌɑ.lɑʃ
Gávuotna+N+Prop+Sg+Acc	Gávuona	kˈɑː.vuo.nɑ
Görlitz+N+Prop+Sem/Sur+Attr	Görlitzs	kˈør.litzs
H	son+N+Prop+Sem/Sur+Pl+Nom:H:sonat	sˈon+n+prop+sem/sur+pl+nom:h:so.nɑh
Iivar+N+Prop+Sem/Mal+Attr	Iivar	ˈijː.vɑːr
MEGA+N+Prop+Sg+Acc	MEGA	mˈe.gɑː
Mbandaka+N+Prop+Der/laš+A+Sg+Acc+PxSg2	Mbandakalaččat	mbˈɑnː.tɑː.kˌɑ.lɑt.tʃɑh
Mölsä+N+Prop+Der/laš+A+Pl+Com+PxDu1	Mölsälaččaideameguin	mˈølə.sæ.lˌɑt.tʃɑj.dˌĕæ.me.gujn
Oshogbo+N+Prop+Der/laš+A+Sg+Nom	Oshotbolaš	ˈos.hoh#pˌo.lɑʃ
Qum+N+Prop+Sem/Sur+Sg+Loc	Qumas	kˈu.mɑːs
Skogssamerna+N+Prop+Sg+Nom	Skogssamerna	skˈogs.sɑː.mˌer.nɑ
Tölli+N+Prop+Sem/Sur+Sg+Gen	Tölli	thˈølː.liː
Umbukta+N+Prop+Sg+Com	Unbuktain	ˈun#pˌukː.htɑjn
Vsevološesk+N+Prop+Der/laš+A+Pl+Acc	Vsevološeskalaččaid	vsˈe.vo.lˌo.ʃes.kˌɑ.lɑt.tʃɑjh
Yle+N+Prop+Sg+Ill	Ylei	ˈy.lej
emacs+N+Prop+Sg+Acc	emacsa	ˈe.mɑːts.sɑ
emacs+N+Prop+Sg+Ill	emacsii	ˈe.mɑːts.sij
von+N+Prop+Attr	von	vˈon
Ängeslevä+N+Prop+Der/laš+A+Sg+Ill	Ängeslevälažžii	ˈæŋŋ.kes.lˌe.væ.lˌɑdː.tʃij
Ääri+N+Prop+Sem/Sur+Sg+Ill	Äärii	ˈææ.rij
Æge+N+Prop+Sem/Mal+Pl+Nom	Æget	ˈæ.geh
Çanakkale+N+Prop+Ess	Çanakkalen	sˈɑ.nɑːk.kˌɑ.len
Émile+N+Prop+Sem/Fem+Sg+Com	Émiliin	ˈeːmi.lijn
Ízü+N+Prop+Sg+Com	Ízüin	ˈiː.dsyjn
Òdáđahraun+N+Prop+Sg+Gen+Allegro	Òdáđahraun	ˈo.dɑː.ðˌɑh.rɑun
Özerk+N+Prop+Sem/Sur+Ess	Özerkan	ˈø.dser.hkɑn
Østsibirsk+N+Prop+Attr	Østsibirsk	ˈøst.si.birsk
Øzerk+N+Prop+Sem/Sur+Sg+Gen	Øzerk	ˈø.dserk
Čeabetjávri+N+Prop+Sg+Nom	Čeabetjávri	tʃˈĕæ.bet.jˌɑːβː.ri
Čáđđervárri+N+Prop+Der/laš+A+Attr+Der/vuohta+N+Pl+Nom	Čáđđervárrilašvuođat	tʃˈɑːð.ðer.vˌɑːr.ri.lɑʃ»vˌuo.ðɑh
Šete+N+Prop+Sg+Acc	Šete	ʃˈeː.te
Azerbaidzan+N+Prop+Der/laš+A+Sg+Loc+PxSg3	Azerbaidzanalaččastis	ˈɑ.dser.bˌɑjd.zɑ.nˌɑ.lɑt.tʃɑs.tis
Czestochowa+N+Prop+Sg+Com	Czestochowain	tszˈesː.tots.hˌo.βɑjn
Duun+N+Prop+Sem/Sur+Pl+Nom	Duunat	tˈu.u.nɑh
Fåset+N+Prop+Sem/Sur+Sg+Ill	Fåsetii	fˈoː#sˌe.tij
Hvinden+N+Prop+Sem/Sur+Ess	Hvindenin	hvˈinː.te.nin
Hylkje+N+Prop+Sem/Sur+Ess	Hylkjen	hˈylk.jen
Jón+N+Prop+Sem/Mal+Attr	Jón	jˈuːn
Köln+N+Prop+Sg+Acc	Kölna	khˈøl.nɑ
Kühn+N+Prop+Ess	Kühnan	khˈyh.nɑn
Kühn+N+Prop+Sg+Gen	Kühn	khˈyhn
Llandudno+N+Prop+Sg+Com	Llandudnoin	l.lɑn.dud.nojn
Olgoáššiidministeriija+N+Prop+Sg+Ill	Olgoáššiidministeriijai	ˈolə.ko.ˌɑːʃ.ʃijd.mˌi.nis.te.rij.jɑj
Rjazan+N+Prop+Sg+Nom	Rjazan	rjˈɑ.dsɑːn
Skogssamerna+N+Prop+Sg+Nom	Skogssamerna	skˈogs.sɑː.mˌer.nɑ
Tampere+N+Prop+Sg+Ill	Tamperei	thˈɑmː.m̥pe.rej
Xin+N+Prop+Sem/Sur+Sg+Acc	Xin	ksˈin
Yle+N+Prop+Sg+Ill	Ylei	ˈy.lej
Yenbo+N+Prop+Der/laš+A+Sg+Ill	Yenbolažžii	ˈyen.bo.lˌɑdː.tʃij
Yggdrasil+N+Prop+Sg+Acc	Yggdrasila	ˈygːdrɑ.si.lɑ
Yle+N+Prop+Sg+Ill	Ylii	ˈy.lij
Zürich+N+Prop+Der/laš+A+Pl+Gen+PxDu3	Zürichlaččaideaskka	zˈy.ritsh.lˌɑt.tʃɑj.dˌeæs.kɑ
bin+N+Prop+Attr	bin	pˈin
emacs+N+Prop+Sg+Nom	emacs	ˈe.mɑːtsː
iTet+N+Prop+Sg+Ill	iTetii	ˈi.te.tij
komvux+N+Prop+Ess	konvuxan	khˈon#vˌuks.ɑn
konstcentrum+N+Prop+Ess	konstcentrumin	khˈonst.tsent.rˌu.min
samtidskunst+N+Prop+Ess	samtidskunstan	sˈɑm.htid.skˌunː.stɑn
von+N+Prop+Attr	von	vˈon
Ákšoalggečohkka+N+Prop+Sg+Gen+Der/t+N+Sg+Nom	Ákšoalggečohkat	ˈɑːkʃ.ŏɑlk.kˌe.tʃoh.kɑ»h
Çanakkale+N+Prop+Der/laš+A+Pl+Com	Çanakkalelaččaiguin	sˈɑ.nɑːk.kˌɑ.le.lˌɑt.tʃɑj.gujn
Çanakkale+N+Prop+Der/laš+A+Sg+Com+PxDu2	Çanakkalelaččaineatte	sˈɑ.nɑːk.kˌɑ.le.lˌɑt.tʃɑj.nĕæt.te
Évora+N+Prop+Der/laš+A+Ess+PxSg2	Évoralažžanat	ˈeːvo.rɑ.lɑdː.tʃɑ.nɑh
Ösel+N+Prop+Sem/Sur+Attr	Ösels	ˈø.sels
Øvre+N+Prop+Sem/Sur+Pl+Acc	Øvriid	ˈøβː.rijh
Øye+N+Prop+Sem/Sur+Sg+Loc	Øyes	ˈøyes
Þistilfjörður+N+Prop+Der/laš+A+Sg+Nom	Þistilfjörðurlaš	θˈisː.til#fjørður.lɑʃ
Þistilfjörður+N+Prop+Der/laš+A+Ess+PxDu1	Þistilfjörðurlažžaneame	θˈisː.til#fjørður.lɑdː.tʃɑ.nĕæ.me
Šamma+N+Prop+Der/laš+A+Sg+Ill	Šammalažžii	ʃˈɑmː.mɑː.lˌɑdː.tʃij
Šáhkkaolympiaden+N+Prop+Sg+Gen+Allegro	Šáhkkaolympiaden	ʃˈɑhː.kɑ.ˌo.lymː.m̥pˌi.ɑ.den
giežalogátlohkái+Num+Sg+Attrniehkki+N+Pl+Loc+PxDu1	oktačuohtigiežalogátlotnihkiineame	ˈokː.htɑ#tʃˌuoh.ti#kˌie.dʃɑ#lˌo.gɑːh#loh»nˌih.kij.nˌĕæ.me
giežanjealjátlohkái+Num+Sg+Com	oktačuohtigiežainnjealjátlogiin	ˈokː.htɑ#tʃˌuoh.ti#kˌie.dʃɑjn#ɲˌeæʎ.ʎɑːh#lˌo.gijn
giežaovccátlohkái+Num+Sg+Loc	oktačuohtigiežaovccátlogis	ˈokː.htɑ#tʃˌuoh.ti#kˌie.dʃɑ#ˌoβɸ.tsɑːh#lˌo.gis
golbmalogiokta+Num+Ess	oktačuohtigolbmalogioktan	ˈokː.htɑ#tʃˌuoh.ti#kˌolə.pmɑ#lˌo.gi#ˌokː.htɑn
golbmaguđatlohkái+Num+Pl+Com+Attr	oktačuohtigolmmaidguđatlogiid	ˈokː.htɑ#tʃˌuoh.ti#kˌolm.mɑjh#kˌu.ðɑh#lˌo.gijh
guhttačihččetlogis+N+Coll+Pl+Nom	oktačuohtiguhttačihččetlohkásat	ˈokː.htɑ#tʃˌuoh.ti#kˌuhː.tɑ#tʃˌihː.tʃeh#lˌohː.kɑː.sɑh
guokteovccátlohkái+Num+Sg+Attr	oktačuohtiguvttiinovccátlot	ˈokː.htɑ#tʃˌuoh.ti#kˌuβɸ.tijn#ˌoβɸ.tsɑːh#loh
guoktegávccátlohkái+Num+Pl+Acc	oktačuohtiguoktegávccátlogiid	ˈokː.htɑ#tʃˌuoh.ti#kˌŭokː.hte#kˌɑːβɸ.tsɑːh#lˌo.gijh
gávcciviđatlohkái+Num+Pl+Com	oktačuohtigávcciviđátlogiiguin	ˈokː.htɑ#tʃˌuoh.ti#kˌɑːβɸ.tsi#vˌi.ðɑːh#lˌo.gij.gujn
njealljelogátlohkái+Num+Sg+Attr	oktačuohtinjeljiinlogátlot	ˈokː.htɑ#tʃˌuoh.ti#ɲˌeʎ.ʎijn#lˌo.gɑːh#loh
njealljeviđatlohkái+Num+Sg+Com	oktačuohtinjeljiinviđatlogiin	ˈokː.htɑ#tʃˌuoh.ti#ɲˌeʎ.ʎijn#vˌi.ðɑh#lˌo.gijn
nubbelogátlohkái+Num+Sg+Attr	oktačuohtinubbinlogátlot	ˈokː.htɑ#tʃˌuoh.ti#nˌubː.pin#lˌo.gɑːh#loh
nubbeviđátlohkái+Num+Sg+Attr	oktačuohtinubbinviđátlot	ˈokː.htɑ#tʃˌuoh.ti#nˌubː.pin#vˌi.ðɑːh#loh
nubbečihččetlohkái+Num+Sg+Attr	oktačuohtinubbinčihččetlot	ˈokː.htɑ#tʃˌuoh.ti#nˌubː.pin#tʃˌihː.tʃeh#loh
nubbelogátlohkái+Num+Ess	oktačuohtinuppitlogátlogin	ˈokː.htɑ#tʃˌuoh.ti#nˌupː.pih#lˌo.gɑːh#lˌo.gin
nubbelogátlohkái+Num+Sg+Com	oktačuohtinuppiinlogátlogiin	ˈokː.htɑ#tʃˌuoh.ti#nˌup.pijn#lˌo.gɑːh#lˌo.gijn
nubbeovccátlohkái+Num+Sg+Attr	oktačuohtinuppiinovccátlot	ˈokː.htɑ#tʃˌuoh.ti#nˌup.pijn#ˌoβɸ.tsɑːh#loh
oktaovccátlohkái+Num+Sg+Attr	oktačuohtioktanovccátlot	ˈokː.htɑ#tʃˌuoh.ti#ˌokː.htɑn#ˌoβɸ.tsɑːh#loh
oktaviđatlohkái+Num+Ess	oktačuohtiovttatviđatlogin	ˈokː.htɑ#tʃˌuoh.ti#ˌoβɸ.tɑh#vˌi.ðɑh#lˌo.gin
oktaviđátlohkái+Num+Ess	oktačuohtiovttatviđatlogin	ˈokː.htɑ#tʃˌuoh.ti#ˌoβɸ.tɑh#vˌi.ðɑh#lˌo.gin
oktačihččetlohkái+Num+Sg+Attr	oktačuohtiovttačihččetlot	ˈokː.htɑ#tʃˌuoh.ti#ˌoβɸ.tɑ#tʃˌihː.tʃeh#loh
ovcciloginjealjis+N+Coll+Sg+Nom	oktačuohtiovcciloginjealjis	ˈokː.htɑ#tʃˌuoh.ti#ˌoβɸ.tsi#lˌo.gi#ɲˌeæʎ.ʎis
vihttalogiokta+Num+Ess	oktačuohtivihttalogioktan	ˈokː.htɑ#tʃˌuoh.ti#vˌihː.tɑ#lˌo.gi#ˌokː.htɑn
vihttalogivihtta+Num+Sg+Nom	oktačuohtiviihttalogivihtta	ˈokː.htɑ#tʃˌuoh.ti#vˌijhː.tɑ#lˌo.gi#vˌihː.tɑ
vihttalogivihtta+Num+Sg+Com	oktačuohtiviđainlogiinviđain	ˈokː.htɑ#tʃˌuoh.ti#vˌi.ðɑjn#lˌo.gijn#vˌi.ðɑjn
vihttaovccátlohkái+Num+Sg+Nom	oktačuohtivihttaovccátlohkái	ˈokː.htɑ#tʃˌuoh.ti#vˌihː.tɑ#ˌoβɸ.tsɑːh#lˌohː.kɑːj
vihttaviđatlohkái+Num+Pl+Gen	oktačuohtivihttaviđatlogiid	ˈokː.htɑ#tʃˌuoh.ti#vˌihː.tɑ#vˌi.ðɑh#lˌo.gijh
vihttaviđatlohkái+Num+Sg+Nom	oktačuohtivihttaviđátlohkái	ˈokː.htɑ#tʃˌuoh.ti#vˌihː.tɑ#vˌi.ðɑːh#lˌohː.kɑːj
vihttaviđatlohkái+Num+Pl+Nom	oktačuohtiviđatviđátlogit	ˈokː.htɑ#tʃˌuoh.ti#vˌi.ðɑh#vˌi.ðɑːh#lˌo.gih
vihttaviđátlohkái+Num+Sg+Acc	oktačuohtivihttaviđatlohkái	ˈokː.htɑ#tʃˌuoh.ti#vˌihː.tɑ#vˌi.ðɑh#lˌohː.kɑːj
vihttaguđátlogis+N+Coll+Pl+Nom	oktačuohtivihttaguđátlohkásat	ˈokː.htɑ#tʃˌuoh.ti#vˌihː.tɑ#kˌu.ðɑːh#lˌohː.kɑː.sɑh
vihttaloginjealjis+N+Coll+Sg+Nom	oktačuohtivihttaloginjealjis	ˈokː.htɑ#tʃˌuoh.ti#vˌihː.tɑ#lˌo.gi#ɲˌeæʎ.ʎis
čiežalogátlohkái+Num+Sg+Nom	oktačuohtičiežalogátlohkái	ˈokː.htɑ#tʃˌuoh.ti#tʃˌie.dʃɑ#lˌo.gɑːh#lˌohː.kɑːj
čiežanjealjátlohkái+Num+Ess	oktačuohtičiežatnjealjátlogin	ˈokː.htɑ#tʃˌuoh.ti#tʃˌie.dʃɑh#ɲˌeæʎ.ʎɑːh#lˌo.gin
čiežalogivuosttaš+A+Ord+Der/vuohta+N+Sg+Ill	oktačuohtičiežalogivuosttašvuhtii	ˈokː.htɑ#tʃˌuoh.ti#tʃˌie.dʃɑ#lˌo.gi#vˌuos.tɑʃ»vˌuh.tij
AIDS+N+Sg+Nom	AIDS	ˈɑjds
AIDS+N+Pl+Nom	AIDSat	ˈɑjd.sɑːh
AIDS+N+Pl+Com+PxDu1	AIDSaideameguin	ˈɑjd.sɑːj.dˌĕæ.me.gujn
AIDS+N+Pl+Ill	AIDSaide	ˈɑjd.sɑːj.de
AIDS+N+Sg+Gen+PxDu1	AIDSame	ˈɑjd.sɑː.me
AIDS+N+Sg+Loc	AIDSas	ˈɑjd.sɑːs
AIDS+N+Sg+Nom+PxDu3	AIDSaska	ˈɑjd.sɑːs.kɑ
AIDS+N+Sg+Nom+PxSg2	AIDSat	ˈɑjd.sɑːh
AIDS+N+Sg+Com+PxSg1	AIDSainan	ˈɑjd.sɑːj.nɑn
AIDS+N+Sg+Com+PxSg2	AIDSainat	ˈɑjd.sɑːj.nɑh
AIDS+N+Sg+Ill+PxDu1	AIDSaseame	ˈɑjd.sɑː.sˌĕæ.me
AIDS+N+Der/Dimin+N+Der/viđá+Adv	AIDSašviđá	ˈɑjd.sɑː»ʃ»vˌi.ðɑː
AIDS+N+Der/Dimin+N+Sg+Ill+PxPl3	AIDSažasaset	ˈɑjd.sɑː»dʃˌɑ.sɑ.seh
AIDS+N+Sg+Ill	AIDSii	ˈɑjd.sij
Biehtárvahkku+N+Sg+Acc+PxSg2	Biehtárvahkot	pˈieh.tɑːr#vˌɑh.koh
Biehtárvahkku+N+Sg+Gen+PxSg2	Biehtárvahkot	pˈieh.tɑːr#vˌɑh.koh
Biehtárvahkku+N+Der/Dimin+N+Der/viđá+Adv	Biehtárvahkošviđá	pˈieh.tɑːr#vˌɑh.ko»ʃ»vˌi.ðɑː
Biehtárvahkku+N+Der/laš+A+Comp+Sg+Gen	Biehtárvahkolabbo	pˈieh.tɑːr#vˌɑh.ko»lˌɑbː.po
Biehtárvahkku+N+Der/laš+A+Der/vuohta+N+Ess+PxDu2	Biehtárvahkolašvuohtaneatte	pˈieh.tɑːr#vˌɑh.ko»lɑʃ»vˌuoh.tɑ.nˌĕæt.te
Biehtárvahkku+N+Sg+Gen+PxSg3	Biehtárvahkus	pˈieh.tɑːr#vˌɑhː.kus
Biehtárvahkku+N+Sg+Com+PxPl2	Biehtárvahkuineattet	pˈieh.tɑːr#vˌɑh.kuj.nˌĕæt.teh
Biehtárvahkku+N+Sg+Com+PxSg3	Biehtárvahkuinis	pˈieh.tɑːr#vˌɑh.kuj.nis
Biehtárvahkku+N+Sg+Loc+PxDu1	Biehtárvahkusteame	pˈieh.tɑːr#vˌɑhː.kus.tˌĕæ.me
Biehtárvahkku+N+Der/heapmi+A+Attr+Der/vuohta+N+Sg+Ill	Biehtárvahkuhisvuhtii	pˈieh.tɑːr#vˌɑh.ku»his»vˌuh.tij
Biehtárvahkku+N+Sg+Acc+PxSg2	Biehtárvahkkot	pˈieh.tɑːr#vˌɑhː.koh
Biehtárvahkku+N+Sg+Gen+PxDu2	Biehtárvahkkode	pˈieh.tɑːr#vˌɑhː.ko.de
Biehtárvahkku+N+Der/huhtti+V+TV+Sup	Biehtárvahkkohuhtážit	pˈieh.tɑːr#vˌɑhː.ko»hˌuhː.tɑː.dʃih
Biehtárvahkku+N+Der/huvva+V+IV+VAbess	Biehtárvahkkohuvahaga	pˈieh.tɑːr#vˌɑhː.ko»hˌu.vɑ.hˌɑ.gɑ
Biehtárvahkku+N+Der/laš+A+Superl+Pl+Gen	Biehtárvahkkolamosiid	pˈieh.tɑːr#vˌɑhː.ko»lˌɑ.mo.sijh
Biehtárvahkku+N+Der/viđá+Adv	Biehtárvahkkoviđá	pˈieh.tɑːr#vˌɑhː.ko»vˌi.ðɑː
Biehtárvahkku+N+Ess+PxSg2	Biehtárvahkkunat	pˈieh.tɑːr#vˌɑhː.ku.nɑh
Biehtárvahkku+N+Pl+Acc+PxSg2	Biehtárvahkkuidat	pˈieh.tɑːr#vˌɑhː.kuj.dɑh
Biehtárvahkku+N+Pl+Gen+PxPl3	Biehtárvahkkuideaset	pˈieh.tɑːr#vˌɑhː.kuj.dˌĕæ.seh
Biehtárvahkku+N+Sg+Loc+PxSg3	Biehtárvahkkustis	pˈieh.tɑːr#vˌɑhː.kus.tis
Biehtárvahkku+N+Sg+Nom	Biehtárvahkku	pˈieh.tɑːr#vˌɑhː.ku
Birggetbeaivi+N+Pl+Gen+PxSg2	Birggetbeivviidat	pˈirk.keh#pˌejv.vij.dɑh
Birggetbeaivi+N+Pl+Nom+PxDu3	Birggetbeivviideaskka	pˈirk.keh#pˌejv.vij.dˌeæs.kɑ
Birggetbeaivi+N+Sg+Com+PxDu3	Birggetbeivviineaskka	pˈirk.keh#pˌejv.vij.nˌeæs.kɑ
Birggetbeaivi+N+Sg+Com+PxSg3	Birggetbeivviinis	pˈirk.keh#pˌejv.vij.nis
Birggetbeaivi+N+Sg+Gen+Allegro	Birggetbeaivve	pˈirk.keh#pˌĕæjv.ve
Birggetbeaivi+N+Sg+Acc+PxDu2	Birggetbeaivváde	pˈirk.keh#pˌeæjv.vɑː.de
Birggetvahkku+N+Sg+Acc+PxDu2	Birggetvahkode	pˈirk.keh#vˌɑh.ko.de
Birggetvahkku+N+Sg+Gen+PxDu2	Birggetvahkode	pˈirk.keh#vˌɑh.ko.de
Birggetvahkku+N+Sg+Gen+PxSg2	Birggetvahkot	pˈirk.keh#vˌɑh.koh
Birggetvahkku+N+Der/laš+A+Comp+Sg+Nom	Birggetvahkolut	pˈirk.keh#vˌɑh.ko»luh
Birggetvahkku+N+Der/laš+A+AttrCmp+Der/fárddat+A+Sg+Nom	Birggetvahkolašfárddat	pˈirk.keh#vˌɑh.ko»lɑʃ»fˌɑːrt.tɑh
Birggetvahkku+N+Der/laš+A+Sg+Nom	Birggetvahkolaš	pˈirk.keh#vˌɑh.ko»lɑʃ
Birggetvahkku+N+Sg+Com+PxSg2	Birggetvahkuinat	pˈirk.keh#vˌɑh.kuj.nɑh
Birggetvahkku+N+Sg+Loc	Birggetvahkus	pˈirk.keh#vˌɑhː.kus
Birggetvahkku+N+Sg+Loc+PxSg3	Birggetvahkustis	pˈirk.keh#vˌɑhː.kus.tis
Birggetvahkku+N+Sg+Ill+PxPl1	Birggetvahkkoseamet	pˈirk.keh#vˌɑhː.ko.sˌĕæ.meh
Birggetvahkku+N+Der/laš+A+Comp+Pl+Acc	Birggetvahkkolabbuid	pˈirk.keh#vˌɑhː.ko»lˌɑbː.pujh
Birggetvahkku+N+Der/viđá+Adv	Birggetvahkkoviđá	pˈirk.keh#vˌɑhː.ko»vˌi.ðɑː
Birggetvahkku+N+Pl+Nom	Birggetvahkkut	pˈirk.keh#vˌɑhː.kuh
Birggetvahkku+N+Pl+Nom+PxDu1	Birggetvahkkuideame	pˈirk.keh#vˌɑhː.kuj.dˌĕæ.me
Birggetvahkku+N+Sg+Ill	Birggetvahkkui	pˈirk.keh#vˌɑhː.kuj
Erkkebeaivi+N+Pl+Gen	Erkkebeivviid	ˈerr̥.ke#pˌejv.vijh
Erkkebeaivi+N+Sg+Com+PxDu2	Erkkebeivviineatte	ˈerr̥.ke#pˌejv.vij.nˌĕæt.te
Erkkebeaivi+N+Sg+Com+PxDu3	Erkkebeivviineaskka	ˈerr̥.ke#pˌejv.vij.nˌeæs.kɑ
Erkkebeaivi+N+Sg+Com+PxPl1	Erkkebeivviineamet	ˈerr̥.ke#pˌejv.vij.nˌĕæ.meh
Erkkebeaivi+N+Sg+Com+PxSg1	Erkkebeivviinan	ˈerr̥.ke#pˌejv.vij.nɑn
Erkkebeaivi+N+Sg+Com+PxSg3	Erkkebeivviinis	ˈerr̥.ke#pˌejv.vij.nis
Erkkebeaivi+N+Der/viđá+Adv	Erkkebeaiveviđá	ˈerr̥.ke#pˌĕæjː.ve»vˌi.ðɑː
Erkkebeaivi+N+Sg+Nom	Erkkebeaivi	ˈerr̥.ke#pˌĕæjː.vi
Erkkebeaivi+N+Sg+Ill	Erkkebeaivái	ˈerr̥.ke#pˌĕæjː.vɑːj
Erkkebeaivi+N+Pl+Nom	Erkkebeaivvit	ˈerr̥.ke#pˌeæjv.vih
Erkkebeaivi+N+Sg+Loc+PxSg1	Erkkebeaivvistan	ˈerr̥.ke#pˌeæjv.vis.tɑn
Erkkebeaivi+N+Sg+Acc+PxPl2	Erkkebeaivvádet	ˈerr̥.ke#pˌeæjv.vɑː.deh
Erkkebeaivi+N+Sg+Acc+PxSg2	Erkkebeaivvát	ˈerr̥.ke#pˌeæjv.vɑːh
Erkkevahkku+N+Der/Dimin+N+Sg+Nom	Erkkevahkoš	ˈerr̥.ke#vˌɑh.ko»ʃ
Erkkevahkku+N+Sg+Gen+PxSg3	Erkkevahkus	ˈerr̥.ke#vˌɑhː.kus
Erkkevahkku+N+Sg+Com+PxDu2	Erkkevahkuineatte	ˈerr̥.ke#vˌɑh.kuj.nˌĕæt.te
Erkkevahkku+N+Der/viđá+Adv	Erkkevahkkoviđá	ˈerr̥.ke#vˌɑhː.ko»vˌi.ðɑː
Erkkevahkku+N+Sg+Ill	Erkkevahkkui	ˈerr̥.ke#vˌɑhː.kuj
Eskilvahkku+N+Sg+Acc+PxSg2	Eskilvahkot	ˈesː.kil#vˌɑh.koh
Eskilvahkku+N+Sg+Gen+PxDu2	Eskilvahkode	ˈesː.kil#vˌɑh.ko.de
Eskilvahkku+N+Der/laš+A+AttrCmp+Der/suorat+A+Attr	Eskilvahkolašsuorat	ˈesː.kil#vˌɑh.ko»lɑʃ»sˌuo.rɑh
Eskilvahkku+N+Pl+Nom	Eskilvahkut	ˈesː.kil#vˌɑhː.kuh
Eskilvahkku+N+Sg+Acc+PxSg3	Eskilvahkus	ˈesː.kil#vˌɑhː.kus
Eskilvahkku+N+Sg+Acc+PxPl2	Eskilvahkkodet	ˈesː.kil#vˌɑhː.ko.deh
Eskilvahkku+N+Sg+Nom+PxDu2	Eskilvahkkode	ˈesː.kil#vˌɑhː.ko.de
Eskilvahkku+N+Der/viđá+Adv	Eskilvahkkoviđá	ˈesː.kil#vˌɑhː.ko»vˌi.ðɑː
Eskilvahkku+N+Ess+PxPl2	Eskilvahkkuneattet	ˈesː.kil#vˌɑhː.ku.nˌĕæt.teh
Eskilvahkku+N+Pl+Nom	Eskilvahkkut	ˈesː.kil#vˌɑhː.kuh
Eskilvahkku+N+Sg+Acc+PxDu3	Eskilvahkkuska	ˈesː.kil#vˌɑhː.kus.kɑ
Eskilvahkku+N+Sg+Gen	Eskilvahkku	ˈesː.kil#vˌɑhː.ku
Eskilvahkku+N+Sg+Com	Eskilvahkkuin	ˈesː.kil#vˌɑhː.kujn
Gucco+Interj	Gucco	kˈut.tso
Heaikkavahkku+N+Sg+Gen+PxSg2	Heaikkavahkot	hˈeæjç.kɑ#vˌɑh.koh
Heaikkavahkku+N+Der/Dimin+N+Sg+Nom	Heaikkavahkoš	hˈeæjç.kɑ#vˌɑh.ko»ʃ
Heaikkavahkku+N+Der/Dimin+N+Ess	Heaikkavahkožin	hˈeæjç.kɑ#vˌɑh.ko»dʃin
Heaikkavahkku+N+Der/Dimin+N+Sg+Gen	Heaikkavahkoža	hˈeæjç.kɑ#vˌɑh.ko»dʃɑ
Heaikkavahkku+N+Der/Dimin+N+Pl+Acc	Heaikkavahkožiid	hˈeæjç.kɑ#vˌɑh.ko»dʃijh
Heaikkavahkku+N+Der/laš+A+Superl+Sg+Nom	Heaikkavahkolamos	hˈeæjç.kɑ#vˌɑh.ko»lˌɑ.mos
Heaikkavahkku+N+Der/laš+A+Superl+Attr	Heaikkavahkoleamos	hˈeæjç.kɑ#vˌɑh.ko»lˌĕæ.mos
Heaikkavahkku+N+Der/laš+A+Superl+Der/at+Adv	Heaikkavahkolepmosit	hˈeæjç.kɑ#vˌɑh.ko»lˌep.mo.sih
Heaikkavahkku+N+Der/laš+A+AttrCmp+Der/ivnnat+A+Der/vuohta+N+Sg+Com+PxDu3	Heaikkavahkolašivnnatvuođaineaskka	hˈeæjç.kɑ#vˌɑh.ko»lɑʃ»ˌivn.nɑh»vˌuo.ðɑj.nˌeæs.kɑ
Heaikkavahkku+N+Pl+Acc+PxDu3	Heaikkavahkuideaskka	hˈeæjç.kɑ#vˌɑh.kuj.dˌeæs.kɑ
Heaikkavahkku+N+Sg+Acc	Heaikkavahku	hˈeæjç.kɑ#vˌɑhː.ku
Heaikkavahkku+N+Sg+Gen+PxDu3	Heaikkavahkuska	hˈeæjç.kɑ#vˌɑhː.kus.kɑ
Heaikkavahkku+N+Sg+Gen+PxSg3	Heaikkavahkus	hˈeæjç.kɑ#vˌɑhː.kus
Heaikkavahkku+N+Sg+Gen+PxPl1	Heaikkavahkkomet	hˈeæjç.kɑ#vˌɑhː.ko.meh
Heaikkavahkku+N+Sg+Ill+PxDu2	Heaikkavahkkoseatte	hˈeæjç.kɑ#vˌɑhː.ko.sˌĕæt.te
Heaikkavahkku+N+Der/Dimin+N+Sg+Acc	Heaikkavahkkoža	hˈeæjç.kɑ#vˌɑhː.ko»dʃɑ
Heaikkavahkku+N+Der/heapmi+A+Sg+Ill	Heaikkavahkkoheapmái	hˈeæjç.kɑ#vˌɑhː.ko»hˌeæp.mɑːj
Heaikkavahkku+N+Der/huvva+V+IV+Imprt+Du2	Heaikkavahkkohuvvi	hˈeæjç.kɑ#vˌɑhː.ko»hˌuvː.vi
Heaikkavahkku+N+Der/viđá+Adv	Heaikkavahkkoviđá	hˈeæjç.kɑ#vˌɑhː.ko»vˌi.ðɑː
Heaikkavahkku+N+Ess+PxDu2	Heaikkavahkkuneatte	hˈeæjç.kɑ#vˌɑhː.ku.nˌĕæt.te
Heaikkavahkku+N+Ess+PxPl2	Heaikkavahkkuneattet	hˈeæjç.kɑ#vˌɑhː.ku.nˌĕæt.teh
Heaikkavahkku+N+Pl+Nom	Heaikkavahkkut	hˈeæjç.kɑ#vˌɑhː.kuh
Heaikkavahkku+N+Pl+Nom+PxSg3	Heaikkavahkkuidis	hˈeæjç.kɑ#vˌɑhː.kuj.dis
Heaikkavahkku+N+Sg+Acc+PxDu3	Heaikkavahkkuska	hˈeæjç.kɑ#vˌɑhː.kus.kɑ
Heaikkavahkku+N+Sg+Gen+PxDu3	Heaikkavahkkuska	hˈeæjç.kɑ#vˌɑhː.kus.kɑ
Hosianna+Interj	Hosianna	hˈo.si.ˌɑn.nɑ
Konsešuvdnaeaktuduvvon+A+Attr	Konsešuvdnaeaktuduvvon	khˈonː.se.ʃˌuβː.tnɑ#ˌeækː.htu.dˌuv.von
Konsešuvdnaeaktuduvvon+A+Pl+Nom	Konsešuvdnaeaktuduvvon	khˈonː.se.ʃˌuβː.tnɑ#ˌeækː.htu.dˌuv.von
Konsešuvdnaeaktuduvvon+A+Sg+Nom	Konsešuvdnaeaktuduvvon	khˈonː.se.ʃˌuβː.tnɑ#ˌeækː.htu.dˌuv.von
Luciabeaivi+N+Pl+Acc+PxDu2	Luciabeivviideatte	lˈu.tsi.ɑ#pˌejv.vij.dˌĕæt.te
Luciabeaivi+N+Pl+Com+PxSg2	Luciabeivviidatguin	lˈu.tsi.ɑ#pˌejv.vij.dˌɑt.gujn
Luciabeaivi+N+Sg+Com+PxPl1	Luciabeivviineamet	lˈu.tsi.ɑ#pˌejv.vij.nˌĕæ.meh
Luciabeaivi+N+Sg+Com+PxPl3	Luciabeivviineaset	lˈu.tsi.ɑ#pˌejv.vij.nˌĕæ.seh
Luciabeaivi+N+Sg+Com	Luciabeivviin	lˈu.tsi.ɑ#pˌejv.vijn
Luciabeaivi+N+Der/viđá+Adv	Luciabeaiveviđá	lˈu.tsi.ɑ#pˌĕæjː.ve»vˌi.ðɑː
Luciabeaivi+N+Sg+Ill	Luciabeaivái	lˈu.tsi.ɑ#pˌĕæjː.vɑːj
Luciabeaivi+N+Sg+Gen+Allegro	Luciabeaivve	lˈu.tsi.ɑ#pˌĕæjv.ve
Luciabeaivi+N+Der/huvva+V+IV+Imprt+Sg2	Luciabeaivvehuva	lˈu.tsi.ɑ#pˌĕæjv.ve»hˌu.vɑ
Luciabeaivi+N+Pl+Nom	Luciabeaivvit	lˈu.tsi.ɑ#pˌeæjv.vih
Luciabeaivi+N+Sg+Acc+PxSg2	Luciabeaivvát	lˈu.tsi.ɑ#pˌeæjv.vɑːh
Luciabeaivi+N+Der/Dimin+N+Pl+Nom+PxPl3	Luciabeaivvážiiddiset	lˈu.tsi.ɑ#pˌeæjv.vɑː»dʃˌijt.ti.seh
Luciabeaivi+N+Der/laš+A+Comp+Sg+Nom	Luciabeaivválit	lˈu.tsi.ɑ#pˌeæjv.vɑː»lih
Lávrrasvahkku+N+Sg+Acc+PxSg2	Lávrrasvahkot	lˈɑːβr.rɑs#vˌɑh.koh
Lávrrasvahkku+N+Sg+Gen+PxPl2	Lávrrasvahkodet	lˈɑːβr.rɑs#vˌɑh.ko.deh
Lávrrasvahkku+N+Der/Dimin+N+Sg+Nom	Lávrrasvahkoš	lˈɑːβr.rɑs#vˌɑh.ko»ʃ
Lávrrasvahkku+N+Der/laš+A+Der/vuohta+N+Sg+Acc+PxPl1	Lávrrasvahkolašvuohtamet	lˈɑːβr.rɑs#vˌɑh.ko»lɑʃ»vˌuoh.tɑ.meh
Lávrrasvahkku+N+Pl+Gen+PxPl3	Lávrrasvahkuideaset	lˈɑːβr.rɑs#vˌɑh.kuj.dˌĕæ.seh
Lávrrasvahkku+N+Pl+Nom	Lávrrasvahkut	lˈɑːβr.rɑs#vˌɑhː.kuh
Lávrrasvahkku+N+Sg+Acc+PxDu3	Lávrrasvahkuska	lˈɑːβr.rɑs#vˌɑhː.kus.kɑ
Lávrrasvahkku+N+Sg+Com+PxDu1	Lávrrasvahkuineame	lˈɑːβr.rɑs#vˌɑh.kuj.nˌĕæ.me
Lávrrasvahkku+N+Sg+Com+PxDu3	Lávrrasvahkuineaskka	lˈɑːβr.rɑs#vˌɑh.kuj.nˌeæs.kɑ
Lávrrasvahkku+N+Der/heapmi+A+Pl+Acc	Lávrrasvahkuhemiid	lˈɑːβr.rɑs#vˌɑh.ku»hˌe.mijh
Lávrrasvahkku+N+Sg+Acc+PxDu2	Lávrrasvahkkode	lˈɑːβr.rɑs#vˌɑhː.ko.de
Lávrrasvahkku+N+Sg+Gen+PxPl2	Lávrrasvahkkodet	lˈɑːβr.rɑs#vˌɑhː.ko.deh
Lávrrasvahkku+N+Sg+Nom+PxPl2	Lávrrasvahkkodet	lˈɑːβr.rɑs#vˌɑhː.ko.deh
Lávrrasvahkku+N+Der/laš+A+Superl+Sg+Gen	Lávrrasvahkkolepmosa	lˈɑːβr.rɑs#vˌɑhː.ko»lˌep.mo.sɑ
Lávrrasvahkku+N+Der/viđá+Adv	Lávrrasvahkkoviđá	lˈɑːβr.rɑs#vˌɑhː.ko»vˌi.ðɑː
Lávrrasvahkku+N+Ess+PxPl2	Lávrrasvahkkuneattet	lˈɑːβr.rɑs#vˌɑhː.ku.nˌĕæt.teh
Lávrrasvahkku+N+Pl+Nom	Lávrrasvahkkut	lˈɑːβr.rɑs#vˌɑhː.kuh
Lávrrasvahkku+N+Sg+Gen+PxDu3	Lávrrasvahkkuska	lˈɑːβr.rɑs#vˌɑhː.kus.kɑ
Lávrrasvahkku+N+Sg+Loc	Lávrrasvahkkus	lˈɑːβr.rɑs#vˌɑhː.kus
Lávrrasvahkku+N+Sg+Ill	Lávrrasvahkkui	lˈɑːβr.rɑs#vˌɑhː.kuj
Mihkalmeassu+G3+N+Der/Dimin+N+Pl+Nom	Mihkalmessožat	mˈihː.kɑːl#mˌes.so»dʃɑh
Mihkalmeassu+G3+N+Der/viđá+Adv	Mihkalmeassoviđá	mˈihː.kɑːl#mˌĕæs.so»vˌi.ðɑː
Mihkalmeassu+G3+N+Pl+Loc+PxDu3	Mihkalmeassuineaskka	mˈihː.kɑːl#mˌeæs.suj.nˌeæs.kɑ
Mihkalmasbasit+N+Ess	Mihkalmasbassin	mˈihː.kɑːlə.mɑs#pˌɑsː.sin
Mihkalmasbeaivi+N+Sg+Com+PxSg3	Mihkalmasbeivviinis	mˈihː.kɑːlə.mɑs#pˌejv.vij.nis
Mihkalmasvahkku+N+Sg+Acc+PxSg2	Mihkalmasvahkot	mˈihː.kɑːlə.mɑs#vˌɑh.koh
Mihkalmasvahkku+N+Der/laš+A+Attr	Mihkalmasvahkolaš	mˈihː.kɑːlə.mɑs#vˌɑh.ko»lɑʃ
Mihkalmasvahkku+N+Pl+Ill	Mihkalmasvahkuide	mˈihː.kɑːlə.mɑs#vˌɑh.kuj.de
Mihkalmasvahkku+N+Pl+Nom+PxDu3	Mihkalmasvahkuideaskka	mˈihː.kɑːlə.mɑs#vˌɑh.kuj.dˌeæs.kɑ
Mihkalmasvahkku+N+Sg+Acc	Mihkalmasvahkku	mˈihː.kɑːlə.mɑs#vˌɑhː.ku
Máhtebeaivi+N+Pl+Acc+PxDu3	Máhtebeivviideaskka	mˈɑːh.te#pˌejv.vij.dˌeæs.kɑ
Máhtebeaivi+N+Pl+Ill+PxPl1	Máhtebeivviidasamet	mˈɑːh.te#pˌejv.vij.dˌɑ.sɑ.meh
Máhtebeaivi+N+Pl+Loc+PxSg2	Máhtebeivviinat	mˈɑːh.te#pˌejv.vij.nɑh
Máhtebeaivi+N+Sg+Com+PxPl2	Máhtebeivviineattet	mˈɑːh.te#pˌejv.vij.nˌĕæt.teh
Máhtebeaivi+N+Pl+Nom	Máhtebeaivvit	mˈɑːh.te#pˌeæjv.vih
Máhtemeasvahkku+N+Sg+Loc	Máhtemeasvahkus	mˈɑːh.te#meæs#vˌɑhː.kus
Máhtemesvahkku+N+Pl+Nom	Máhtemesvahkut	mˈɑːh.te#mes#vˌɑhː.kuh
Máhtemesvahkku+N+Sg+Com+PxSg2	Máhtemesvahkkuinat	mˈɑːh.te#mes#vˌɑhː.kuj.nɑh
Márggasvahkku+N+Der/laš+A+Comp+Attr	Márggasvahkolit	mˈɑːrk.kɑs#vˌɑh.ko»lih
Márggasvahkku+N+Sg+Gen+PxPl3	Márggasvahkuset	mˈɑːrk.kɑs#vˌɑh.ku.seh
Márggasvahkku+N+Sg+Loc	Márggasvahkus	mˈɑːrk.kɑs#vˌɑhː.kus
Márggasvahkku+N+Sg+Acc+PxSg2	Márggasvahkkot	mˈɑːrk.kɑs#vˌɑhː.koh
Márggasvahkku+N+Pl+Loc+PxDu3	Márggasvahkkuineaskka	mˈɑːrk.kɑs#vˌɑhː.kuj.nˌeæs.kɑ
Márjjabeaivvedánssat+N+Pl+Nom	Márjjabeaivvedánssat	mˈɑːrj.jɑ#pˌĕæjv.ve#tˌɑːns.sɑh
Márjjabeaivvedánssat+N+Der/Dimin+N+Pl+Nom	Márjjabeaivvedánssažat	mˈɑːrj.jɑ#pˌĕæjv.ve#tˌɑːns.sɑ»dʃɑh
Márjjameassu+G3+N+Der/viđá+Adv	Márjjameassoviđá	mˈɑːrj.jɑ#mˌĕæs.so»vˌi.ðɑː
Márjjameassu+G3+N+Ess+PxDu2	Márjjameassuneatte	mˈɑːrj.jɑ#mˌeæs.su.nˌĕæt.te
Márjjábeaidánssat+N+Ess	Márjjábeaidánsan	mˈɑːrj.jɑː#peæj#tˌɑːnː.sɑn
Márjjábeaidánssat+N+Der/Dimin+N+Pl+Nom	Márjjábeaidánssažat	mˈɑːrj.jɑː#peæj#tˌɑːns.sɑ»dʃɑh
Márjjávahkku+N+Der/viđá+Adv	Márjjávahkkoviđá	mˈɑːrj.jɑː#vˌɑhː.ko»vˌi.ðɑː
Márjjávahkku+N+Sg+Ill	Márjjávahkkui	mˈɑːrj.jɑː#vˌɑhː.kuj
Norggaáittardeaddji+N+NomAg+Pl+Acc+PxPl3	Norggaáittardeddjiideaset	nˈorkː.kɑː#ˌɑːjç.tɑr.dˌeɟː.cij.dˌĕæ.seh
Norggaáittardeaddji+N+NomAg+Pl+Com	Norggaáittardeddjiiguin	nˈorkː.kɑː#ˌɑːjç.tɑr.dˌeɟː.cij.gujn
Norggaáittardeaddji+N+NomAg+Pl+Gen+PxPl1	Norggaáittardeddjiideamet	nˈorkː.kɑː#ˌɑːjç.tɑr.dˌeɟː.cij.dˌĕæ.meh
Norggaáittardeaddji+N+NomAg+Pl+Loc+PxDu1	Norggaáittardeddjiineame	nˈorkː.kɑː#ˌɑːjç.tɑr.dˌeɟː.cij.nˌĕæ.me
Norggaáittardeaddji+N+NomAg+Pl+Nom+PxPl2	Norggaáittardeddjiideattet	nˈorkː.kɑː#ˌɑːjç.tɑr.dˌeɟː.cij.dˌĕæt.teh
Norggaáittardeaddji+N+NomAg+Pl+Nom+PxSg3	Norggaáittardeddjiidis	nˈorkː.kɑː#ˌɑːjç.tɑr.dˌeɟː.cij.dis
Norggaáittardeaddji+N+NomAg+Sg+Com+PxDu2	Norggaáittardeddjiineatte	nˈorkː.kɑː#ˌɑːjç.tɑr.dˌeɟː.cij.nˌĕæt.te
Norggaáittardeaddji+N+NomAg+Sg+Com+PxPl2	Norggaáittardeddjiineattet	nˈorkː.kɑː#ˌɑːjç.tɑr.dˌeɟː.cij.nˌĕæt.teh
Norggaáittardeaddji+N+NomAg+Sg+Com+PxSg2	Norggaáittardeddjiinat	nˈorkː.kɑː#ˌɑːjç.tɑr.dˌeɟː.cij.nɑh
Norggaáittardeaddji+N+NomAg+Sg+Com+PxSg3	Norggaáittardeddjiinis	nˈorkː.kɑː#ˌɑːjç.tɑr.dˌeɟː.cij.nis
Norggaáittardeaddji+N+NomAg+Sg+Gen	Norggaáittardeaddje	nˈorkː.kɑː#ˌɑːjç.tɑr.dˌĕæɟː.ce
Norggaáittardeaddji+N+NomAg+Der/viđá+Adv	Norggaáittardeaddjeviđá	nˈorkː.kɑː#ˌɑːjç.tɑr.dˌĕæɟː.ce»vˌi.ðɑː
Norggaáittardeaddji+N+NomAg+Ess+PxPl3	Norggaáittardeaddjineaset	nˈorkː.kɑː#ˌɑːjç.tɑr.dˌĕæɟː.ci.nˌĕæ.seh
Norggaáittardeaddji+N+NomAg+Pl+Nom	Norggaáittardeaddjit	nˈorkː.kɑː#ˌɑːjç.tɑr.dˌĕæɟː.cih
Norggaáittardeaddji+N+NomAg+Sg+Acc+PxSg3	Norggaáittardeaddjis	nˈorkː.kɑː#ˌɑːjç.tɑr.dˌĕæɟː.cis
Norggaáittardeaddji+N+NomAg+Sg+Nom	Norggaáittardeaddji	nˈorkː.kɑː#ˌɑːjç.tɑr.dˌĕæɟː.ci
Norggaáittardeaddji+N+NomAg+Sg+Acc+PxPl2	Norggaáittardeaddjádet	nˈorkː.kɑː#ˌɑːjç.tɑr.dˌĕæɟː.cɑː.deh
Norggaáittardeaddji+N+NomAg+Sg+Ill	Norggaáittardeaddjái	nˈorkː.kɑː#ˌɑːjç.tɑr.dˌĕæɟː.cɑːj
Norggaáittardeaddji+N+Sg+Ill+NomAg+PxSg1	Norggaáittardeaddjásan	nˈorkː.kɑː#ˌɑːjç.tɑr.dˌĕæɟː.cɑː.sɑn
Norggaáittardeaddji+N+Sg+Nom+NomAg+PxDu2	Norggaáittardeaddjáde	nˈorkː.kɑː#ˌɑːjç.tɑr.dˌĕæɟː.cɑː.de
Nuvttevahkku+N+Sg+Gen+PxDu2	Nuvttevahkode	nˈuβɸ.te#vˌɑh.ko.de
Nuvttevahkku+N+Sg+Gen+PxPl2	Nuvttevahkodet	nˈuβɸ.te#vˌɑh.ko.deh
Nuvttevahkku+N+Sg+Gen+PxSg2	Nuvttevahkot	nˈuβɸ.te#vˌɑh.koh
Nuvttevahkku+N+Der/Dimin+N+Sg+Nom+PxDu2	Nuvttevahkožeatte	nˈuβɸ.te#vˌɑh.ko»dʃˌĕæt.te
Nuvttevahkku+N+Der/laš+A+Superl+Sg+Ill	Nuvttevahkolamosii	nˈuβɸ.te#vˌɑh.ko»lˌɑ.mo.sij
Nuvttevahkku+N+Der/laš+A+Der/vuohta+N+Sg+Ill	Nuvttevahkolašvuhtii	nˈuβɸ.te#vˌɑh.ko»lɑʃ»vˌuh.tij
Nuvttevahkku+N+Pl+Gen+PxDu2	Nuvttevahkuideatte	nˈuβɸ.te#vˌɑh.kuj.dˌĕæt.te
Nuvttevahkku+N+Pl+Loc+PxSg1	Nuvttevahkuinan	nˈuβɸ.te#vˌɑh.kuj.nɑn
Nuvttevahkku+N+Pl+Nom	Nuvttevahkut	nˈuβɸ.te#vˌɑhː.kuh
Nuvttevahkku+N+Sg+Nom+PxSg2	Nuvttevahkkot	nˈuβɸ.te#vˌɑhː.koh
Nuvttevahkku+N+Der/Dimin+N+Der/viđá+Adv	Nuvttevahkkošviđá	nˈuβɸ.te#vˌɑhː.ko»ʃ»vˌi.ðɑː
Nuvttevahkku+N+Der/heapmi+A+Comp+Sg+Nom	Nuvttevahkkohit	nˈuβɸ.te#vˌɑhː.ko»hih
Nuvttevahkku+N+Ess+PxSg2	Nuvttevahkkunat	nˈuβɸ.te#vˌɑhː.ku.nɑh
Nuvttevahkku+N+Pl+Nom	Nuvttevahkkut	nˈuβɸ.te#vˌɑhː.kuh
Nuvttevahkku+N+Sg+Ill	Nuvttevahkkui	nˈuβɸ.te#vˌɑhː.kuj
Simmonvahkku+N+Sg+Acc+PxDu2	Simmonvahkode	sˈim.mon#vˌɑh.ko.de
Simmonvahkku+N+Sg+Gen+PxDu2	Simmonvahkode	sˈim.mon#vˌɑh.ko.de
Simmonvahkku+N+Pl+Nom	Simmonvahkut	sˈim.mon#vˌɑhː.kuh
Simmonvahkku+N+Sg+Acc	Simmonvahku	sˈim.mon#vˌɑhː.ku
Simmonvahkku+N+Sg+Com+PxDu2	Simmonvahkuineatte	sˈim.mon#vˌɑh.kuj.nˌĕæt.te
Simmonvahkku+N+Der/viđá+Adv	Simmonvahkkoviđá	sˈim.mon#vˌɑhː.ko»vˌi.ðɑː
Simmonvahkku+N+Ess+PxDu3	Simmonvahkkuneaskka	sˈim.mon#vˌɑhː.ku.nˌeæs.kɑ
Simmonvahkku+N+Ess+PxPl2	Simmonvahkkuneattet	sˈim.mon#vˌɑhː.ku.nˌĕæt.teh
Simmonvahkku+N+Sg+Gen	Simmonvahkku	sˈim.mon#vˌɑhː.ku
Simmonvahkku+N+Sg+Loc	Simmonvahkkus	sˈim.mon#vˌɑhː.kus
St.dieđáhus+N+Pl+Nom	St.dieđáhusat	st.die.ðɑː.hu.sɑh
St.dieđáhus+N+Pl+Gen+PxSg3	St.dieđáhusaidis	st.die.ðɑː.hu.sɑj.dis
St.dieđáhus+N+Pl+Nom+PxSg3	St.dieđáhusaidis	st.die.ðɑː.hu.sɑj.dis
St.dieđáhus+N+Sg+Acc+PxSg3	St.dieđáhusas	st.die.ðɑː.hu.sɑs
St.dieđáhus+N+Sg+Gen+PxPl2	St.dieđáhusadet	st.die.ðɑː.hu.sɑ.deh
St.dieđáhus+N+Sg+Loc+PxPl2	St.dieđáhusasteattet	st.die.ðɑː.hu.sɑs.tĕæt.teh
St.dieđáhus+N+Sg+Com+PxDu3	St.dieđáhusaineaskka	st.die.ðɑː.hu.sɑj.neæs.kɑ
St.dieđáhus+N+Sg+Com+PxPl3	St.dieđáhusaineaset	st.die.ðɑː.hu.sɑj.nĕæ.seh
St.dieđáhus+N+Der/Dimin+N+Sg+Nom	St.dieđáhusaš	st.die.ðɑː.hu.sɑ»ʃ
St.dieđáhus+N+Der/Dimin+N+Ess	St.dieđáhusažin	st.die.ðɑː.hu.sɑ»dʃin
St.dieđáhus+N+Sg+Gen+PxSg1	St.dieđáhussan	st.die.ðɑː.hus.sɑn
St.dieđáhus+N+Sg+Nom+PxDu1	St.dieđáhussame	st.die.ðɑː.hus.sɑ.me
St.dieđáhus+N+Sg+Ill	St.dieđáhussii	st.die.ðɑː.hus.sij
Suomaáittardeaddji+N+NomAg+Pl+Acc+PxDu2	Suomaáittardeddjiideatte	sˈuo.mɑ#ˌɑːjç.tɑr.dˌeɟː.cij.dˌĕæt.te
Suomaáittardeaddji+N+NomAg+Pl+Acc+PxPl3	Suomaáittardeddjiideaset	sˈuo.mɑ#ˌɑːjç.tɑr.dˌeɟː.cij.dˌĕæ.seh
Suomaáittardeaddji+N+NomAg+Pl+Acc+PxSg2	Suomaáittardeddjiidat	sˈuo.mɑ#ˌɑːjç.tɑr.dˌeɟː.cij.dɑh
Suomaáittardeaddji+N+NomAg+Pl+Gen+PxPl1	Suomaáittardeddjiideamet	sˈuo.mɑ#ˌɑːjç.tɑr.dˌeɟː.cij.dˌĕæ.meh
Suomaáittardeaddji+N+NomAg+Sg+Com+PxDu3	Suomaáittardeddjiineaskka	sˈuo.mɑ#ˌɑːjç.tɑr.dˌeɟː.cij.nˌeæs.kɑ
Suomaáittardeaddji+N+NomAg+Sg+Com+PxPl2	Suomaáittardeddjiineattet	sˈuo.mɑ#ˌɑːjç.tɑr.dˌeɟː.cij.nˌĕæt.teh
Suomaáittardeaddji+N+NomAg+Sg+Com+PxSg1	Suomaáittardeddjiinan	sˈuo.mɑ#ˌɑːjç.tɑr.dˌeɟː.cij.nɑn
Suomaáittardeaddji+N+NomAg+Sg+Com+PxSg2	Suomaáittardeddjiinat	sˈuo.mɑ#ˌɑːjç.tɑr.dˌeɟː.cij.nɑh
Suomaáittardeaddji+N+NomAg+Sg+Gen	Suomaáittardeaddje	sˈuo.mɑ#ˌɑːjç.tɑr.dˌĕæɟː.ce
Suomaáittardeaddji+N+NomAg+Sg+Loc+PxPl3	Suomaáittardeaddjisteaset	sˈuo.mɑ#ˌɑːjç.tɑr.dˌĕæɟː.cis.tˌĕæ.seh
Urbanbeaivi+N+Pl+Acc+PxDu1	Urbanbeivviideame	ˈurə.pɑn#pˌejv.vij.dˌĕæ.me
Urbanbeaivi+N+Pl+Com+PxDu2	Urbanbeivviideatteguin	ˈurə.pɑn#pˌejv.vij.dˌĕæt.te.gujn
Urbanbeaivi+N+Pl+Com+PxPl2	Urbanbeivviideattetguin	ˈurə.pɑn#pˌejv.vij.dˌĕæt.tet.gujn
Urbanbeaivi+N+Pl+Gen	Urbanbeivviid	ˈurə.pɑn#pˌejv.vijh
Urbanbeaivi+N+Pl+Ill+PxDu1	Urbanbeivviidasame	ˈurə.pɑn#pˌejv.vij.dˌɑ.sɑ.me
Urbanbeaivi+N+Pl+Loc+PxDu1	Urbanbeivviineame	ˈurə.pɑn#pˌejv.vij.nˌĕæ.me
Urbanbeaivi+N+Pl+Loc+PxSg2	Urbanbeivviinat	ˈurə.pɑn#pˌejv.vij.nɑh
Urbanbeaivi+N+Sg+Com+PxDu2	Urbanbeivviineatte	ˈurə.pɑn#pˌejv.vij.nˌĕæt.te
Urbanbeaivi+N+Sg+Com+PxPl3	Urbanbeivviineaset	ˈurə.pɑn#pˌejv.vij.nˌĕæ.seh
Urbanbeaivi+N+Sg+Com+PxSg2	Urbanbeivviinat	ˈurə.pɑn#pˌejv.vij.nɑh
Urbanbeaivi+N+Sg+Com	Urbanbeivviin	ˈurə.pɑn#pˌejv.vijn
Urbanbeaivi+N+Der/viđá+Adv	Urbanbeaiveviđá	ˈurə.pɑn#pˌĕæjː.ve»vˌi.ðɑː
Urbanbeaivi+N+Sg+Nom	Urbanbeaivi	ˈurə.pɑn#pˌĕæjː.vi
Urbanbeaivi+N+Sg+Gen+Allegro	Urbanbeaivve	ˈurə.pɑn#pˌĕæjv.ve
Urbanbeaivi+N+Der/heapmi+A+Comp+Attr	Urbanbeaivvehit	ˈurə.pɑn#pˌĕæjv.ve»hih
Urbanbeaivi+N+Der/heapmi+A+Attr+Der/vuohta+N+Sg+Ill	Urbanbeaivvehisvuhtii	ˈurə.pɑn#pˌĕæjv.ve»his»vˌuh.tij
Urbanbeaivi+N+Sg+Acc+PxSg3	Urbanbeaivvis	ˈurə.pɑn#pˌeæjv.vis
Urbanbeaivi+N+Sg+Gen+PxDu3	Urbanbeaivviska	ˈurə.pɑn#pˌeæjv.vis.kɑ
Urbanbeaivi+N+Sg+Gen+PxPl3	Urbanbeaivviset	ˈurə.pɑn#pˌeæjv.vi.seh
Urbanbeaivi+N+Der/heapmi+A+Comp+Pl+Nom	Urbanbeaivvihabbot	ˈurə.pɑn#pˌeæjv.vi»hˌɑbː.poh
Urbanbeaivi+N+Der/heapmi+A+Attr+Der/vuohta+N+Sg+Ill	Urbanbeaivvihisvuhtii	ˈurə.pɑn#pˌeæjv.vi»his»vˌuh.tij
Urbanbeaivi+N+Sg+Acc+PxSg2	Urbanbeaivvát	ˈurə.pɑn#pˌeæjv.vɑːh
Urbánbeaivi+N+Pl+Acc+PxSg2	Urbánbeivviidat	ˈurə.pɑːn#pˌejv.vij.dɑh
Urbánbeaivi+N+Pl+Gen+PxSg3	Urbánbeivviidis	ˈurə.pɑːn#pˌejv.vij.dis
Urbánbeaivi+N+Pl+Ill	Urbánbeivviide	ˈurə.pɑːn#pˌejv.vij.de
Urbánbeaivi+N+Sg+Com+PxDu1	Urbánbeivviineame	ˈurə.pɑːn#pˌejv.vij.nˌĕæ.me
Urbánbeaivi+N+Sg+Com+PxDu2	Urbánbeivviineatte	ˈurə.pɑːn#pˌejv.vij.nˌĕæt.te
Urbánbeaivi+N+Sg+Com+PxSg2	Urbánbeivviinat	ˈurə.pɑːn#pˌejv.vij.nɑh
Urbánbeaivi+N+Sg+Com+PxSg3	Urbánbeivviinis	ˈurə.pɑːn#pˌejv.vij.nis
Urbánbeaivi+N+Der/viđá+Adv	Urbánbeaiveviđá	ˈurə.pɑːn#pˌĕæjː.ve»vˌi.ðɑː
Urbánbeaivi+N+Ess+PxDu1	Urbánbeaivineame	ˈurə.pɑːn#pˌĕæjː.vi.nˌĕæ.me
Urbánbeaivi+N+Ess+PxPl1	Urbánbeaivineamet	ˈurə.pɑːn#pˌĕæjː.vi.nˌĕæ.meh
Urbánbeaivi+N+Sg+Nom	Urbánbeaivi	ˈurə.pɑːn#pˌĕæjː.vi
Urbánbeaivi+N+Sg+Ill+PxDu2	Urbánbeaiváseatte	ˈurə.pɑːn#pˌĕæjː.vɑː.sˌĕæt.te
Urbánbeaivi+N+Sg+Nom+PxDu2	Urbánbeaiváde	ˈurə.pɑːn#pˌĕæjː.vɑː.de
Urbánbeaivi+N+Der/heapmi+A+Comp+Sg+Nom	Urbánbeaivveheabbo	ˈurə.pɑːn#pˌĕæjv.ve»hˌĕæbː.po
Urbánbeaivi+N+Pl+Nom	Urbánbeaivvit	ˈurə.pɑːn#pˌeæjv.vih
Urbánbeaivi+N+Sg+Loc	Urbánbeaivvis	ˈurə.pɑːn#pˌeæjv.vis
Urbánbeaivi+N+Sg+Gen+PxSg2	Urbánbeaivvát	ˈurə.pɑːn#pˌeæjv.vɑːh
Urbánbeaivi+N+Der/laš+A+Comp+Attr	Urbánbeaivválut	ˈurə.pɑːn#pˌeæjv.vɑː»luh
Vullešvahkku+N+Der/Dimin+N+Der/Dimin+N+Sg+Acc+PxDu2	Vullešvahkožaččade	vˈul.leʃ#vˌɑh.ko»dʃˌɑt.tʃɑ.de
Vullešvahkku+N+Der/Dimin+N+Der/Dimin+N+Sg+Ill	Vullešvahkožažžii	vˈul.leʃ#vˌɑh.ko»dʃˌɑdː.tʃij
Vullešvahkku+N+Der/laš+A+Comp+Sg+Ill	Vullešvahkolebbui	vˈul.leʃ#vˌɑh.ko»lˌebː.puj
Vullešvahkku+N+Der/laš+A+Ess	Vullešvahkolažžan	vˈul.leʃ#vˌɑh.ko»lˌɑdː.tʃɑn
Vullešvahkku+N+Pl+Nom	Vullešvahkut	vˈul.leʃ#vˌɑhː.kuh
Vullešvahkku+N+Sg+Gen	Vullešvahku	vˈul.leʃ#vˌɑhː.ku
Vullešvahkku+N+Sg+Com+PxSg1	Vullešvahkuinan	vˈul.leʃ#vˌɑh.kuj.nɑn
Vullešvahkku+N+Sg+Loc+PxDu1	Vullešvahkusteame	vˈul.leʃ#vˌɑhː.kus.tˌĕæ.me
Vullešvahkku+N+Sg+Loc+PxDu2	Vullešvahkusteatte	vˈul.leʃ#vˌɑhː.kus.tˌĕæt.te
Vullešvahkku+N+Der/huhtti+V+TV+VGen	Vullešvahkuhuhti	vˈul.leʃ#vˌɑh.ku»hˌuhː.ti
Vullešvahkku+N+Sg+Gen+PxDu2	Vullešvahkkode	vˈul.leʃ#vˌɑhː.ko.de
Vullešvahkku+N+Sg+Gen+PxSg2	Vullešvahkkot	vˈul.leʃ#vˌɑhː.koh
Vullešvahkku+N+Sg+Ill+PxDu2	Vullešvahkkoseatte	vˈul.leʃ#vˌɑhː.ko.sˌĕæt.te
Vullešvahkku+N+Der/huhtti+V+TV+Pot+Prs+ConNeg	Vullešvahkkohuhteš	vˈul.leʃ#vˌɑhː.ko»hˌuh.teʃ
Vullešvahkku+N+Der/viđá+Adv	Vullešvahkkoviđá	vˈul.leʃ#vˌɑhː.ko»vˌi.ðɑː
Vullešvahkku+N+Ess+PxDu1	Vullešvahkkuneame	vˈul.leʃ#vˌɑhː.ku.nˌĕæ.me
Vullešvahkku+N+Ess+PxPl2	Vullešvahkkuneattet	vˈul.leʃ#vˌɑhː.ku.nˌĕæt.teh
Vullešvahkku+N+Ess	Vullešvahkkun	vˈul.leʃ#vˌɑhː.kun
Vullešvahkku+N+Pl+Nom	Vullešvahkkut	vˈul.leʃ#vˌɑhː.kuh
Vullešvahkku+N+Pl+Acc	Vullešvahkkuid	vˈul.leʃ#vˌɑhː.kujh
Vullešvahkku+N+Pl+Com+PxPl2	Vullešvahkkuideattetguin	vˈul.leʃ#vˌɑhː.kuj.dˌĕæt.tet.gujn
Vullešvahkku+N+Pl+Com	Vullešvahkkuiguin	vˈul.leʃ#vˌɑhː.kuj.gujn
Vullešvahkku+N+Pl+Gen+PxPl2	Vullešvahkkuideattet	vˈul.leʃ#vˌɑhː.kuj.dˌĕæt.teh
Vullešvahkku+N+Sg+Acc	Vullešvahkku	vˈul.leʃ#vˌɑhː.ku
Vullešvahkku+N+Sg+Gen+PxDu3	Vullešvahkkuska	vˈul.leʃ#vˌɑhː.kus.kɑ
Vullešvahkku+N+Sg+Gen+PxPl3	Vullešvahkkuset	vˈul.leʃ#vˌɑhː.ku.seh
Vullešvahkku+N+Sg+Gen+PxSg3	Vullešvahkkus	vˈul.leʃ#vˌɑhː.kus
Vullešvahkku+N+Sg+Nom	Vullešvahkku	vˈul.leʃ#vˌɑhː.ku
Vullešvahkku+N+Sg+Com+PxDu3	Vullešvahkkuineaskka	vˈul.leʃ#vˌɑhː.kuj.nˌeæs.kɑ
Vullešvahkku+N+Sg+Com+PxSg1	Vullešvahkkuinan	vˈul.leʃ#vˌɑhː.kuj.nɑn
akkommodašuvdna+N+Sg+Nom+PxDu3	+OLang/NOBakkommodašuvdnaska	+o.lɑng/no.bɑk.kom.mo.dɑ.ʃuv.tnɑs.kɑ
akkommodašuvdna+N+Sg+Nom+PxPl3	+OLang/NOBakkommodašuvdnaset	+o.lɑng/no.bɑk.kom.mo.dɑ.ʃuv.tnɑ.seh
akkommodašuvdna+N+Ess+PxSg3	+OLang/NOBakkommodašuvdnanis	+o.lɑng/no.bɑk.kom.mo.dɑ.ʃuv.tnɑ.nis
akkommodašuvdna+N+Sg+Gen+PxDu3	+OLang/NOBakkommodašuvnnaska	+o.lɑng/no.bɑk.kom.mo.dɑ.ʃuvn.nɑs.kɑ
akkommodašuvdna+N+Sg+Com+PxDu1	+OLang/NOBakkommodašuvnnaineame	+o.lɑng/no.bɑk.kom.mo.dɑ.ʃuvn.nɑj.nĕæ.me
akkommodašuvdna+N+Sg+Loc	+OLang/NOBakkommodašuvnnas	+o.lɑng/no.bɑk.kom.mo.dɑ.ʃuvn.nɑs
asteroiida+N+Ess+PxSg3	+OLang/NOBasteroiidanis	+o.lɑng/no.bɑs.te.rojː.dɑ.nis
asteroiida+N+Pl+Acc+PxDu2	+OLang/NOBasteroiidaideatte	+o.lɑng/no.bɑs.te.rojː.dɑj.dĕæt.te
asteroiida+N+Pl+Acc+PxSg3	+OLang/NOBasteroiidaidis	+o.lɑng/no.bɑs.te.rojː.dɑj.dis
asteroiida+N+Pl+Nom	+OLang/NOBasteroiidat	+o.lɑng/no.bɑs.te.rojː.dɑh
asteroiida+N+Sg+Nom+PxPl2	+OLang/NOBasteroiidadet	+o.lɑng/no.bɑs.te.rojː.dɑ.deh
asteroiida+N+Sg+Loc	+OLang/NOBasteroiidas	+o.lɑng/no.bɑs.te.rojː.dɑs
asteroiida+N+Der/viđá+Adv	+OLang/NOBasteroiidaviđá	+o.lɑng/no.bɑs.te.rojː.dɑ»vˌi.ðɑː
asteroiida+N+Sg+Ill	+OLang/NOBasteroiidii	+o.lɑng/no.bɑs.te.rojː.dij
audiovisuála+N+Pl+Com	+OLang/NOBaudiovisuálaiguin	+o.lɑng/no.bɑu.dio#vˌi.su.ˌɑː.lɑj.gujn
audiovisuála+N+Pl+Nom	+OLang/NOBaudiovisuálat	+o.lɑng/no.bɑu.dio#vˌi.su.ˌɑː.lɑh
audiovisuála+N+Sg+Acc+PxDu3	+OLang/NOBaudiovisuálaska	+o.lɑng/no.bɑu.dio#vˌi.su.ˌɑː.lɑs.kɑ
audiovisuála+N+Sg+Gen+PxPl1	+OLang/NOBaudiovisuálamet	+o.lɑng/no.bɑu.dio#vˌi.su.ˌɑː.lɑ.meh
audiovisuála+N+Sg+Loc	+OLang/NOBaudiovisuálas	+o.lɑng/no.bɑu.dio#vˌi.su.ˌɑː.lɑs
audiovisuála+N+Sg+Ill	+OLang/NOBaudiovisuálii	+o.lɑng/no.bɑu.dio#vˌi.su.ˌɑː.lij
abbonneret+V+TV+Der/PassL+V+IV+Actio+Nom	abbonnerejuvvon	ˈɑbː.pon.nˌe.re»jˌuv.von
abonneret+V+TV+Ind+Prt+Pl1	abonneriimet	ˈɑ.bon.nˌe.rij.meh
aborteret+V+IV+Inf	aborteret	ˈɑ.bor.htˌe.reh
absorberet+V+TV+Ind+Prt+Du1	absorberiime	ˈɑb.sor.bˌe.rij.me
adresseret+V+TV+VAbess	adresserehaga	ˈɑ.dres.sˌe.re.hˌɑ.gɑ
adresseret+V+TV+Der/PassL+V+IV+Pot+Prs+Sg3	adresserejuvvoš	ˈɑ.dres.sˌe.re»j»ˌuv.voʃ
adopteret+V+TV+VAbess	adopterehaga	ˈɑ.dop.tˌe.re.hˌɑ.gɑ
addit+V+TV+Pot+Prs+Sg3	atteš	ˈɑt.teʃ
aetáhtta+N+Sg+Gen	aetáhta	ˈɑ.e.tˌɑːh.tɑ
aetáhtta+N+Sg+Loc	aetáhtas	ˈɑ.e.tˌɑːh.tɑs
afghánalaš+A+Sg+Nom	afghánalaš	ˈɑfg.hɑː.nˌɑ.lɑʃ
ahppar+A+Attr+Der/vuohta+N+Sg+Ill	ahpparvuhtii	ˈɑhː.pɑːr»vˌuh.tij
ahttat+V+IV+Ind+Prs+Sg3	ahttá	ˈɑhː.tɑː
aji+N+Pl+Nom	adjágat	ˈɑcː.cɑː.gɑh
akademihkalaš+A+Der/vuohta+N+Sg+Ill	akademihkalašvuhtii	ˈɑ.kɑː.ðˌe.mih.kˌɑ.lɑʃ»vˌuh.tij
allut+V+IV+Der/st+V+Ind+Prs+ConNeg	alos	ˈɑ.lo»s
alŋŋis+N+Sg+Loc	algŋás	ˈɑlə.kŋɑːs
amiidit+V+IV+Ind+Prs+ConNeg	amiit	ˈɑ.mijh
amorlaš+N+Sg+Nom	amorlaš	ˈɑ.mor.lɑʃ
amas+A+Superl+Pl+Gen	apmasamosiid	ˈɑpː.mɑː.sˌɑ.mo.sijh
arkiveret+V+TV+Der/PassL+V+IV+Der/upmi+N+Pl+Nom	arkiverejumit	ˈɑrə.hki.vˌe.re»j»ˌu.mih
aromatiseret+V+TV+Der/PassL+V+IV+Der/upmi+N+Sg+Gen+Allegro	aromatiserejume	ˈɑ.ro.mˌɑ.ti.sˌe.re»j»ˌu.me
assi+N+Der/heapmi+A+Comp+Sg+Ill	asihebbui	ˈɑ.si»hˌebː.puj
atnit+V+TV+Imprt+Pl2	adnet	ˈɑd.neh
atelihkalaš+A+Der/vuohta+N+Sg+Ill	atelihkalašvuhtii	ˈɑ.te.lˌih.kɑ.lɑʃ»vˌuh.tij
attraheret+V+TV+Ind+Prt+Sg3	attraherii	ˈɑt.trɑ.hˌe.rij
avádat+N+Pl+Gen+PxPl2	avádagaideattet	ˈɑ.vɑː.ðˌɑ.gɑj.dˌĕæt.teh
aziheapme+A+Der/huvva+V+IV+ConNegII	azihuvvo	ˈɑ.dsih»ˌuv.vo
ađa+N+Sg+Nom	ađa	ˈɑ.ðɑː
ađa+N+Pl+Gen+PxSg2	ađđamiiddát	ˈɑðː.ðɑː.mˌijtː.tɑːh
aŋaldagas+Adv	aŋaldagas	ˈɑ.ŋɑːl.dˌɑ.gɑs
aŋkke+Adv	aŋkke	ˈɑŋŋ̊.ke
aškkas+N+Sg+Com	aškasiin	ˈɑʃː.kɑː.sijn
boazolohkoraporta+N+Ess+PxDu2	+Use/Subboazolohkuraportaneatte	+u.se/subː.pŏɑ.dso#lˌoh.ku#rˌɑ.por.htˌɑ.nĕæt.te
boazolohkoraporta+N+Ess	+Use/Subboazolohkuraportan	+u.se/subː.pŏɑ.dso#lˌoh.ku#rˌɑ.por.htɑn
boazolohkoraporta+N+Sg+Gen+PxDu1	+Use/Subboazolohkuraportame	+u.se/subː.pŏɑ.dso#lˌoh.ku#rˌɑ.por.htˌɑ.me
boazolohkoraporta+N+Sg+Gen+PxPl1	+Use/Subboazolohkuraportamet	+u.se/subː.pŏɑ.dso#lˌoh.ku#rˌɑ.por.htˌɑ.meh
boazolohkoraporta+N+Sg+Gen+PxSg1	+Use/Subboazolohkuraportan	+u.se/subː.pŏɑ.dso#lˌoh.ku#rˌɑ.por.htɑn
boazolohkoraporta+N+Sg+Ill+PxDu2	+Use/Subboazolohkuraportaseatte	+u.se/subː.pŏɑ.dso#lˌoh.ku#rˌɑ.por.htˌɑ.sĕæt.te
boazolohkoraporta+N+Sg+Ill+PxSg3	+Use/Subboazolohkuraportasis	+u.se/subː.pŏɑ.dso#lˌoh.ku#rˌɑ.por.htˌɑ.sis
boazolohkoraporta+N+Sg+Nom+PxSg1	+Use/Subboazolohkuraportan	+u.se/subː.pŏɑ.dso#lˌoh.ku#rˌɑ.por.htɑn
boazolohkoraporta+N+Der/viđá+Adv	+Use/Subboazolohkuraportaviđá	+u.se/subː.pŏɑ.dso#lˌoh.ku#rˌɑ.por.htɑ»vˌi.ðɑː
boazolohkoraporta+N+Sg+Ill	+Use/Subboazolohkuraportii	+u.se/subː.pŏɑ.dso#lˌoh.ku#rˌɑ.por.htij
boazolohkoraporta+N+Pl+Gen+PxPl2	+Use/Subboazolohkuraporttaideattet	+u.se/subː.pŏɑ.dso#lˌoh.ku#rˌɑ.porht.tˌɑjː.tĕæt.teh
boazolohkoraporta+N+Pl+Nom	+Use/Subboazolohkuraporttat	+u.se/subː.pŏɑ.dso#lˌoh.ku#rˌɑ.porht.tɑh
boazolohkoraporta+N+Sg+Gen+PxDu3	+Use/Subboazolohkuraporttaska	+u.se/subː.pŏɑ.dso#lˌoh.ku#rˌɑ.porht.tˌɑsː.kɑ
boazolohkoraporta+N+Sg+Gen+PxPl2	+Use/Subboazolohkuraporttadet	+u.se/subː.pŏɑ.dso#lˌoh.ku#rˌɑ.porht.tˌɑ.deh
boazolohkoraporta+N+Sg+Gen+PxSg3	+Use/Subboazolohkuraporttas	+u.se/subː.pŏɑ.dso#lˌoh.ku#rˌɑ.porht.tɑs
boazolohkoraporta+N+Sg+Com+PxDu2	+Use/Subboazolohkuraporttaineatte	+u.se/subː.pŏɑ.dso#lˌoh.ku#rˌɑ.porht.tˌɑj.nĕæt.te
boazolohkoraporta+N+Sg+Com	+Use/Subboazolohkuraporttain	+u.se/subː.pŏɑ.dso#lˌoh.ku#rˌɑ.porht.tɑjn
boazolohkoraporta+N+Sg+Loc+PxSg1	+Use/Subboazolohkuraporttastan	+u.se/subː.pŏɑ.dso#lˌoh.ku#rˌɑ.porht.tˌɑsː.tɑn
boazolohkoraporta+N+Der/Dimin+N+Sg+Nom	+Use/Subboazolohkuraporttaš	+u.se/subː.pŏɑ.dso#lˌoh.ku#rˌɑ.porht.tɑ»ʃ
boazolohkoraporta+N+Der/heapmi+A+Comp+Sg+Acc	+Use/Subboazolohkuraporttahabbo	+u.se/subː.pŏɑ.dso#lˌoh.ku#rˌɑ.porht.tɑ»hˌɑbː.po
boazolohkoraporta+N+Der/huhtti+V+TV+Imprt+Pl2	+Use/Subboazolohkuraporttahuhttet	+u.se/subː.pŏɑ.dso#lˌoh.ku#rˌɑ.porht.tɑ»hˌuhː.teh
boazolohkoraporta+N+Der/huvva+V+IV+Imprt+Du2	+Use/Subboazolohkuraporttahuvvi	+u.se/subː.pŏɑ.dso#lˌoh.ku#rˌɑ.porht.tɑ»hˌuvː.vi
bagadusvirgi+N+Sg+Acc+PxSg1	bagadusvirgán	pˈɑ.gɑː.ðus#vˌirə.kɑːn
bakteara+N+Sg+Ill	bakterii	pˈɑkː.hte.rij
ballat+V+TV+Imprt+ConNeg	bala	pˈɑ.lɑː
banus+N+Der/viđá+Adv	banusviđá	pˈɑ.nus»vˌi.ðɑː
bassit+V+TV+Cond+Prs+Pl2	basášeiddet	pˈɑ.sɑː.ʃˌejt.teh
beste+N+Der/viđá+Adv	besteviđá	pˈesː.te»vˌi.ðɑː
berosmeahttun+A+Der/at+Adv	birosmeahttumit	pˈiː.ros.mˌĕæhː.tu.mih
berosmeahttun+A+Sg+Ill	birosmeahttumii	pˈiː.ros.mˌĕæhː.tu.mij
berosmeahttun+A+Superl+Sg+Acc	birosmeahttusamosa	pˈiː.ros.mˌĕæhː.tu.sˌɑ.mo.sɑ
berošmeahttun+A+Der/vuohta+N+Sg+Ill	birošmeahttunvuhtii	pˈiː.roʃ.mˌĕæhː.tun»vˌuh.tij
berošmeahttun+A+Comp+Sg+Nom	birošmeahttuset	pˈiː.roʃ.mˌĕæhː.tu.seh
beroštahtti+A+Sg+Com	biroštahttiin	pˈiː.roʃ.tˌɑhː.tijn
bijekšuvdna+N+Sg+Ill	bijekšuvdnii	pˈiː.jekː.ʃˌuβː.tnij
binjas+A+Sg+Com	bitnjasiin	pˈit.ɲɑ.sijn
bire+N+Sg+Ill	birii	pˈiː.rij
bivdet+V+TV+Ind+Prt+Du3	bivdiiga	pˈiβː.tij.gɑ
blasoneret+V+TV+Ind+Prs+Du1	blasonerejetne	blˈɑ.so.nˌe.re.jˌet.ne
bliánttabužan+N+Der/viđá+Adv	bliánttabužanviđá	blˈi.ɑːnht.tɑ#pˌu.dʃɑn»vˌi.ðɑː
blubb+Interj	blubb	blˈubː
bláđet+V+IV+Ind+Prt+Du3	bláđiiga	blˈɑː.ðij.gɑ
bonte+N+Pl+Nom	bonttet	pˈonn̥.teh
bozza+N+Sg+Ill	bozzii	pˈodː.tsij
bođaš+N+Ess	bođašin	pˈo.ðɑː.ʃin
breive+N+Der/viđá+Adv	breiveviđá	brˈejː.ve»vˌi.ðɑː
brugga+N+Der/viđá+Adv	bruggaviđá	brˈugː.kɑː»vˌi.ðɑː
bryggeriija+N+Sg+Ill	bryggeriijii	brˈygː.ke.rˌij.jij
bráhkka+N+Der/viđá+Adv	bráhkkaviđá	brˈɑhː.kɑ»vˌi.ðɑː
buhčat+V+TV+Ger	bužadin	pˈu.dʃɑː.ðin
busildit+V+IV+VGen	busil	pˈu.siːl
buđaldit+V+IV+Imprt+Sg2	buđal	pˈu.ðɑːl
buđđá+G3+N+Der/laš+A+Attr	buđđálaš	pˈuðː.ðɑː»lɑʃ
byrohoavda+N+Sg+Ill	byrohovdii	pˈy.ro#hˌoβː.tij
byrokratiija+N+Ess+PxDu3	byrokratiijaneaskka	pˈy.ro.krˌɑ.tij.jˌɑ.neæs.kɑ
byrokráhta+N+Pl+Nom	byrokráhtat	pˈy.ro.krˌɑːh.tɑh
byrokráhtalaš+A+AttrCmp+Der/kultuvrrat+A+Attr	byrokráhtalaškultuvrrat	pˈy.ro.krˌɑːh.tɑ.lɑʃ»kˌul.htuvr.rɑh
byrokráhtaheapme+A+Der/huhtti+V+TV+VAbess	byrokráhtahuhtihaga	pˈy.rok.rˌɑːh.tɑh»ˌuh.ti.hˌɑ.gɑ
byrokráhtaheapme+A+Der/huhtti+V+TV+Inf	byrokráhtahuhttit	pˈy.rok.rˌɑːh.tɑh»ˌuhː.tih
báfaidit+V+IV+PrsPrc	báfajeaddji	pˈɑː.fɑ.jˌĕæɟː.ci
báttas+N+Sg+Acc	báddasa	pˈɑːdː.tɑ.sɑ
báŋádit+V+IV+Der/eamoš+N+Sg+Ill+PxSg3	báŋádepmošasas	pˈɑː.ŋɑːd»ˌep.mo.ʃˌɑ.sɑs
börsafitnodat+N+Der/Dimin+N+Ess	börsafitnodagažin	pˈørə.sɑ#fˌit.no.dˌɑ.gɑ»dʃin
börsagávpi+N+Sg+Nom	börsagávpi	pˈørə.sɑ#kˌɑːβː.ɸpi
börsagávpi+N+Sg+Acc+PxSg2	börsagávppát	pˈørə.sɑ#kˌɑːβɸ.pɑːh
börsakursa+N+Der/viđá+Adv	börsakursaviđá	pˈørə.sɑ#khˌurə.sɑ»vˌi.ðɑː
börsakursa+N+Sg+Ill	börsakursii	pˈørə.sɑ#khˌurə.sij
caggi+N+Sg+Gen+PxSg2	cakkát	tsˈɑkː.kɑːh
cahkat+V+IV+Ind+Prs+Pl3	cahket	tsˈɑh.keh
cakŋa+N+Ess+PxDu1	cakŋaneame	tsˈɑkː.ŋɑː.nˌĕæ.me
cakŋa+N+Ess+PxDu2	cakŋaneatte	tsˈɑkː.ŋɑː.nˌĕæt.te
ceakkuhit+V+TV+Der/alla+V+Der/PassS+V+IV+Ind+Prt+Pl1	cekkohalluimet	tsˈek.koh»ˌɑl.lu»ˌi.meh
cecce+N+Der/Dimin+N+Ess	ceccežin	tsˈet.tse»dʃin
ceggodat+N+Sg+Ill	ceggodahkii	tsˈegː.ko.ðˌɑh.kij
celkojupmi+N+Sg+Ill+PxSg1	celkojupmásan	tsˈelə.hko.jˌupː.mɑː.sɑn
certifieret+V+TV+Ind+Prt+Pl2	certifieriidet	tsˈerə.hti.fˌi.e.rˌij.deh
changeret+V+TV+Ind+Prt+Pl1	changeriimet	tshˈɑŋŋ.ke.rˌij.meh
chatságastallan+N+Sg+Nom	chatságastallan	tshˈɑh#sˌɑː.gɑs.tˌɑl.lɑn
chevroteret+V+IV+Ind+Prt+Du1	chevroteriime	tshˈeβː.ro.tˌe.rij.me
chiffertelegrámma+N+Der/viđá+Adv	chiffertelegrámmaviđá	tshˈif.fer#thˌe.le.grˌɑːm.mɑ»vˌi.ðɑː
chilibihppor+N+Der/viđá+Adv	chilibihpporviđá	tshˈi.li#pˌihː.por»vˌi.ðɑː
ci+Interj	ci	tsˈi
cibmut+V+TV+VAbess	cipmohaga	tsˈip.mo.hˌɑ.gɑ
cieggat+V+IV+Imprt+Pl2	ciegget	tsˈĭegː.keh
cillat+V+IV+VGen	cila	tsˈi.lɑː
cipmastit+V+TV+Inf	cipmastit	tsˈipː.mɑːs.tih
ciskat+V+TV+Cond+Prs+ConNeg	ciskkaše	tsˈis.kɑː.ʃe
coahki+N+Pl+Loc+PxPl3	cogiineaset	tsˈoː.gij.nˌĕæ.seh
codisilla+N+Sg+Ill	codisillii	tsˈo.di.sˌil.lij
coica+N+Pl+Acc	coiccaid	tsˈojçç.tsɑːjh
cokkadit+V+TV+VGen	cokkat	tsˈokː.kɑːh
cosinusláhka+N+Pl+Com+PxDu3	cosinuslágaideaskkaguin	tsˈo.si.nus#lˌɑː.gɑj.dˌeæs.kɑ.gujn
crossa+N+Der/heapmi+A+Comp+Attr	crosahat	tsrˈo.sɑː»hɑh
crossa+N+Der/heapmi+A+Sg+Loc	crosaheames	tsrˈo.sɑː»hˌĕæ.mes
crossa+N+Sg+Loc+PxPl2	crossasteattet	tsrˈosː.sɑːs.tˌĕæt.teh
crossa+N+Sg+Ill	crossii	tsrˈos.sij
crossfalástallan+N+Der/viđá+Adv	crossfalástallanviđá	tsrˈosː#fˌɑ.lɑːs.tˌɑl.lɑn»vˌi.ðɑː
crossgilvu+N+Sg+Gen	crossgilvvu	tsrˈosː#kˌilvː.vu
crosssihkkel+N+Ess	crosssihkkelin	tsrˈosː#sˌihː.ke.lin
crosssyhkkel+N+Der/viđá+Adv	crosssyhkkelviđá	tsrˈosː#sˌyhː.kel»vˌi.ðɑː
cuhpat+V+TV+Imprt+Pl2	cuhpet	tsˈuːh.peh
cukcat+V+IV+Der/d+V+Imprt+Sg3	cuvccadus	tsˈuβɸː.tsɑː»dus
cuoigut+V+TV+Der/l+V+Der/adda+V+Sup	cuigolattažit	tsˈujː.ko»lˌɑt.tɑ.dʃih
cyberfalleheapmi+N+Sg+Nom+PxPl3	cyberfalleheapmiset	tsˈy.ber#fˌɑl.le.hˌeæp.mi.seh
cys+Interj	cys	tsˈys
cyš+Interj	cyš	tsˈyʃ
cábastit+V+TV+Ind+Prs+Sg2	cábastat	tsˈɑː.bɑs.tɑh
cára+N+Sg+Ill	cárii	tsˈɑː.rij
cæsarisma+N+Sg+Ill	cæsarismii	tsˈæ.sɑ.rˌisː.mij
cæsarisma+N+Sg+Com+PxPl2	cæsarismmaineattet	tsˈæ.sɑ.rˌis.mɑj.nˌĕæt.teh
cæsarisma+N+Sg+Loc+PxPl3	cæsarismmasteaset	tsˈæ.sɑ.rˌis.mɑs.tˌĕæ.seh
čiekŋun+N+Sg+Acc+PxDu2	čiekŋumeatte	tšiek.ŋu.mĕæt.te
čiekŋun+N+Sg+Nom	čiekŋun	tšĭĕkː.ŋun
damasceret+V+TV+Imprt+Sg3	damascerejus	tˈɑ.mɑːs.tsˌe.re.jus
dat+Pron+Dem+Ess	danin	tˈɑ.niːn
danhámat+A+Pl+Nom	donhámagat	tˈon#hˌɑː.mɑ.gɑh
danhámat+A+Sg+Acc	donhámaga	tˈon#hˌɑː.mɑ.gɑ
danhámat+A+Attr	donhámat	tˈon#hˌɑː.mɑh
danhámat+A+Sg+Nom	donhámat	tˈon#hˌɑː.mɑh
danhámat+A+Der/vuohta+N+Sg+Ill	donhámatvuhtii	tˈon#hˌɑː.mɑh»vˌuh.tij
danhámat+A+Der/vuohta+N+Ess+PxPl2	donhámatvuohtaneattet	tˈon#hˌɑː.mɑh»vˌuoh.tɑ.nˌĕæt.teh
danhámat+A+Der/vuohta+N+Der/viđá+Adv	donhámatvuohtaviđá	tˈon#hˌɑː.mɑh»vˌuoh.tɑ»vˌi.ðɑː
deđot+A+Attr+Der/vuohta+N+Sg+Ill	diđotvuhtii	tˈiː.ðoh»vˌuh.tij
deđot+A+Der/vuohta+N+Sg+Acc+PxSg1	diđotvuohtan	tˈiː.ðoh»vˌuoh.tɑn
diminutiiva+N+Sg+Acc+PxSg1	deminutiivan	tˈe.mi.nˌu.tij.vɑn
diminutiiva+N+Sg+Acc+PxPl2	deminutiivvadet	tˈe.mi.nˌu.tijv.vˌɑ.deh
diminutiiva+N+Sg+Acc	deminutiivva	tˈe.mi.nˌu.tijv.vɑ
diftongeret+V+TV+Der/PassL+V+IV+Actio+Nom	diftongerejuvvon	tˈif.ton.gˌe.re»jˌuv.von
digrešuvdna+N+Sg+Ill	digrešuvdnii	tˈi.gre.ʃˌuβː.tnij
divttis+A+Superl+Der/at+Adv	diktásamosit	tˈikː.htɑː.sˌɑ.mo.sih
diáranummar+N+Der/viđá+Adv	diáranummarviđá	tˈi.ɑː.rɑ#nˌum.mɑr»vˌi.ðɑː
don+Pron+Pers+Pl2+Acc	din	tˈin
don+Pron+Pers+Pl2+Com	dinguin	tˈiŋŋ.kujn
don+Pron+Pers+Pl2+Ess	dinin	tˈi.niːn
don+Pron+Pers+Sg2+Com	duinna	tˈujnː.nɑː
dobbut+V+IV+Der/stuvva+V+Pot+Prs+Sg1	doppostuvažan	tˈop.po»stˌu.vɑ.dʃɑn
doggi+N+Der/viđá+Adv	doggeviđá	tˈogː.ke»vˌi.ðɑː
dogmatisma+N+Sg+Ill	dogmatismii	tˈog.mɑː.tˌisː.mij
doggi+N+Sg+Loc+PxDu1	dokkisteame	tˈokː.kis.tˌĕæ.me
doppis+N+Sg+Ill+PxPl3	dobbásasaset	tˈobː.pɑː.sˌɑ.sɑ.seh
dreassa+N+Sg+Ill	dressii	drˈes.sij
dreaggá+N+Sg+Ill+PxPl2	dreaggáseattet	drˈeægː.kɑː.sˌĕæt.teh
dreaggá+N+Sg+Gen+PxSg3	dreakkás	drˈeæk.kɑːs
drošša+G3+N+Sg+Ill	droššii	drˈoʃ.ʃij
drumbugoazan+N+Der/viđá+Adv	drumbugoazanviđá	drˈumː.pu#kˌoɑ.dsɑn»vˌi.ðɑː
dräneret+V+TV+Der/PassL+V+IV+Actio+Nom	dränerejuvvon	drˈæ.ne.re»jˌuv.von
dudássásaš+A+Der/vuohta+N+Sg+Loc+PxDu1	dudássásašvuođasteame	tˈu#tˌɑːs.sɑː.sɑʃ»vˌuo.ðɑs.tˌĕæ.me
duealla+N+Sg+Ill	duellii	tˈu.el.lij
dumsui+A+Pl+Nom	dumsot	tˈumː.soh
duosánaga+Adv	duosánaga	tˈuo.sɑː.nˌɑ.gɑ
durra+N+Der/Dimin+N+Pl+Nom	duražat	tˈu.rɑː»dʃɑh
dutkat+V+TV+Der/PassS+V+IV+Ind+Prt+Du3	dutkuiga	tˈutː.hku»ˌi.gɑ
dynámo+N+Sg+Ill+PxDu3	dynámosaskka	tˈy.nɑː.mˌo.sɑs.kɑ
dynámo+N+Der/heapmi+A+Superl+Sg+Loc	dynámohepmosis	tˈy.nɑː.mo»hˌep.mo.sis
dysleksiija+N+Sg+Loc+PxDu1	dysleksiijasteame	tˈys.lekː.sˌij.jɑs.tˌĕæ.me
dystrofiija+N+Sg+Ill	dystrofiijii	tˈyst.ro.fˌij.jij
dáhkat+V+IV+Imprt+Du2	dáhkki	tˈɑhː.kiː
dáččalágan+A+Sg+Acc	dáččalágána	tˈɑːt.tʃɑ#lˌɑː.gɑː.nɑ
eana+N+Ess+PxDu1	eananeame	ˈeæ.nɑ.nˌĕæ.me
eana+N+Ess+PxPl2	eananeattet	ˈeæ.nɑ.nˌĕæt.teh
eana+N+Ess+PxPl3	eananeaset	ˈeæ.nɑ.nˌĕæ.seh
eana+N+Sg+Nom	eana	ˈeæ.nɑ
eana+N+Ess	eanamin	ˈeæ.nɑ.min
eana+N+Der/viđá+Adv	eanamviđá	ˈeæ.nɑm»vˌi.ðɑː
eana+N+Sg+Nom	eanan	ˈeæ.nɑn
eana+N+Der/laš+A+Comp+Attr	eananlut	ˈeæ.nɑn»luh
eana+N+Der/huhtti+V+TV+Der/PassS+V+IV+Ind+Prt+Du2	eanahuhttuide	ˈeæ.nɑ»hˌuhː.tu»ˌi.de
eana+N+Der/huhtti+V+TV+Imprt+Du1	eanahuhttu	ˈeæ.nɑ»hˌuhː.tu
eana+N+Der/huhtti+V+TV+Ind+Prt+ConNeg	eanahuhttán	ˈeæ.nɑ»hˌuhː.tɑːn
eana+N+Ess	eatnamin	ˈeæt.nɑ.min
eana+N+Pl+Nom	eatnamat	ˈeæt.nɑ.mɑh
eana+N+Pl+Acc+PxPl2	eatnamiiddádet	ˈeæt.nɑ.mˌijtː.tɑː.deh
eana+N+Sg+Nom	eatnan	ˈeæt.nɑn
eana+N+Der/laš+A+Comp+Attr	eatnanlat	ˈeæt.nɑn»lɑh
eana+N+Der/laš+A+Sg+Nom	eatnanlaš	ˈeæt.nɑn»lɑʃ
eana+N+Ess+PxPl1	eananeamet	ˈeæ.nɑ.nˌĕæ.meh
eana+N+Sg+Nom	eana	ˈeæ.nɑ
eana+N+Ess	eanamin	ˈeæ.nɑ.min
eana+N+Der/viđá+Adv	eanamviđá	ˈeæ.nɑm»vˌi.ðɑː
eana+N+Sg+Nom	eanan	ˈeæ.nɑn
eana+N+Der/geahtes+A+Attr	eanangeahtes	ˈeæ.nɑn»gˌĕæh.tes
eana+N+Ess	eatnamin	ˈeæt.nɑ.min
eana+N+Pl+Nom	eatnamat	ˈeæt.nɑ.mɑh
eana+N+Sg+Gen+PxSg2	eatnamat	ˈeæt.nɑ.mɑh
eana+N+Sg+Ill+PxPl1	eatnamasamet	ˈeæt.nɑ.mˌɑ.sɑ.meh
eana+N+Sg+Loc+PxPl3	eatnamisttiset	ˈeæt.nɑ.mˌis.ti.seh
eana+N+Der/Dimin+N+Sg+Com+PxPl1	eatnamaččaineamet	ˈeæt.nɑm»ˌɑt.tʃɑj.nˌĕæ.meh
eana+N+Der/Dimin+N+Sg+Nom	eatnamaš	ˈeæt.nɑm»ɑʃ
eana+N+Sg+Nom	eatnan	ˈeæt.nɑn
eana+N+Der/viđá+Adv	eatnanviđá	ˈeæt.nɑn»vˌi.ðɑː
eahki+N+Pl+Com	egiiguin	ˈeː.gij.gujn
eanandoallohoavda+N+Sg+Ill	eatnandoallohovdii	ˈeæt.nɑn#tˌŏɑl.lo#hˌoβː.tij
ecstasy+N+Pl+Nom	ecstasyt	ˈets.stɑ.syh
ecstasy+N+Sg+Nom+PxDu3	ecstasyskka	ˈets.stɑ.sˌys.kɑ
edet+N+Ess	edegin	ˈe.de.gin
ednožat+N+Pl+Ill	ednožiidda	ˈed.no.dʃˌijt.tɑ
effektueret+V+TV+Ind+Prt+Pl2	effektueriidet	ˈef.fekː.htˌu.e.rˌij.deh
effisieansa+N+Der/huvva+V+IV+Cond+Prs+Sg3	effisieanssahuvašii	ˈef.fi.sˌi.eæns.sɑ»hˌu.vɑ.ʃij
egaliseret+V+TV+Der/PassL+V+IV+Actio+Com	egaliserejuvvomiin	ˈe.gɑː.lˌi.se.re»jˌuv.vo.mijn
egyptalaš+A+Sg+Ill	egyptalažžii	ˈeː.gyp.tˌɑ.lɑdː.tʃij
ehpel+N+Sg+Com+PxSg3	ehpeliinnis	ˈeh.pe.lˌijnː.nis
eiddo+Pcle	eiddo	ˈejt.to
eitto+Pcle	eitto	ˈejç.to
ejakuleret+V+IV+VGen	ejakulere	ˈe.jɑː.kˌu.le.re
ejakuleret+V+IV+Der/PassL+V+IV+Ger	ejakulerejuvvodiin	ˈe.jɑː.kˌu.le.re»j»ˌuv.vo.dijn
ejakuleret+V+IV+Ind+Prt+Du1	ejakuleriime	ˈe.jɑː.kˌu.le.rˌij.me
ekovuogádat+N+Pl+Nom	ekovuogádagat	ˈe.ko#vˌuo.gɑː.dˌɑ.gɑh
eluvdna+N+Der/viđá+Adv	eluvdnaviđá	ˈel#ˌuβː.tnɑ»vˌi.ðɑː
elčalbmi+N+Sg+Gen+Allegro	elčalmme	ˈel#tʃˌɑlm.me
entusiásta+N+Sg+Ill	entusiástii	ˈenː.n̥tu.sˌi.ɑːs.tij
epmolaš+A+Der/at+Adv	epmolaččat	ˈep.mo.lˌɑt.tʃɑh
erenoamáš+A+Der/vuohta+N+Ess+PxSg3	earenoamášvuohtanis	ˈĕæ.re.nˌoɑ.mɑːʃ»vˌuoh.tɑ.nis
erenoamášoahpahus+N+Sg+Ill	earenoamášoahpahussii	ˈĕæ.re.nˌoɑ.mɑːʃ#ˌoɑh.pɑ.hˌus.sij
erenoamášlávdegoddi+N+Pl+Com+PxSg3	earenomášlávdegottiidisguin	ˈĕæ.re.nˌo.mɑːʃ#lˌɑːβː.te#kˌot.tij.dˌis.gujn
erdui+A+Sg+Loc	erdos	ˈerə.tos
eseváldi+N+Sg+Nom	eseváldi	ˈe.se#vˌɑːlː.ti
etiopialaš+N+Pl+Nom	etiopialaččat	ˈe.ti.ˌo.pi.ˌɑ.lɑt.tʃɑh
etiopialaš+N+Sg+Nom	etiopialaš	ˈe.ti.ˌo.pi.ˌɑ.lɑʃ
ettodit+V+IV+Der/meahttun+A+Superl+Attr	ettotmeahttusamos	ˈet.toh»mˌĕæhː.tu.sˌɑ.mos
etylena+N+Der/viđá+Adv	etylenaviđá	ˈe.ty.lˌe.nɑ»vˌi.ðɑː
eufemisma+N+Sg+Com+PxPl2	eufemismmaineattet	ˈeu.fe.mˌis.mɑj.nˌĕæt.teh
eufemisttalaš+A+Sg+Nom	eufemisttalaš	ˈeu.fe.mˌis.tɑ.lɑʃ
europeiseret+V+TV+Der/PassL+V+IV+Actio+Loc	europeiserejuvvomis	ˈeu.ro.pˌe.i.sˌe.re»jˌuv.vo.mis
evalueren+N+Sg+Gen	evalueren	ˈe.vɑː.lˌu.e.ren
extraheret+V+TV+Ger	extraherediin	ˈeks.trɑ.hˌe.re.dijn
eŋgelas+A+AttrCmp+Der/bealjat+A+Sg+Nom	eŋgalasbealjat	ˈeŋŋ.kɑː.lɑs»bˌĕælə.jɑh
eŋgelas+A+AttrCmp+Der/fárddat+A+Sg+Nom	eŋgalasfárddat	ˈeŋŋ.kɑː.lɑs»fˌɑːrt.tɑh
eretorru+A+Attr	iretorru	ˈiː.reh#ˌor.ru
eretorru+A+Attr+Der/vuohta+N+Sg+Ill	iretorruvuhtii	ˈiː.reh#ˌor.ru»vˌuh.tij
eretorru+A+Attr+Der/vuohta+N+Ess+PxDu1	iretorruvuohtaneame	ˈiː.reh#ˌor.ru»vˌuoh.tɑ.nˌĕæ.me
eretorru+A+AttrCmp+Der/agat+A+Attr	iretorruagat	ˈiː.reh#ˌor.ru»ˌɑ.gɑh
eretorru+A+AttrCmp+Der/gieškkat+A+Der/vuohta+N+Sg+Com+PxSg2	iretorrugieškkatvuođainat	ˈiː.reh#ˌor.ru»gˌieʃ.kɑh»vˌuo.ðɑj.nɑh
eretorru+A+AttrCmp+Der/mohkat+A+Sg+Nom	iretorrumohkat	ˈiː.reh#ˌor.ru»mˌoh.kɑh
eretorru+A+AttrCmp+Der/sorttat+A+Sg+Acc	iretorrusorttaga	ˈiː.reh#ˌor.ru»sˌorht.tɑ.gɑ
eretorru+A+AttrCmp+Der/vuđot+A+Sg+Com	iretorruvuđogiin	ˈiː.reh#ˌor.ru»vˌu.ðo.gijn
eretorru+A+Ess	iretorrun	ˈiː.reh#ˌor.run
eretorru+A+Pl+Acc	iretorruid	ˈiː.reh#ˌor.rujh
eretorru+A+Pl+Ill	iretorruide	ˈiː.reh#ˌor.ruj.de
eretorru+A+Pl+Loc	iretorruin	ˈiː.reh#ˌor.rujn
eretorru+A+Pl+Nom	iretorrut	ˈiː.reh#ˌor.ruh
eretorru+A+Sg+Acc	iretorru	ˈiː.reh#ˌor.ru
eretorru+A+Sg+Gen	iretorru	ˈiː.reh#ˌor.ru
eretorru+A+Sg+Nom	iretorru	ˈiː.reh#ˌor.ru
eretorru+A+Sg+Com	iretorruin	ˈiː.reh#ˌor.rujn
eretorru+A+Sg+Ill	iretorrui	ˈiː.reh#ˌor.ruj
eretorru+A+Sg+Loc	iretorrus	ˈiː.reh#ˌor.rus
eretorru+A+Der/viđá+Adv	iretorruviđá	ˈiː.reh#ˌor.ru»vˌi.ðɑː
eretorru+A+Der/vuohta+N+Sg+Ill	iretorruvuhtii	ˈiː.reh#ˌor.ru»vˌuh.tij
eretorru+A+Der/vuohta+N+Sg+Gen+PxDu1	iretorruvuohtame	ˈiː.reh#ˌor.ru»vˌuoh.tɑ.me
eretorru+A+Der/vuohta+N+Der/viđá+Adv	iretorruvuohtaviđá	ˈiː.reh#ˌor.ru»vˌuoh.tɑ»vˌi.ðɑː
eretorru+A+Der/vuohta+N+Sg+Acc+PxSg3	iretorruvuođas	ˈiː.reh#ˌor.ru»vˌuo.ðɑs
fabuleret+V+IV+Imprt+Sg2	fabulere	fˈɑ.bu.lˌe.re
fakturá+N+Ess+PxSg1	fakturánan	fˈɑkː.htu.rˌɑː.nɑn
fatnat+V+IV+Imprt+ConNeg	fana	fˈɑ.nɑː
fatnat+V+IV+Imprt+Pl2	fatnet	fˈɑt.neh
feastit+V+TV+Der/NomAg+N+Pl+Acc+PxSg3	festiidis	fˈesː.tij.dis
fetisjisma+N+Sg+Loc	fetisjismmas	fˈeː.tis.jˌis.mɑs
fiila+N+Sg+Ill	fiilii	fˈijː.lij
fijuvla+N+Der/huvva+V+IV+VAbess	fijuvllahuvahaga	fˈiː.juvl.lɑ»hˌu.vɑ.hˌɑ.gɑ
fisket+V+TV+Der/PassL+V+IV+Imprt+Sg3	fiskejuvvojus	fˈisː.ke»j»ˌuv.vo.jus
fitnat+V+IV+VAbess+A+Attr	finakeahtes	fˈi.nɑː.kˌĕæh.tes
flirtet+V+TV+Actio+Nom	flirten	flˈirə.hten
floreret+V+TV+VAbess	florerehaga	flˈo.re.rˌe.hɑ.gɑ
fløita+N+Pl+Ill+PxPl1	fløittaidasamet	flˈøjç.tɑj.dˌɑ.sɑ.meh
foahpir+N+Pl+Nom	foahpirat	fˈoɑh.pi.rɑh
fokus+N+Der/viđá+Adv	fokusviđá	fˈoː.kus»vˌi.ðɑː
fonotáksa+N+Pl+Loc+PxDu2	fonotávssaineatte	fˈo.no.tˌɑːβs.sɑj.nˌĕæt.te
fosforesceret+V+TV+VAbess	fosforescerehaga	fˈos.fo.rˌes.tse.rˌe.hɑ.gɑ
freestyla+A+Attr	freestyla	frˈe.e.stˌy.lɑ
fregáhtta+N+Pl+Nom	fregáhtat	frˈeː.gɑːh.tɑh
friijet+V+TV+Ind+Prt+Du1	friijiime	frˈij.jij.me
fronderet+V+TV+Pot+Prs+ConNeg	frondereš	frˈonː.te.reʃ
frotteret+V+TV+PrfPrc	frotteren	frˈot.te.ren
frustreret+V+TV+Ind+Prt+Du1	frustreriime	frˈust.re.rˌij.me
fundamenteret+V+TV+PrfPrc	fundamenteren	fˈunː.tɑː.mˌenː.n̥te.ren
fuotni+A+Der/at+Adv	funet	fˈuː.neh
futterála+N+Pl+Com+PxSg2	futterálaidatguin	fˈut.te.rˌɑː.lɑj.dˌɑt.gujn
futterála+N+Sg+Loc	futterálas	fˈut.te.rˌɑː.lɑs
fušoneret+V+TV+Der/PassL+V+IV+Der/upmi+N+Sg+Gen+PxDu2	fušonerejumáde	fˈu.ʃo.nˌe.re»j»ˌu.mɑː.de
fylka+N+Der/viđá+Adv	fylkaviđá	fˈylə.hkɑ»vˌi.ðɑː
fysalaš+A+Comp+Der/Dimin+N+Sg+Loc	fysalabbožis	fˈy.sɑ.lˌɑbː.po»dʃis
fysalaš+A+Pl+Acc	fysalaččaid	fˈy.sɑ.lˌɑt.tʃɑjh
fysalaš+A+Ess	fysalažžan	fˈy.sɑ.lˌɑdː.tʃɑn
fysalaš+A+Attr	fysalaš	fˈy.sɑ.lɑʃ
fáhcca+N+Der/laš+A+Sg+Nom	fáhcalaš	fˈɑːh.tsɑ»lɑʃ
fáhcca+N+Sg+Ill	fáhccii	fˈɑhː.tsij
fáiput+V+TV+Der/PassL+V+IV+Der/supmi+N+Sg+Ill	fáiposupmái	fˈɑːjː.çpo»sˌupː.mɑːj
fákta+N+Sg+Loc+PxSg3	fávttastis	fˈɑːβɸ.tɑs.tis
fákta+N+Der/Dimin+N+Ess	fávttažin	fˈɑːβɸ.tɑ»dʃin
fápmuibidjanáigemearri+N+Sg+Com+PxSg2	fápmuibidjanáigemeriinat	fˈɑːp.muj#pˌic.cɑn#ˌɑːjː.ke#mˌe.rij.nɑh
fátmi+N+Ess+PxPl2	fátmineattet	fˈɑːtː.mi.nˌĕæt.teh
fáđašit+V+TV+Sup	fáđašeažžat	fˈɑː.ðɑ.ʃˌeædː.tʃɑh
føydalisma+N+Sg+Ill+PxDu1	føydalismaseame	fˈøy.dɑ.lˌisː.mɑ.sˌĕæ.me
falástallanruhta+N+Pl+Nom	valástallanruđat	vˈɑ.lɑːs.tˌɑl.lɑn#rˌu.ðɑh
falástallanruhta+N+Sg+Acc+PxDu2	valástallanruđade	vˈɑ.lɑːs.tˌɑl.lɑn#rˌu.ðɑ.de
falástallanruhta+N+Sg+Com+PxSg2	valástallanruđainat	vˈɑ.lɑːs.tˌɑl.lɑn#rˌu.ðɑj.nɑh
falástallanruhta+N+Der/heapmi+A+Sg+Com	valástallanruđahemiin	vˈɑ.lɑːs.tˌɑl.lɑn#rˌu.ðɑ»hˌe.mijn
falástallanruhta+N+Der/huvva+V+IV+Imprt+ConNeg	valástallanruđahuva	vˈɑ.lɑːs.tˌɑl.lɑn#rˌu.ðɑ»hˌu.vɑ
falástallanruhta+N+Der/huvva+V+IV+Imprt+ConNegII	valástallanruđahuvvo	vˈɑ.lɑːs.tˌɑl.lɑn#rˌu.ðɑ»hˌuv.vo
falástallanruhta+N+Sg+Acc+PxSg1	valástallanruhtan	vˈɑ.lɑːs.tˌɑl.lɑn#rˌuh.tɑn
falástallanruhta+N+Sg+Ill+PxPl1	valástallanruhtaseamet	vˈɑ.lɑːs.tˌɑl.lɑn#rˌuh.tɑ.sˌĕæ.meh
falástallanruhta+N+Der/viđá+Adv	valástallanruhtaviđá	vˈɑ.lɑːs.tˌɑl.lɑn#rˌuh.tɑ»vˌi.ðɑː
falástallanruhta+N+Sg+Ill	valástallanruhtii	vˈɑ.lɑːs.tˌɑl.lɑn#rˌuh.tij
faláštallanruhta+N+Pl+Ill+PxDu3	valáštallanruđaidasaska	vˈɑ.lɑːʃ.tˌɑl.lɑn#rˌu.ðɑj.dˌɑ.sɑs.kɑ
faláštallanruhta+N+Pl+Nom	valáštallanruđat	vˈɑ.lɑːʃ.tˌɑl.lɑn#rˌu.ðɑh
faláštallanruhta+N+Sg+Acc+PxPl2	valáštallanruđadet	vˈɑ.lɑːʃ.tˌɑl.lɑn#rˌu.ðɑ.deh
faláštallanruhta+N+Sg+Gen+PxDu2	valáštallanruđade	vˈɑ.lɑːʃ.tˌɑl.lɑn#rˌu.ðɑ.de
faláštallanruhta+N+Sg+Com+PxDu1	valáštallanruđaineame	vˈɑ.lɑːʃ.tˌɑl.lɑn#rˌu.ðɑj.nˌĕæ.me
faláštallanruhta+N+Sg+Com+PxPl2	valáštallanruđaineattet	vˈɑ.lɑːʃ.tˌɑl.lɑn#rˌu.ðɑj.nˌĕæt.teh
faláštallanruhta+N+Sg+Com+PxSg2	valáštallanruđainat	vˈɑ.lɑːʃ.tˌɑl.lɑn#rˌu.ðɑj.nɑh
faláštallanruhta+N+Sg+Loc	valáštallanruđas	vˈɑ.lɑːʃ.tˌɑl.lɑn#rˌu.ðɑs
faláštallanruhta+N+Der/Dimin+N+Sg+Nom	valáštallanruđaš	vˈɑ.lɑːʃ.tˌɑl.lɑn#rˌu.ðɑ»ʃ
faláštallanruhta+N+Der/huvva+V+IV+Imprt+Pl2	valáštallanruđahuvvit	vˈɑ.lɑːʃ.tˌɑl.lɑn#rˌu.ðɑ»hˌuvː.vih
faláštallanruhta+N+Ess+PxDu3	valáštallanruhtaneaskka	vˈɑ.lɑːʃ.tˌɑl.lɑn#rˌuh.tɑ.nˌeæs.kɑ
faláštallanruhta+N+Der/viđá+Adv	valáštallanruhtaviđá	vˈɑ.lɑːʃ.tˌɑl.lɑn#rˌuh.tɑ»vˌi.ðɑː
faláštallanruhta+N+Sg+Ill	valáštallanruhtii	vˈɑ.lɑːʃ.tˌɑl.lɑn#rˌuh.tij
gii+Pron+Interr+Sg+Ill+Foc	geasagii	kˈeæ.sɑ.gij
gii+Pron+Interr+Ess	geanin	kˈeæ.niːn
gii+Pron+Interr+Pl+Acc	geaid	kˈeæjh
gii+Pron+Interr+Pl+Ill	geaidda	kˈeæjt.tɑ
gii+Pron+Interr+Pl+Loc	geain	kˈeæjn
gii+Pron+Interr+Pl+Nom	geat	kˈeæh
gii+Pron+Interr+Sg+Acc	gean	kˈeæn
gii+Pron+Rel+Sg+Ill+Foc	geasagii	kˈeæ.sɑ.gij
gii+Pron+Rel+Sg+Nom	gii	kˈij
gii+Pron+Rel+Ess	geanin	kˈeæ.niːn
gii+Pron+Rel+Pl+Acc	geaid	kˈeæjh
gii+Pron+Rel+Sg+Gen	gean	kˈeæn
goabbat+Pron+Recipr+Du	goabbat	kˈoɑbː.pɑh
goabbat+Pron+Recipr+Pl	guhtet	kˈuːh.teh
guhte+Pron+Rel+Sg+Nom	guhtes	kˈuːh.tes
guhte+Pron+Rel+Sg+Com	guđiin	kˈuː.ðijn
guhtemuš+Pron+Rel	guhtemuš	kˈuh.te.muʃ
guoibmi+Pron+Recipr+Pl+Com+PxDu1	guimmiideameguin	kˈujm.mij.dˌĕæ.me.gujn
guoibmi+Pron+Recipr+Pl+Com+PxDu3	guimmiideaskkaguin	kˈujm.mij.dˌeæs.kɑ.gujn
guoibmi+Pron+Recipr+Pl+Loc+PxPl1	guimmiineamet	kˈujm.mij.nˌĕæ.meh
guoibmi+Pron+Recipr+Sg+Gen+PxDu1	guoibmáme	kˈuoj.pmɑː.me
guoibmi+Pron+Recipr+Sg+Gen+PxPl3	guoimmiset	kˈuojm.mi.seh
galljut+V+IV+VAbess+A+Attr	galjukeahtes	kˈɑʎ.ʎu.kˌĕæh.tes
ganiš+N+Sg+Ill+PxPl3	gatnihasaset	kˈɑt.ni.hˌɑ.sɑ.seh
gazzut+V+TV+VAbess	gaccokeahttájin	kˈɑt.tso.kˌĕæhː.tɑː.jin
gazirdit+V+TV+Der/meahttun+A+Pl+Nom	gazirmeahttumat	kˈɑ.dsir»mˌĕæhː.tu.mɑh
ge+Pcle	ge	kˈe
gekset+V+TV+Ind+Prt+Sg3	geksii	kˈekː.sij
georgisma+N+Sg+Gen	georgismma	kˈe.or.gˌis.mɑ
gessot+V+IV+Ind+Prt+Du3	gessuiga	kˈes.suj.gɑ
gii+Pron+Indef+Pl+Nom	geat	kˈeæh
giige+Pron+Indef+Ess	geaninge	kˈeæ.nin.ge
giige+Pron+Indef+Pl+Nom	geatge	kˈĕæt.ge
gibuheapme+A+Superl+Sg+Nom	gibuheamos	kˈi.bu.hˌĕæ.mos
giehppi+N+Sg+Com	gihpiin	kˈiːh.pijn
gielalaš+A+Sg+Ill	gielalažžii	kˈie.lɑ.lˌɑdː.tʃij
giervat+V+TV+Der/NomAg+N+Sg+Acc+PxPl3	gierviset	kˈĭerə.vi»seh
ginal+N+Sg+Nom	ginal	kˈi.nɑːl
gitnat+V+IV+Der/NomAg+N+Sg+Gen+PxSg1	gidnán	kˈid.nɑː»n
gizzut+V+IV+Pot+Prs+Sg1	giccožan	kˈit.tso.dʃɑn
gizzulit+V+IV+Imprt+Sg3	gizzulehkos	kˈidː.tsu.lˌeh.kos
glukosa+N+Sg+Ill	glukosii	glˈu.ko.sij
gluovva+N+Sg+Ill	gluvvii	glˈuv.vij
glykogena+N+Der/laš+A+Superl+Sg+Ill	glykogenalepmosii	glˈy.ko.gˌe.nɑ»lˌep.mo.sij
glássa+N+Sg+Com+PxPl2	glásaineattet	glˈɑː.sɑj.nˌĕæt.teh
gneaisa+N+Sg+Ill	gneisii	gnˈejː.sij
gnostisisma+N+Pl+Nom	gnostisismmat	gnˈosː.ti.sˌis.mɑh
gnostisisma+N+Der/Dimin+N+Sg+Gen	gnostisismmaža	gnˈosː.ti.sˌis.mɑ»dʃɑ
gnostisisma+N+Der/heapmi+A+Attr	gnostisismmahis	gnˈosː.ti.sˌis.mɑ»his
gohcin+N+Sg+Gen	gohcin	kˈohː.tsiːn
goigárastit+V+IV+Ger	goigárasttediin	kˈojː.kɑː.rˌɑs.te.dijn
gožža+N+Sg+Acc+PxPl3	goččaset	kˈotː.tʃɑː.seh
gregoriánalaš+A+Sg+Ill	gregoriánalažžii	grˈe.go.rˌi.ɑː.nˌɑ.lɑdː.tʃij
gussa+N+Der/huhtti+V+TV+Ind+Prs+ConNeg	gusahuhte	kˈu.sɑː»hˌuh.te
gynekologa+N+Der/viđá+Adv	gynekologaviđá	kˈy.ne.kˌo.lo.gɑ»vˌi.ðɑː
gynekologiija+N+Sg+Ill	gynekologiijii	kˈy.ne.kˌo.lo.gˌij.jij
gággá+N+Sg+Loc	gákkás	kˈɑːk.kɑːs
gákčašuvvat+V+IV+Der/ahtti+V+TV+Pot+Prs+Sg3	gákčašuhteža	kˈɑːkː.htʃɑʃ»ˌuh.te.dʃɑ
gámmir+N+Der/heapmi+A+Ess	gámirheapmin	kˈɑː.mir»hˌeæp.min
gánas+A+Attr	gánas	kˈɑː.nɑs
gánis+N+Sg+Com+PxDu1	gádnáineame	kˈɑːd.nɑːj.nˌĕæ.me
gäbbäläbivdu+N+Sg+Ill	gäbbäläbivdui	kˈæbː.pæ.læ#pˌiβː.tuj
gäbbäläbivdu+N+Sg+Com+PxDu1	gäbbäläbivdduineame	kˈæbː.pæ.læ#pˌiβt.tuj.nˌĕæ.me
gælalaš+A+Der/vuohta+N+Sg+Ill	gælalašvuhtii	kˈæ.lɑ.lɑʃ»vˌuh.tij
gælikgiella+N+Sg+Ill	gælikgillii	kˈæ.lik#kˌil.lij
haddi+N+Ess+PxDu2	haddineatte	hˈɑdː.ti.nˌĕæt.te
haddi+N+Sg+Ill	haddái	hˈɑdː.tɑːj
haga+Adv	haga	hˈɑ.gɑː
hahttá+Pr	hahttá	hˈɑhː.tɑː
haiku+N+Sg+Loc	haikus	hˈɑjː.çkuːs
hapmu+N+Pl+Com	hamuiguin	hˈɑ.muj.gujn
hapmat+V+TV+Der/PassS+V+IV+Ind+Prt+Sg3	habmui	hˈɑb.mu»i
hattáiduvvat+V+IV+Cond+Prs+Du2	hattáiduvašeidde	hˈɑtː.tɑːj.dˌu.vɑ.ʃˌejt.te
hattáiduvvat+V+IV+Der/muš+N+Der/viđá+Adv	hattáiduvvamoššviđá	hˈɑtː.tɑːj.dˌuv.vɑ»moʃː»vˌi.ðɑː
headjut+V+IV+Ind+Prt+ConNeg	hedjon	hˈec.con
heajudit+V+TV+Der/alla+V+Ind+Prs+Sg1	hejodalan	hˈeː.jod»ˌɑ.lɑn
hede+Adv	hede	hˈeː.de
heggosii+Adv	heggosii	hˈegː.ko.sij
herodialaš+N+Pl+Nom	herodialaččat	hˈe.ro.ðˌi.ɑ.lˌɑt.tʃɑh
hevilaš+N+Sg+Ill	hevilažžii	hˈe.vi.lˌɑdː.tʃij
hissa+N+Sg+Com+PxDu3	hisaineaskka	hˈi.sɑːj.nˌeæs.kɑ
hivvehit+V+TV+Der/meahttun+A+Comp+Attr	hivvetmeahttusit	hˈiv.veh»mˌĕæhː.tu.sih
hiđis+A+Pl+Acc	hihtásiid	hˈihː.tɑː.sijh
hm+Interj	hm	hm
hmm+Interj	hmm	hmː
hmmm+Interj	hmmm	hmːm
hobbyboazodoalli+N+Sg+Ill+NomAg+PxDu1	hobbyboazodoalláseame	hˈobː.py#pˌŏɑ.dso#tˌoɑl.lɑː.sˌĕæ.me
house+N+Der/viđá+Adv	houseviđá	hˈou.se»vˌi.ðɑː
hovrriidit+V+IV+Imprt+Sg2	hovrriit	hˈoβr.rijh
hoŋket+V+TV+Ind+Prt+Sg3	hoŋkii	hˈoŋŋ.ŋ̊kij
huollat+V+TV+Der/NomAg+N+Pl+Loc+PxDu2	hulliineatte	hˈul.li»ˌi.nĕæt.te
huonaš+N+Der/Dimin+N+Sg+Nom	huotnahaš	hˈuot.nɑh»ɑʃ
huššat+V+IV+Imprt+ConNeg	huša	hˈu.ʃɑː
huššat+V+IV+Ind+Prs+Sg3	huššá	hˈuʃː.ʃɑː
hybrida+N+Sg+Ill	hybridii	hˈyb.ri.ðij
hydrogena+N+Der/viđá+Adv	hydrogenaviđá	hˈyd.ro.gˌe.nɑ»vˌi.ðɑː
hyhttá+N+Ess+PxPl1	hyhttáneamet	hˈyhː.tɑː.nˌĕæ.meh
hyš+Interj	hyš	hˈyʃ
háhku+N+Sg+Acc+PxSg2	hágot	hˈɑː.goh
háhtta+N+Sg+Loc	háhtas	hˈɑːh.tɑs
hárčasaddat+V+IV+Imprt+ConNeg	hárčasatta	hˈɑːrə.htʃɑ.sˌɑt.tɑ
hástit+V+TV+Imprt+Du2	hásti	hˈɑːsː.tiː
hátnut+V+IV+Der/stuvva+V+Imprt+Pl2	hánostuvvet	hˈɑː.no»stˌuv.veh
hátná+N+Der/viđá+Adv	hátnaviđá	hˈɑːt.nɑ»vˌi.ðɑː
håløygalaš+N+Sg+Acc+PxSg2	håløygalaččat	hˈoːl.øy.gˌɑ.lɑt.tʃɑh
håløygalaš+N+Sg+Nom	håløygalaš	hˈoːl.øy.gˌɑ.lɑʃ
håløygalaš+N+Ess	håløygalažžan	hˈoːl.øy.gˌɑ.lɑdː.tʃɑn
håløygalaš+N+Sg+Nom+PxPl2	håløygalažžadet	hˈoːl.øy.gˌɑ.lɑdː.tʃˌɑ.deh
håløygalaš+N+Sg+Ill	håløygalažžii	hˈoːl.øy.gˌɑ.lɑdː.tʃij
ieš+Pron+Refl+Acc+PxDu1	iehčame	ˈieh.tʃɑ.me
ieš+Pron+Refl+Com+PxPl1	iežaineamet	ˈie.dʃɑj.nˌĕæ.meh
ieš+Pron+Refl+Com+PxPl2	iežaineattet	ˈie.dʃɑj.nˌĕæt.teh
ieš+Pron+Refl+ComPxCPlCom+PxDu1	iežaideameguin	ˈie.dʃɑj.dˌĕæ.me.gujn
ieš+Pron+Refl+Du+Nom	ieža	ˈie.dʃɑ
ieš+Pron+Refl+Ess+PxDu1	iehčaneame	ˈieh.tʃɑ.nˌĕæ.me
ieš+Pron+Refl+Ess+PxPl1	iehčaneamet	ˈieh.tʃɑ.nˌĕæ.meh
ieš+Pron+Refl+Ess+PxSg3	iehčanis	ˈieh.tʃɑ.nis
ieš+Pron+Refl+Ess	iehčanassii	ˈieh.tʃɑ.nˌɑs.sij
ieš+Pron+Refl+Gen+PxDu3+Attr	ald	ˈɑld
ieš+Pron+Refl+Gen+PxDu1	iehčame	ˈieh.tʃɑ.me
ieš+Pron+Refl+Ill+PxPl3	alcciset	ˈɑll̥.tsi.seh
ieš+Pron+Refl+Ill+PxSg2	allasat	ˈɑlː.lɑː.sɑh
ieš+Pron+Refl+Ill+PxSg3	allasis	ˈɑlː.lɑː.sis
ieš+Pron+Refl+Loc+PxDu3	alddeska	ˈɑlt.tes.kɑ
ieš+Pron+Refl+Loc+PxPl3	alddiset	ˈɑlt.ti.seh
ieš+Pron+Refl+Pl+Nom	ieža	ˈie.dʃɑ
ii+V+IV+Neg+Imprt+Du3	alloska	ˈɑl.los.kɑ
ii+V+IV+Neg+Imprt+Pl1	allot	ˈɑl.loh
ii+V+IV+Neg+Imprt+Pl2	allet	ˈɑl.leh
ii+V+IV+Neg+Imprt+Pl3	alloset	ˈɑl.lo.seh
ii+V+IV+Neg+Imprt+Sg2	ale	ˈɑ.le
ii+V+IV+Neg+Imprt+Sg3	allos	ˈɑl.los
ii+V+IV+Neg+Ind+Du2	eahppi	ˈĕæhː.piː
ii+V+IV+Neg+Ind+Pl1	eat	ˈeæh
ii+V+IV+Neg+Ind+Pl2	ehpet	ˈeːh.peh
ii+V+IV+Neg+Ind+Pl3	eai	ˈeæj
ii+V+IV+Neg+Ind+Sg3	ii	ˈij
ii+V+IV+Neg+Sup+Du2	amade	ˈɑ.mɑː.ðe
idja+N+Pl+Ill	ijaide	ˈi.jɑːj.de
idja+N+Der/heapmi+A+Attr+Der/vuohta+N+Ess+PxDu2	ijahisvuohtaneatte	ˈi.jɑː»his»vˌuoh.tɑ.nˌĕæt.te
iddjái+A+Ess	iddjájin	ˈiɟː.cɑː.jin
ignoreret+V+TV+Ind+Prt+Pl1	ignoreriimet	ˈig.no.rˌe.rij.meh
ihtit+V+IV+Ind+Prs+ConNeg	iđe	ˈiː.ðe
ihána+Adv	ihána	ˈi.hɑː.nɑ
iilet+V+TV+Der/PassL+V+IV+Actio+Loc	iilejuvvomis	ˈijː.le»jˌuv.vo.mis
iktit+V+TV+Imprt+ConNeg	ivtte	ˈiβɸ.te
iktit+V+TV+Cond+Prs+Pl3	ivttále	ˈiβɸː.tɑː.le
iktit+V+TV+Sup	ivttážit	ˈiβɸː.tɑː.dʃih
ilgatvuohta+N+Sg+Ill	ilgatvuhtii	ˈilə.kɑt.vˌuh.tij
imaš+A+Ess	imašin	ˈi.mɑː.ʃin
imeš+Adv	imeš	ˈiː.meʃ
implanteret+V+TV+Inf	implanteret	ˈim.plɑnː.n̥tˌe.reh
imaš+A+Comp+Sg+Nom	ipmahut	ˈipː.mɑː.huh
imaš+N+Sg+Acc+PxSg2	ipmašat	ˈipː.mɑː.ʃɑh
ingefeara+N+Sg+Loc+PxSg3	ingefearastis	ˈiŋŋ.ke.fˌeæ.rɑs.tis
inkásso+N+Sg+Loc	inkássos	ˈiŋŋ.ŋ̊kɑːs.sos
inokuleret+V+TV+Der/PassL+V+IV+Ind+Prs+Pl2	inokulerejuvvobehtet	ˈi.no.kˌu.le.re»j»ˌuv.vo.bˌeh.teh
ipmái+A+Pl+Acc	ibmáid	ˈib.mɑːjh
ipmái+A+Pl+Gen	ibmáid	ˈib.mɑːjh
ipmái+A+Pl+Ill	ibmáide	ˈib.mɑːj.de
ipmil+N+Der/Dimin+N+Sg+Ill	ipmilažžii	ˈipː.mil»ˌɑdː.tʃij
iras+A+Sg+Nom	iras	ˈi.rɑːs
irrut+V+IV+Ger	irodiin	ˈi.ro.ðijn
itnat+V+IV+Imprt+Pl1	idnut	ˈid.nuːh
ittis+A+Comp+Pl+Acc	iddáseappuid	ˈidː.tɑː.sˌeæp.pujh
ivttážis+Adv	ivttážis	ˈiβɸː.tɑː.dʃis
iđus+N+Sg+Nom	iđus	ˈi.ðuːs
iđa+N+Pl+Nom	ihtagat	ˈihː.tɑː.gɑh
iš+Interj	iš	ˈiʃ
jieš+Pron+Refl+Du+Nom	jieža	jˈie.dʃɑ
jieš+Pron+Refl+Ess	jiehčanassii	jˈieh.tʃɑ.nˌɑs.sij
jieš+Pron+Refl+Pl+Nom	jieža	jˈie.dʃɑ
jieš+Pron+Refl+Sg+Nom	jieš	jˈieʃ
jieš+Pron+Refl+Acc+PxSg1	jiehčan	jˈieh.tʃɑn
jieš+Pron+Refl+Acc+PxDu2	jiežade	jˈie.dʃɑ.ðe
juobbágoabbá+Pron+Indef+Ess	juobbángoabbán	jˈuobː.pɑːn#kˌoɑbː.pɑːn
juobbágoabbá+Pron+Indef+Pl+Acc	juoppáidgoappáid	jˈŭŏpː.pɑːjh#kˌoɑp.pɑːjh
juobbágoabbá+Pron+Indef+Pl+Com+Attr	juoppáidgoappáid	jˈŭŏpː.pɑːjh#kˌoɑp.pɑːjh
juobbágoabbá+Pron+Indef+Pl+Gen	juoppáidgoappáid	jˈŭŏpː.pɑːjh#kˌoɑp.pɑːjh
juobbágoabbá+Pron+Indef+Pl+Loc	juoppáingoappáin	jˈŭŏpː.pɑːjn#kˌoɑp.pɑːjn
juobbágoabbá+Pron+Indef+Pl+Nom	juobbátgoabbát	jˈuobː.pɑːh#kˌoɑbː.pɑːh
juobbágoabbá+Pron+Indef+Sg+Acc	juoppágoappá	jˈŭŏpː.pɑː#kˌoɑp.pɑː
juobbágoabbá+Pron+Indef+Sg+Com	juoppáingoappáin	jˈŭŏpː.pɑːjn#kˌoɑp.pɑːjn
juobbágoabbá+Pron+Indef+Sg+Gen	juoppágoappá	jˈŭŏpː.pɑː#kˌoɑp.pɑː
juobbágoabbá+Pron+Indef+Sg+Nom	juobbágoabbá	jˈuobː.pɑː#kˌoɑbː.pɑː
jahki+N+Der/laš+A+Comp+Pl+Nom	jagálabbot	jˈɑ.gɑː»lˌɑbː.poh
jahtat+V+TV+Der/d+V+Pot+Prs+Du1	jađadežže	jˈɑ.ðɑː»dˌedː.tʃe
jakkas+A+Der/vuohta+N+Sg+Ill	jakkasvuhtii	jˈɑkː.kɑːs»vˌuh.tij
jaman+N+Der/viđá+Adv	jamanviđá	jˈɑ.mɑːn»vˌi.ðɑː
jaril+Adv	jaril	jˈɑ.riːl
jarkŋasmuvvat+V+IV+Sup	jarkŋasmeažžat	jˈɑrkː.ŋɑːs.mˌeædː.tʃɑh
jarla+N+Sg+Ill	jarlii	jˈɑr.lij
jassa+N+Pl+Nom	jasat	jˈɑ.sɑːh
jat+Adv	jat	jˈɑh
jađgŋot+V+IV+Ind+Prt+Sg3	jađgŋui	jˈɑðə.kŋuj
jealbma+N+Sg+Ill	jelbmii	jˈelə.pmij
jelgii+Adv	jelgii	jˈelə.kij
jeđđejeaddji+N+NomAg+Sg+Com+PxPl2	jeđđejeddjiineattet	jˈeð.ðe.jˌeɟː.cij.nˌĕæt.teh
jeđđet+V+TV+Ind+Prt+Sg3	jeđđii	jˈeð.ðij
jiekŋudit+V+TV+Der/adda+V+Imprt+Pl2	jikŋodaddit	jˈik.ŋod»ˌɑdː.tih
jiellut+V+IV+VAbess+A+Attr	jielukeahtes	jˈie.lu.kˌĕæh.tes
jieŋas+N+Sg+Nom+PxDu3	jiekŋaseaskka	jˈiek.ŋɑ.sˌeæs.kɑ
jikkat+N+Ess	jiggan	jˈigː.kɑːn
jikkat+N+Pl+Nom	jikkat	jˈikː.kɑːh
jirkut+V+TV+Pot+Prs+Sg3	jirkkoš	jˈirr̥.koʃ
jirpmet+Adv	jirpmet	jˈirp.meh
jitnosii+Adv	jitnosii	jˈit.no.sij
jo+Interj	jo	jˈo
joazihit+V+IV+Inf	joazihit	jˈoɑ.dsi.hih
johtalit+V+IV+PrfPrc	johtalan	jˈohː.tɑː.lɑn
jolas+N+Sg+Nom	jolas	jˈo.lɑːs
joliheapme+A+Pl+Com	jolihemiiguin	jˈo.li.hˌe.mij.gujn
joliheapme+A+Der/huhtti+V+TV+Inf	jolihuhttit	jˈoː.lih»ˌuhː.tih
jođas+N+Ess	jođasin	jˈo.ðɑː.sin
jođas+N+Der/viđá+Adv	jođasviđá	jˈo.ðɑːs»vˌi.ðɑː
juggi+N+Sg+Acc+PxSg2	jukkát	jˈukː.kɑːh
juksaoarra+N+Sg+Ill	juksaorrii	jˈukː.sɑː#ˌor.rij
jupmat+V+IV+Der/NomAg+N+Sg+Acc	jubmi	jˈub.mi»
jupmat+V+IV+Imprt+Pl2	jupmet	jˈup.meh
jussut+V+IV+Der/st+V+Ind+Prs+ConNeg	jusus	jˈu.su»s
jutnošit+V+IV+PrfPrc	jutnošan	jˈut.no.ʃɑn
juđus+N+Sg+Nom	juđus	jˈu.ðuːs
juŋgá+N+Ess+PxDu1	juŋgáneame	jˈuŋŋ.kɑː.nˌĕæ.me
jáhpi+N+Pl+Nom	jábit	jˈɑː.biːh
játnat+V+IV+Imprt+Du2	jádni	jˈɑːd.niː
játnat+V+IV+Der/NomAg+N+Sg+Ill	jádnái	jˈɑːd.nɑː»i
jázzahámat+A+Der/vuohta+N+Ess+PxSg1	jázzahámatvuohtanan	jˈɑːdː.tsɑ#hˌɑː.mɑh»vˌuoh.tɑ.nɑn
kantuvra+N+Sg+Nom+PxSg3	gántuvras	kˈɑːnː.n̥tuv.rɑs
kantuvra+N+Sg+Nom	gántuvra	kˈɑːnː.n̥tuv.rɑ
kantuvra+N+Der/laš+A+Der/vuohta+N+Sg+Ill	gánttorlašvuhtii	kˈɑːnn̥.tor»lɑʃ»vˌuh.tij
kantuvra+N+Sg+Nom+PxPl3	kantuvraset	khˈɑnː.n̥tuv.rˌɑ.seh
kantuvra+N+Sg+Nom+PxSg3	kontuvras	khˈonː.n̥tuv.rɑs
kantuvra+N+Sg+Ill	kantuvrii	khˈɑnː.n̥tuv.rij
kantuvra+N+Sg+Gen+PxPl1	kontoreamet	khˈonː.n̥to.rˌĕæ.meh
kantuvra+N+Sg+Nom+PxDu3	gántuvraska	kˈɑːnː.n̥tuv.rˌɑsː.kɑ
kantuvra+N+Sg+Nom+PxSg3	gántuvras	kˈɑːnː.n̥tuv.rɑs
kantuvra+N+Sg+Nom	gántuvra	kˈɑːnː.n̥tuv.rɑ
kantuvra+N+Ess+PxDu2	gántuvraneatte	kˈɑːnː.n̥tuv.rˌɑ.nĕæt.te
kantuvra+N+Sg+Gen+PxDu1	gántuvrame	kˈɑːnː.n̥tuv.rˌɑ.me
kantuvra+N+Sg+Nom+PxPl1	gántuvramet	kˈɑːnː.n̥tuv.rˌɑ.meh
kantuvra+N+Sg+Ill	gántuvrii	kˈɑːnː.n̥tuv.rij
kantuvra+N+Sg+Com+PxDu1	gántuvrraineame	kˈɑːnː.n̥tuvr.rˌɑj.nĕæ.me
kantuvra+N+Sg+Loc+PxPl1	gántuvrrasteamet	kˈɑːnː.n̥tuvr.rˌɑsː.tĕæ.meh
kantuvra+N+Sg+Nom+PxPl3	kantuvraset	khˈɑnː.n̥tuv.rˌɑ.seh
kantuvra+N+Sg+Nom	kantuvra	khˈɑnː.n̥tuv.rɑ
kantuvra+N+Sg+Nom+PxDu3	kontuvraska	khˈonː.n̥tuv.rˌɑsː.kɑ
kantuvra+N+Sg+Nom	kontuvra	khˈonː.n̥tuv.rɑ
kantuvra+N+Sg+Acc+PxDu1	kontuvrame	khˈonː.n̥tuv.rˌɑ.me
kantuvra+N+Sg+Ill	kontuvrii	khˈonː.n̥tuv.rij
kantuvra+N+Pl+Acc	kontuvrraid	khˈonː.n̥tuvr.rɑjh
kantuvra+N+Sg+Loc+PxPl2	kontuvrrasteattet	khˈonː.n̥tuvr.rˌɑsː.tĕæt.teh
kantuvra+N+Sg+Nom+PxPl3	gántoreaset	kˈɑːnː.n̥to.rˌĕæ.seh
kantuvra+N+Sg+Loc	gántoris	kˈɑːnː.n̥to.ris
kantuvra+N+Der/viđá+Adv	gántorviđá	kˈɑːnː.n̥tor»vˌi.ðɑː
kantuvra+N+Der/viđá+Adv	gánttorviđá	kˈɑːnn̥.tor»vˌi.ðɑː
kantuvra+N+Sg+Acc+PxSg1	kontoran	khˈonː.n̥to.rɑn
kantuvra+N+Sg+Acc+PxSg2	kontorat	khˈonː.n̥to.rɑh
kantuvra+N+Sg+Gen+PxPl1	kontoreamet	khˈonː.n̥to.rˌĕæ.meh
kantuvra+N+Sg+Loc+PxPl2	kontoristtádet	khˈonː.n̥to.rˌis.tɑː.deh
kantuvra+N+Der/viđá+Adv	kontorviđá	khˈonː.n̥tor»vˌi.ðɑː
kantuvra+N+Der/viđá+Adv	konttorviđá	khˈonn̥.tor»vˌi.ðɑː
kanovdna+N+Sg+Nom+PxDu3	kanovdnaska	khˈɑ.nov.tnˌɑsː.kɑ
kanovdna+N+Ess+PxDu3	kanovdnaneaskka	khˈɑ.nov.tnˌɑ.neæs.kɑ
kanovdna+N+Pl+Nom+PxDu2	kanovnnaideatte	khˈɑ.novn.nˌɑjː.tĕæt.te
kaderpartiija+N+Pl+Gen+PxDu2	kaderpartiijaideatte	khˈɑ.der#phˌɑrə.htij.jˌɑjː.tĕæt.te
kakáo+N+Sg+Com+PxPl2	kakáoineattet	khˈɑ.kɑː.ˌoj.nĕæt.teh
kaoliidna+N+Sg+Nom	kaoliidna	khˈɑ.o.lˌij.tnɑ
kapteaidna+N+Sg+Ill	kapteidnii	khˈɑp.tej.tnij
keailu+N+Sg+Acc+PxSg2	keillot	khˈejl.loh
keeper+N+Der/viđá+Adv	keeperviđá	khˈe.e.per»vˌi.ðɑː
kelatiidna+N+Sg+Nom+PxPl3	kelatiidnaset	khˈe.lɑː.tˌij.tnɑ.seh
kempe+N+Der/viđá+Adv	kempeviđá	khˈemː.m̥pe»vˌi.ðɑː
kenlaš+N+Sg+Ill	kenlažžii	khˈen.lɑːdː.tʃij
keyboard+N+Ess+PxPl2	keyboardaneattet	khˈe.y.bˌŏɑrə.tɑ.nˌĕæt.teh
kitiidna+N+Sg+Nom	kitiidna	khˈiː.tij.tnɑ
kivrosaš+A+Attr	kivrosaš	khˈiβː.ro.sɑʃ
kjemikála+N+Pl+Gen+PxDu2	kjemikálaideatte	kjˈe.mi.kˌɑː.lɑj.dˌĕæt.te
kjemikála+N+Sg+Ill+PxSg2	kjemikálasat	kjˈe.mi.kˌɑː.lɑ.sɑh
kjemikála+N+Sg+Ill	kjemikálii	kjˈe.mi.kˌɑː.lij
klieanta+N+Ess+PxSg2	klieantanat	klˈi.ĕænː.n̥tˌɑ.nɑh
kluovva+N+Der/viđá+Adv	kluovvaviđá	klˈuov.vɑ»vˌi.ðɑː
knihppet+V+TV+Der/PassL+V+IV+Actio+Nom	knihppejuvvon	knˈihː.pe»jˌuv.von
knihppet+V+TV+Ind+Prt+Du1	knihppiime	knˈihː.pij.me
knohpa+N+Ess+PxSg3	knohpanis	knˈohː.pɑː.nis
knohpa+N+Sg+Com+PxSg2	knohpainat	knˈohː.pɑːj.nɑh
knállja+N+Ess+PxDu1	knálljaneame	knˈɑːʎː.ʎɑ.nˌĕæ.me
knállja+N+Sg+Ill	knálljii	knˈɑːʎː.ʎij
koaffar+N+Der/viđá+Adv	koaffarviđá	khˈoɑf.fɑr»vˌi.ðɑː
koasttidit+V+TV+Imprt+ConNeg	koasttit	khˈoɑs.tiːh
kokaiidna+N+Sg+Nom	kokaiidna	khˈo.kɑː.ˌij.tnɑ
kotangeanta+N+Sg+Ill	kotangentii	khˈo.tɑːn.gˌenː.n̥tij
kremeret+V+TV+Der/PassL+V+IV+Der/upmi+N+Sg+Nom+PxSg1	kremerejupmán	krˈe.me.re»j»ˌup.mɑːn
kruoktu+N+Sg+Nom+PxPl2	kruktodet	krˈukː.hto.deh
kuhciidit+V+IV+VGen	kuhciit	khˈuh.tsijh
kulihkka+N+Sg+Com+PxPl3	kulihkaineaset	khˈuː.lih.kˌɑj.nĕæ.seh
kuvla+N+Sg+Ill	kuvlii	khˈuβː.lij
kvena+N+Sg+Com+PxDu1	kvenaineame	kvˈe.nɑːj.nˌĕæ.me
kymrigiel+A+Attr	kymrigiel	khˈym.ri#kiel
kymrigiella+N+Sg+Acc+PxDu3	kymrigielaska	khˈym.ri#kˌie.lɑs.kɑ
kyproslaš+N+Sg+Ill	kyproslažžii	khˈyp.ros.lˌɑdː.tʃij
káfet+N+Pl+Nom	káfet	khˈɑː.feh
kágga+N+Der/viđá+Adv	kággaviđá	khˈɑːgː.kɑ»vˌi.ðɑː
káhkaluvdna+N+Der/huhtti+V+TV+Der/NomAct+N+Sg+Acc	káhkaluvnnahuhttima	khˈɑːh.kɑl#ˌuβn.nɑ»hˌuhː.ti»mɑ
káktus+N+Ess	káktusin	khˈɑːkː.htu.sin
kámmir+N+Der/heapmi+A+Attr+Der/vuohta+N+Sg+Ill	kámerhisvuhtii	khˈɑː.mer»his»vˌuh.tij
kámera+N+Pl+Nom+PxSg1	kámeraidan	khˈɑː.me.rˌɑjː.tɑn
kátkkesmus+N+Sg+Com+PxDu2	kátkkesmusaineatte	khˈɑːtk.kes.mˌu.sɑj.nˌĕæt.te
kåseriija+N+Sg+Acc+PxDu1	kåseriijame	khˈoː.se.rˌij.jɑ.me
logi+Num+Ess	login	lˈo.giːn
logi+Num+Ess	lohkin	lˈohː.kiːn
logi+Num+Pl+Acc	logiid	lˈoː.gijh
logi+Num+Pl+Gen	logiid	lˈoː.gijh
logi+Num+Pl+Ill	logiide	lˈoː.gij.de
logi+Num+Pl+Loc	logiin	lˈoː.gijn
logi+Num+Pl+Nom	logit	lˈo.giːh
logi+Num+Sg+Acc	logi	lˈo.giː
logi+Num+Sg+Gen	logi	lˈo.giː
logi+Num+Sg+Ill	lohkái	lˈohː.kɑːj
logi+Num+Sg+Nom	logi	lˈo.giː
lágan+A+Sg+Nom	lágan	lˈɑː.gɑn
lágan+A+Sg+Com	láganiin	lˈɑː.gɑ.nijn
lágan+A+Attr	lágán	lˈɑː.gɑːn
lágan+A+Pl+Nom	lágánat	lˈɑː.gɑː.nɑh
lágan+A+Pl+Acc	lágániid	lˈɑː.gɑː.nijh
lágan+A+Sg+Acc	lágán	lˈɑː.gɑːn
lágan+A+Sg+Acc	lágána	lˈɑː.gɑː.nɑ
lágan+A+Sg+Gen	lágána	lˈɑː.gɑː.nɑ
lágaš+A+Sg+Acc	lágaš	lˈɑː.gɑʃ
lágaš+A+Der/vuohta+N+Der/viđá+Adv	lágašvuohtaviđá	lˈɑː.gɑʃ»vˌuoh.tɑ»vˌi.ðɑː
lágaš+A+Der/vuohta+N+Pl+Acc+PxSg1	lágašvuođaidan	lˈɑː.gɑʃ»vˌuo.ðɑj.dɑn
lágaš+A+Ess	lágažin	lˈɑː.gɑ.dʃin
lágaš+A+Pl+Loc	lágažiin	lˈɑː.gɑ.dʃijn
lágaš+A+Sg+Acc	lágáš	lˈɑː.gɑːʃ
lágaš+A+Pl+Gen	lágážiid	lˈɑː.gɑː.dʃijh
lágaš+A+Sg+Acc	lágáža	lˈɑː.gɑː.dʃɑ
lahpa+N+Der/laš+A+Comp+Sg+Ill	labalebbui	lˈɑ.bɑː»lˌebː.puj
lahka+A+Superl+Attr	lagamus	lˈɑ.gɑː.mus
lašpa+N+Der/viđá+Adv	lašpaviđá	lˈɑʃː.pɑː»vˌi.ðɑː
leat+V+IV+Inf	leat	lˈeæh
leat+V+IV+Pot+Prs+Pl3	ležžet	lˈedː.tʃeh
leat+V+IV+PrfPrc	leamašan	lˈeæ.mɑ.ʃɑn
leat+V+IV+PrsPrc	leahkki	lˈĕæhː.kiː
lerret+N+Sg+Acc+PxPl3	lerredeaset	lˈer.re.ðˌĕæ.seh
levlo+N+Sg+Com+PxPl3	levlluineaset	lˈeβl.luj.nˌĕæ.seh
lietuvagiella+N+Sg+Com+PxDu1	lietuvagielaineame	lˈi.e.tˌu.vɑ#kˌie.lɑj.nˌĕæ.me
liggu+N+Der/huvva+V+IV+Ger+PxPl2	likkohuvadettiineattet	lˈik.ko»hˌu.vɑ.dˌet.tij.nˌĕæt.teh
liánttabužan+N+Der/viđá+Adv	liánttabužanviđá	lˈi.ɑːnht.tɑ#pˌu.dʃɑn»vˌi.ðɑː
liántanjunni+N+Sg+Gen+PxDu3	liántanjuniska	lˈi.ɑːnː.n̥tɑ#ɲˌu.nis.kɑ
logis+N+Coll+Sg+Ill+PxDu2	lohkásasade	lˈohː.kɑː.sˌɑ.sɑ.de
lojan+N+Der/viđá+Adv	lojanviđá	lˈo.jɑːn»vˌi.ðɑː
loktit+V+TV+Der/halla+V+Imprt+Sg2	lovttáhala	lˈoβɸː.tɑː»hˌɑ.lɑ
lollat+V+TV+Ind+Prt+Du1	lolaime	lˈo.lɑːj.me
lollat+V+TV+ConNegII	lollo	lˈol.lo
lorgnetteret+V+TV+Ind+Prt+Du2	lorgnetteriide	lˈorg.net.tˌe.rij.de
lođas+N+Sg+Nom	lođas	lˈo.ðɑːs
luhppu+N+Sg+Gen+PxDu2	luhpode	lˈuh.po.ðe
luksushotealla+G3+N+Sg+Ill	luksushotellii	lˈukː.sus#hˌo.tel.lij
luovvi+N+Sg+Com+PxSg2	luviinat	lˈuː.vij.nɑh
luččuhit+V+TV+Der/alla+V+Sup	luččohalažit	lˈut.tʃoh»ˌɑ.lɑ.dʃih
lužohat+N+Sg+Com+PxPl1	lužohagaineamet	lˈu.dʃo.hˌɑ.gɑj.nˌĕæ.meh
lužohat+N+Sg+Nom	lužohat	lˈu.dʃo.hɑh
lydisoleret+V+TV+Der/PassL+V+IV+Ind+Prs+Sg3	lydisolerejuvvo	lˈyd#ˌi.so.lˌe.re»j»ˌuv.vo
lydisoleret+V+TV+Ind+Prt+Du3	lydisoleriiga	lˈyd#ˌi.so.lˌe.rij.gɑ
lymfa+N+Sg+Ill	lymfii	lˈym.fij
láddeluvvat+V+IV+Der/ahtti+V+TV+Actio+Gen	láddiluhttin	lˈɑːdː.til»ˌuhː.tin
lágut+N+Der/geahtes+A+Attr	lágotkeahtes	lˈɑː.goh»kˌĕæh.tes
lákči+N+Sg+Gen+PxPl3	lávččiset	lˈɑːβɸ.tʃi.seh
láppezas+N+Pl+Acc+PxPl2	láppezasaideattet	lˈɑːp.pe.dsˌɑ.sɑj.dˌĕæt.teh
lásis+N+Der/huhtti+V+TV+Ger	láseshuhtidettiin	lˈɑː.ses»hˌuh.ti.dˌet.tijn
lávnnaslivva+N+Sg+Acc+PxDu3	lávnnaslivaska	lˈɑːβn.nɑs#lˌi.vɑs.kɑ
láđis+A+AttrCmp+Der/dáfot+A+Der/vuohta+N+Sg+Ill	láđisdáfotvuhtii	lˈɑː.ðis»dˌɑː.foh»vˌuh.tij
láža+N+Der/huvva+V+IV+Imprt+ConNeg	lážahuva	lˈɑː.dʃɑ»hˌu.vɑ
læstadianisma+N+Der/viđá+Adv	læstadianismaviđá	lˈæsː.tɑ.ðˌi.ɑ.nˌis.mɑ»vˌi.ðɑː
læstadianisma+N+Sg+Ill	læstadianismii	lˈæsː.tɑ.ðˌi.ɑ.nˌis.mij
læstadianisma+N+Der/huvva+V+IV+Imprt+Pl3	læstadianismmahuvvoset	lˈæsː.tɑ.ðˌi.ɑ.nˌis.mɑ»hˌuv.vo.seh
læstadialaš+A+Ess	læstadialažžan	lˈæsː.tɑ.ðˌi.ɑ.lˌɑdː.tʃɑn
læstadiánalašvuohta+N+Sg+Ill	læstadiánalašvuhtii	lˈæsː.tɑ.ðˌi.ɑː.nˌɑ.lɑʃ.vuh.tij
læstadiánalašvuohta+N+Ess+PxSg2	læstadiánalašvuohtanat	lˈæsː.tɑ.ðˌi.ɑː.nˌɑ.lɑʃ.vuoh.tɑ.nɑh
læstadiánalašvuohta+N+Sg+Ill+PxPl1	læstadiánalašvuohtaseamet	lˈæsː.tɑ.ðˌi.ɑː.nˌɑ.lɑʃ.vuoh.tɑ.sĕæ.meh
mašiidna+N+Sg+Nom+PxDu3	mašiidnaska	mˈɑ.ʃij.tnˌɑsː.kɑ
mašiidna+N+Sg+Nom+PxPl3	mašiidnaset	mˈɑ.ʃij.tnˌɑ.seh
mašiidna+N+Sg+Nom+PxSg3	mašiidnas	mˈɑ.ʃij.tnɑs
mašiidna+N+Sg+Nom	mašiidna	mˈɑ.ʃij.tnɑ
mašiidna+N+Sg+Acc+PxSg1	mašiidnan	mˈɑ.ʃij.tnɑn
mašiidna+N+Sg+Nom+PxDu2	mašiidnade	mˈɑ.ʃij.tnˌɑ.de
mašiidna+N+Sg+Ill	mašiidnii	mˈɑ.ʃij.tnij
mašiidna+N+Pl+Acc+PxDu2	mašiinnaideatte	mˈɑ.ʃijn.nˌɑjː.tĕæt.te
mašiidna+N+Pl+Nom	mašiinnat	mˈɑ.ʃijn.nɑh
mašiidna+N+Sg+Acc+PxSg2	mašiinnat	mˈɑ.ʃijn.nɑh
mašiidna+N+Sg+Acc	mašiinna	mˈɑ.ʃijn.nɑ
mašiidna+N+Sg+Com+PxDu2	mašiinnaineatte	mˈɑ.ʃijn.nˌɑj.nĕæt.te
mašiidna+N+Sg+Loc+PxPl3	mašiinnasteaset	mˈɑ.ʃijn.nˌɑsː.tĕæ.seh
mii+Pron+Interr+Sg+Nom	mii	mˈij
mii+Pron+Interr+Ess	manin	mˈɑ.niːn
mii+Pron+Interr+Pl+Acc	maid	mˈɑjh
mii+Pron+Interr+Pl+Com	maiguin	mˈɑjː.kujn
mii+Pron+Interr+Pl+Gen	maid	mˈɑjh
mii+Pron+Interr+Pl+Ill	maidda	mˈɑjtː.tɑː
mii+Pron+Interr+Pl+Nom	mat	mˈɑh
mii+Pron+Rel+Sg+Acc	máid	mˈɑːjh
mii+Pron+Rel+Sg+Nom	mii	mˈij
mii+Pron+Rel+Ess	manin	mˈɑ.niːn
mii+Pron+Rel+Pl+Gen	maid	mˈɑjh
mii+Pron+Rel+Pl+Nom	mat	mˈɑh
mii+Pron+Rel+Sg+Com	mainna	mˈɑjnː.nɑː
mii+Pron+Rel+Sg+Ill	masa	mˈɑ.sɑː
mai+Adv	mai	mˈɑj
mammografiijabusse+G3+N+Sg+Ill	mammografiijabussii	mˈɑm.mo.grˌɑ.fij.jɑ#pˌus.sij
mccarthyisma+N+Der/viđá+Adv	mccarthyismaviđá	mtstsˈɑrt.hy.ˌisː.mɑ»vˌi.ðɑː
mccarthyisma+N+Der/huvva+V+IV+Ind+Prt+Sg1	mccarthyismmahuvven	mtstsˈɑrt.hy.ˌis.mɑ»hˌuv.ven
meiráma+N+Sg+Ill	meirámii	mˈejː.rɑː.mij
mihkkege+Pron+Indef+Sg+Loc	masge	mˈɑs.ge
mihkke+Pron+Indef+Sg+Acc	maide	mˈɑjː.te
mii+Pron+Indef+Pl+Nom	mat	mˈɑh
miktam+N+Pl+Nom	miktamat	mˈikː.htɑ.mɑh
mimihkka+N+Pl+Acc+PxPl2	mimihkaideattet	mˈiː.mih.kˌɑjː.tĕæt.teh
mimihkka+N+Der/heapmi+A+Comp+Pl+Nom	mimihkahabbot	mˈiː.mih.kɑ»hˌɑbː.poh
mittodit+V+TV+Der/meahttun+A+Superl+Ess	mittotmeahttuseamosin	mˈit.toh»mˌĕæhː.tu.sˌĕæ.mo.sin
mii+Pron+Indef+Sg+Acc+	máid	mˈɑːjh
mjau+Interj	mjau	mjˈɑu
moattebealat+A+Sg+Nom	maottibealat	mˈɑ.ot.ti#pˌeæ.lɑh
mollat+V+TV+Cond+Prs+Sg3	molalii	mˈo.lɑː.lij
moxa+N+Der/viđá+Adv	moxaviđá	mˈoks.ɑ»vˌi.ðɑː
mun+Pron+Pers+Du1+Acc	munno	mˈun.no
mun+Pron+Pers+Du1+Loc	munnos	mˈun.nos
mun+Pron+Pers+Pl1+Com	minguin	mˈiŋŋ.kujn
mun+Pron+Pers+Pl1+Loc	mis	mˈis
muoidu+N+Sg+Ill+PxSg1	muidosan	mˈujː.to.sɑn
muŋka+N+Ess+PxPl2	muŋkaneattet	mˈuŋŋ.ŋ̊kɑ.nˌĕæt.teh
myhta+N+Der/huvva+V+IV+Ind+Prs+Sg3	myhtahuvvá	mˈyh.tɑ»hˌuvː.vɑː
mánnu+N+Der/Dimin+N+Sg+Nom	mánoš	mˈɑː.no»ʃ
mánahallat+V+IV+Pot+Prs+Du1	mánahalažetne	mˈɑː.nɑ.hˌɑ.lɑ.dʃˌet.ne
mánáhuvvat+V+IV+Der/ahtti+V+TV+Imprt+Pl2	mánáhuhttet	mˈɑː.nɑːh»ˌuhː.teh
mátta+N+Sg+Nom+PxPl3	máddageaset	mˈɑːdː.tɑ.gˌĕæ.seh
mátta+N+Pl+Acc	máddagiid	mˈɑːdː.tɑ.gijh
möbleret+V+TV+PrfPrc	möbleren	mˈøb.le.ren
möbleret+V+TV+Der/PassL+V+IV+Der/upmi+N+Pl+Loc+PxDu1	möblerejumiineame	mˈøb.le.re»j»ˌu.mij.nˌĕæ.me
möbleret+V+TV+Ind+Prt+Pl1	möbleriimet	mˈøb.le.rˌij.meh
møbleret+V+TV+Der/PassL+V+IV+Cond+Prs+Du1	møblerejuvvošeimme	mˈøb.le.re»j»ˌuv.vo.ʃˌejm.me
møbleret+V+TV+Ind+Prt+Du2	møbleriide	mˈøb.le.rˌijː.te
nubbi+Pron+Recipr+Pl+Acc+PxDu2	nuppiideatte	nˈup.pij.dˌĕæt.te
nubbi+Pron+Recipr+Pl+Acc+PxPl1	nuppiideamet	nˈup.pij.dˌĕæ.meh
nubbi+Pron+Recipr+Pl+Acc+PxPl2	nuppiideattet	nˈup.pij.dˌĕæt.teh
nubbi+Pron+Recipr+Pl+Com+PxDu1	nuppiideameguin	nˈup.pij.dˌĕæ.me.gujn
nubbi+Pron+Recipr+Pl+Com+PxPl1	nuppiideametguin	nˈup.pij.dˌĕæ.met.gujn
nubbi+Pron+Recipr+Pl+Com+PxPl3	nuppiideasetguin	nˈup.pij.dˌĕæ.set.gujn
nubbi+Pron+Recipr+Pl+Gen+PxDu1	nuppiideame	nˈup.pij.dˌĕæ.me
nubbi+Pron+Recipr+Pl+Gen+PxDu2	nuppiideatte	nˈup.pij.dˌĕæt.te
nubbi+Pron+Recipr+Pl+Gen+PxDu3	nuppiideaskka	nˈup.pij.dˌeæs.kɑ
nubbi+Pron+Recipr+Pl+Gen+PxPl1	nuppiideamet	nˈup.pij.dˌĕæ.meh
nubbi+Pron+Recipr+Pl+Gen+PxPl2	nuppiideattet	nˈup.pij.dˌĕæt.teh
nubbi+Pron+Recipr+Pl+Ill+PxDu1	nuppiidasame	nˈup.pij.dˌɑ.sɑ.me
nubbi+Pron+Recipr+Pl+Ill+PxPl2	nuppiidasadet	nˈup.pij.dˌɑ.sɑ.deh
nubbi+Pron+Recipr+Pl+Loc+PxDu1	nuppiineame	nˈup.pij.nˌĕæ.me
nubbi+Pron+Recipr+Pl+Loc+PxDu2	nuppiineatte	nˈup.pij.nˌĕæt.te
nubbi+Pron+Recipr+Pl+Loc+PxDu3	nuppiineaskka	nˈup.pij.nˌeæs.kɑ
nubbi+Pron+Recipr+Pl+Loc+PxPl1	nuppiineamet	nˈup.pij.nˌĕæ.meh
nubbi+Pron+Recipr+Pl+Loc+PxPl2	nuppiineattet	nˈup.pij.nˌĕæt.teh
nubbi+Pron+Recipr+Pl+Loc+PxPl3	nuppiineaset	nˈup.pij.nˌĕæ.seh
nuppelohkái+Num+Ess	nubbinlogin	nˈubː.pin#lˌo.gin
nuppelohkái+Num+Ess	nubbinlohkin	nˈubː.pin#lˌohː.kin
nuppelohkái+Num+Sg+Gen	nuppelogi	nˈup.pe#lˌo.gi
nuppelohkái+Num+Sg+Genmiesebeaska+N+Sg+Ill	nuppelogimiesebeskii	nˈup.pe#lˌo.gi»mˌĭe.se#pˌesː.kij
nuppelohkái+Num+Sg+Gensahán+N+Sg+Gen	nuppelogisaháma	nˈup.pe#lˌo.gi»sˌɑ.hɑː.mɑ
nuppelohkái+Num+Sg+Acc	nuppelohkái	nˈup.pe#lˌohː.kɑːj
nuppelohkái+Num+Pl+Com	nuppiiguinlogiiguin	nˈup.pij.gujn#lˌo.gij.gujn
nuppelohkái+Num+Pl+Loc	nuppiinlogiin	nˈup.pijn#lˌo.gijn
nuppelohkái+Num+Pl+Nom	nuppitlogit	nˈupː.pih#lˌo.gih
naššuvdna+N+Sg+Nom+PxDu3	naššuvdnaska	nˈɑʃː.ʃuv.tnˌɑsː.kɑ
naššuvdna+N+Sg+Nom	naššuvdna	nˈɑʃː.ʃuv.tnɑ
naššuvdna+N+Pl+Loc+PxPl2	naššuvnnaineattet	nˈɑʃː.ʃuvn.nˌɑj.nĕæt.teh
naššuvdna+N+Sg+Acc+PxSg2	naššuvnnat	nˈɑʃː.ʃuvn.nɑh
naššuvdna+N+Sg+Loc	naššuvnnas	nˈɑʃː.ʃuvn.nɑs
naššuvdna+N+Sg+Nom	naššuvdna	nˈɑʃː.ʃuv.tnɑ
naššuvdna+N+Der/heapmi+A+Superl+Ess	naššuvnnahamosin	nˈɑʃː.ʃuvn.nɑ»hˌɑ.mo.sin
nejaljegearddat+A+Pl+Nom	nejaljegearddagat	nˈe.jɑːlə.je#kˌeært.tɑ.gɑh
nejaljegearddat+A+Pl+Com	nejaljegearddagiiguin	nˈe.jɑːlə.je#kˌeært.tɑ.gˌijː.kujn
nemda+N+Sg+Ill	nemdii	nˈem.dij
neutrála+A+Comp+Der/at+Adv	neutrálabut	nˈeut.rɑː.lˌɑ.buh
neutrála+A+Sg+Ill	neutrálii	nˈeut.rɑː.lij
nevrošit+V+IV+Ind+Prt+ConNeg	nevrošan	nˈeβː.ro.ʃɑn
nihlla+N+Sg+Acc+PxPl2	nihladet	nˈih.lɑː.ðeh
niitu+N+Sg+Acc+PxDu2	niittode	nˈijç.to.ðe
nilkkistit+V+TV+Der/alla+V+Cond+Prs+Pl3	nilkkástalaledje	nˈill̥ː.kɑːsh»ˌɑ.lɑ.lˌec.ce
ninna+N+Sg+Com+PxDu3	ninaineaskka	nˈi.nɑːj.nˌeæs.kɑ
njávvi+N+Der/Dimin+N+Der/viđá+Adv	njávášviđá	ɲˈɑː.vɑː»ʃ»vˌi.ðɑː
no+Adv	no	nˈo
noddet+V+IV+VAbess	noddekeahttájin	nˈodː.te.kˌĕæhː.tɑː.jin
nollas+A+Superl+Sg+Nom	nollaseamos	nˈolː.lɑː.sˌĕæ.mos
nollut+Adv	nollut	nˈolː.luːh
nođđu+N+Sg+Acc+PxDu3	nođuska	nˈoː.ðus.kɑ
nubbeviđátlohkái+Num+Sg+Attr	nubbinviđatlot	nˈubː.pin#vˌi.ðɑh#loh
nudisma+N+Sg+Ill	nudismii	nˈuː.dis.mij
nuggá+N+Sg+Loc	nukkás	nˈukː.kɑːs
nunná+N+Sg+Gen	nunná	nˈunː.nɑː
nurridit+V+TV+Der/alla+V+Pot+Prs+ConNeg	nurrádalaš	nˈurː.rɑːd»ˌɑ.lɑʃ
nyanseret+V+TV+Imprt+ConNeg	nyansere	nˈy.ɑn.sˌe.re
nygaardsvollvanca+N+Sg+Ill	nygaardsvollvancii	nˈy.gɑ.ɑrds#volː#vˌɑnː.n̥tsij
nylona+N+Ess	nylonan	nˈy.lo.nɑn
nylona+N+Sg+Com+PxPl1	nylonaineamet	nˈy.lo.nˌɑj.nĕæ.meh
návccaiduvvat+V+IV+Ind+Prt+Pl1	návccaiduvaimet	nˈɑːβɸ.tsɑj.dˌu.vɑj.meh
náđodit+V+IV+VGen	náđot	nˈɑː.ðoh
náššat+V+TV+Der/NomAg+N+Sg+Com+PxPl3	náššiineaset	nˈɑːʃ.ʃi»ˌi.nĕæ.seh
nødsignála+N+Sg+Ill	nødsignálii	nˈød#sˌig.nɑː.lij
okta+Num+Sg+Nom	akta	ˈɑkː.htɑ
oktagoalmmátlohkái+Num+Sg+Nom	aktagoalmmátlohkái	ˈɑkː.htɑ#kˌoɑlm.mɑːh#lˌohː.kɑːj
oktagoalmmátlohkái+Num+Sg+Attr	aktangoalmmátlot	ˈɑkː.htɑn#kˌoɑlm.mɑːh#loh
oktalogátlohkái+Num+Ess	aktalogátlohkin	ˈɑkː.htɑ#lˌo.gɑːh#lˌohː.kin
oktalogátlohkái+Num+Sg+Attr	aktanlogátlot	ˈɑkː.htɑn#lˌo.gɑːh#loh
oktanjealjátlohkái+Num+Sg+Nom	aktanjealjátlohkái	ˈɑkː.htɑ#ɲˌeæʎ.ʎɑːh#lˌohː.kɑːj
oktanuppelohkái+Num+Sg+Attr	aktannuppelot	ˈɑkː.htɑn#nˌup.pe#loh
oktaovccátlohkái+Num+Sg+Attr	aktanovccátlot	ˈɑkː.htɑn#ˌoβɸ.tsɑːh#loh
oktačihččetlohkái+Num+Sg+Attr	aktačihččetlot	ˈɑkː.htɑ#tʃˌihː.tʃeh#loh
okta#lohki+Num+Sg+Nom	aktalohki	ˈɑkː.htɑ#lˌohː.ki
oktaduháhat+A+Ord+Sg+Loc	aktaduháhattas	ˈɑkː.htɑ#tˌu.hɑː.hˌɑt.tɑs
oktaduhátlogi+Num+Ess	aktaduhátlogin	ˈɑkː.htɑ#tˌu.hɑːh#lˌo.gin
oktage+Pron+Indef+Sg+Nom	aktage	ˈɑkː.htɑ.ge
oktačuohti+Num+Sg+Nom	aktačuohti	ˈɑkː.htɑ#tʃˌuoh.ti
oktagoalmmátlohkái+Num+Sg+Attr	avttagoalmmátlot	ˈɑβɸː.tɑː#kˌoɑlm.mɑːh#loh
oktagoalmmátlohkái+Num+Sg+Loc	avttagoalmmátlogis	ˈɑβɸː.tɑː#kˌoɑlm.mɑːh#lˌo.gis
oktagávccátlohkái+Num+Sg+Attr	avttaingávccátlot	ˈɑβɸː.tɑːjn#kˌɑːβɸ.tsɑːh#loh
oktalogátlohkái+Num+Pl+Com+Attr	avttaidlogátlogiid	ˈɑβɸː.tɑːjh#lˌo.gɑːh#lˌo.gijh
oktalogátlohkái+Num+Pl+Gen	avttaidlogátlogiid	ˈɑβɸː.tɑːjh#lˌo.gɑːh#lˌo.gijh
oktalogátlohkái+Num+Sg+Ill	avttalogátlohkái	ˈɑβɸː.tɑː#lˌo.gɑːh#lˌohː.kɑːj
oktanjealjátlohkái+Num+Pl+Acc	avttaidnjealjátlogiid	ˈɑβɸː.tɑːjh#ɲˌeæʎ.ʎɑːh#lˌo.gijh
oktanjealjátlohkái+Num+Pl+Attr	avttainnjealjátlot	ˈɑβɸː.tɑːjn#ɲˌeæʎ.ʎɑːh#loh
oktanuppelohkái+Num+Ess	avttatnuppelogin	ˈɑβɸː.tɑːh#nˌup.pe#lˌo.gin
oktanuppelohkái+Num+Pl+Acc	avttaidnuppelogiid	ˈɑβɸː.tɑːjh#nˌup.pe#lˌo.gijh
oktaovccátlohkái+Num+Pl+Ill+Attr	avttaidovccátlogiid	ˈɑβɸː.tɑːjh#ˌoβɸ.tsɑːh#lˌo.gijh
oktaviđatlohkái+Num+Pl+Attr	avttatviđátlot	ˈɑβɸː.tɑːh#vˌi.ðɑːh#loh
oktaviđátlohkái+Num+Ess	avttatviđatlogin	ˈɑβɸː.tɑːh#vˌi.ðɑh#lˌo.gin
oktaviđátlohkái+Num+Ess	avttatviđátlogin	ˈɑβɸː.tɑːh#vˌi.ðɑːh#lˌo.gin
oktaviđátlohkái+Num+Pl+Gen	avttaidviđátlogiid	ˈɑβɸː.tɑːjh#vˌi.ðɑːh#lˌo.gijh
oktaviđátlohkái+Num+Sg+Ill	avttaviđátlohkái	ˈɑβɸː.tɑː#vˌi.ðɑːh#lˌohː.kɑːj
oktačihččetlohkái+Num+Ess	avttatčihččetlogin	ˈɑβɸː.tɑːh#tʃˌihː.tʃeh#lˌo.gin
oktačihččetlohkái+Num+Sg+Attr	avttačihččetlot	ˈɑβɸː.tɑː#tʃˌihː.tʃeh#loh
oatni+A+Der/at+Adv	oanit	ˈoɑ.niːh
obugralaš+A+Der/vuohta+N+Sg+Ill	obugralašvuhtii	ˈob#ˌug.rɑ.lɑʃ»vˌuh.tij
ockuperet+V+TV+Der/PassL+V+IV+Cond+Prs+Pl1	ockuperejuvvoleimmet	ˈots.ku.pˌe.re»j»ˌuv.vo.lˌejm.meh
ohcat+V+TV+VAbess+A+Attr	ozakeahtes	ˈo.dsɑː.kˌĕæh.tes
oivošguovlu+N+Sg+Ill	oivošguvlui	ˈojː.voʃ#kˌuβː.luj
oktaovccátlohkái+Num+Ess	ovttatovccátlogin	ˈoβɸː.tɑːh#ˌoβɸ.tsɑːh#lˌo.gin
ollut+Pron+Indef+Pl+Loc	oluin	ˈoː.lujn
ollugat+Pron+Indef+Pl+Nom	oallugat	ˈoɑl.lu.gɑh
omardit+V+TV+Actio+Com	omardemiin	ˈo.mɑːr.dˌe.mijn
opmir+N+Der/heapmi+A+Attr	omerhis	ˈoː.mer»his
opmu+N+Der/huhtti+V+TV+Ger	omohuhtidiin	ˈo.mo»hˌuh.ti.dijn
opmu+N+Der/huvva+V+IV+VAbess	omuhuvahaga	ˈo.mu»hˌu.vɑ.hˌɑ.gɑ
oppas+N+Pl+Nom	obbasat	ˈobː.pɑː.sɑh
opereret+V+TV+Ind+Prt+Du1	opereriime	ˈo.pe.rˌe.rij.me
opiniovdna+N+Sg+Gen+PxDu1	opiniovdname	ˈo.pi.nˌi.ov.tnˌɑ.me
orrut+V+IV+Ger+PxPl3	orudettiineaset	ˈo.ru.ðˌet.tij.nˌĕæ.seh
ordnet+V+TV+Der/PassL+V+IV+Der/upmi+N+Ess+PxDu3	ordnejupmineaskka	ˈorə.tne»j»ˌup.mi.nˌeæs.kɑ
orjješbiegga+N+Der/viđá+Adv	orjješbieggaviđá	ˈorj.jeʃ#pˌiegː.kɑ»vˌi.ðɑː
oscillográmma+N+Sg+Ill	oscillográmmii	ˈos.tsil.lˌo.grɑːm.mij
osku+N+Sg+Nom+PxSg1	oskon	ˈosː.kon
ossodat+N+Pl+Ill+PxDu1	ossodagaidasame	ˈos.so.ðˌɑ.gɑj.dˌɑ.sɑ.me
osttus+N+Pl+Nom	ostosat	ˈosː.to.sɑh
otne+Adv	otne	ˈot.ne
otnáeahket+N+Sg+Nom	otnáeahket	ˈotː.nɑː#ˌĕæh.keh
ovttas+N+Coll+Pl+Nom	oktasat	ˈokː.htɑ.sɑh
ovehit+V+IV+Ind+Prs+ConNeg	ovet	ˈoː.veh
ođas+N+Sg+Nom	ođas	ˈo.ðɑːs
ođđot+V+IV+Ind+Prt+Sg3	ođđui	ˈoð.ðuj
ožoldit+V+TV+Ind+Prs+ConNeg	ožol	ˈo.dʃol
ožžodit+V+IV+Actio+Nom	ožžodan	ˈodː.tʃo.ðɑn
ovdaprojekterengolut+N+Der/heapmi+A+Comp+Sg+Nom	váktagolohet	vˈɑːkː.htɑ#kˌo.lo»heh
ovdaprojekterengolut+N+Der/heapmi+A+Comp+Attr	váktagolohut	vˈɑːkː.htɑ#kˌo.lo»huh
ovdaprojekterengolut+N+Der/heapmi+A+Ess	váktagoloheapmin	vˈɑːkː.htɑ#kˌo.lo»hˌeæp.min
ovdaprojekterengolut+N+Der/heapmi+A+Sg+Com	váktagolohemiin	vˈɑːkː.htɑ#kˌo.lo»hˌe.mijn
ovdaprojekterengolut+N+Der/huhtti+V+TV+Pot+Prs+ConNeg	váktagolohuhteš	vˈɑːkː.htɑ#kˌo.lo»hˌuh.teʃ
ovdaprojekterengolut+N+Der/huvva+V+IV+Pot+Prs+Sg3	váktagolohuvaš	vˈɑːkː.htɑ#kˌo.lo»hˌu.vɑʃ
ovdaprojekterengolut+N+Der/huvva+V+IV+Imprt+Pl2	váktagolohuvvet	vˈɑːkː.htɑ#kˌo.lo»hˌuv.veh
ovdaprojekterengolut+N+Der/Dimin+N+Pl+Nom	váktagoložat	vˈɑːkː.htɑ#kˌo.lo»dʃɑh
ovdaprojekterengolut+N+Der/Dimin+N+Ess	váktagoložin	vˈɑːkː.htɑ#kˌo.lo»dʃin
ovdaprojekterengolut+N+Der/Dimin+N+Pl+Gen	váktagoložiid	vˈɑːkː.htɑ#kˌo.lo»dʃijh
ovdaprojekterengolut+N+Der/Dimin+N+Pl+Ill+PxSg1	váktagoložiiddásan	vˈɑːkː.htɑ#kˌo.lo»dʃˌijtː.tɑː.sɑn
ovdaprojekterengolut+N+Pl+Acc	váktagoluid	vˈɑːkː.htɑ#kˌo.lujh
ovdaprojekterengolut+N+Pl+Ill+PxDu3	váktagoluidasaska	vˈɑːkː.htɑ#kˌo.luj.dˌɑ.sɑs.kɑ
ovdaprojekterengolut+N+Pl+Loc+PxSg3	váktagoluinis	vˈɑːkː.htɑ#kˌo.luj.nis
ovdaprojekterengolut+N+Pl+Nom+PxPl1	váktagoluideamet	vˈɑːkː.htɑ#kˌo.luj.dˌĕæ.meh
ovdaprojekterengolut+N+Der/heapmi+A+Comp+Sg+Com	váktagoluheappuin	vˈɑːkː.htɑ#kˌo.lu»hˌeæp.pujn
ovdaprojekterengolut+N+Der/huhtti+V+TV+VAbess	váktagoluhuhtehaga	vˈɑːkː.htɑ#kˌo.lu»hˌuh.te.hˌɑ.gɑ
ovdaprojekterengolut+N+Der/huhtti+V+TV+VGen	váktagoluhuhti	vˈɑːkː.htɑ#kˌo.lu»hˌuhː.ti
ovdaprojekterengolut+N+Der/huhtti+V+TV+Ind+Prt+Pl3	váktagoluhuhtte	vˈɑːkː.htɑ#kˌo.lu»hˌuhː.te
ovdaprojekterengolut+N+Der/huhtti+V+TV+Der/PassL+V+IV+Der/supmi+N+Sg+Ill	váktagoluhuhttosupmái	vˈɑːkː.htɑ#kˌo.lu»hˌuhː.to»sˌupː.mɑːj
ovdaprojekterengolut+N+Der/huvva+V+IV+VGen	váktagoluhuva	vˈɑːkː.htɑ#kˌo.lu»hˌu.vɑ
ovdaprojekterengolut+N+Der/huvva+V+IV+Actio+Com	váktagoluhuvvamiin	vˈɑːkː.htɑ#kˌo.lu»hˌuv.vɑ.mijn
ovdaprojekterengolut+N+Der/huvva+V+IV+Imprt+Sg1	váktagoluhuvvon	vˈɑːkː.htɑ#kˌo.lu»hˌuv.von
ovdaprojekterengolut+N+Der/huvva+V+IV+Imprt+Sg3	váktagoluhuvvos	vˈɑːkː.htɑ#kˌo.lu»hˌuv.vos
ovdaprojekterengolut+N+Ess	váktagollun	vˈɑːkː.htɑ#kˌolː.lun
poastamáhppa+N+Pl+Com+PxDu1	boastamáhpaideameguin	pˈŏɑsː.tɑ#mˌɑːh.pɑj.dˌĕæ.me.gujn
poastamáhppa+N+Pl+Loc	boastamáhpain	pˈŏɑsː.tɑ#mˌɑːh.pɑjn
poastamáhppa+N+Pl+Nom	boastamáhpat	pˈŏɑsː.tɑ#mˌɑːh.pɑh
poastamáhppa+N+Sg+Acc+PxSg2	boastamáhpat	pˈŏɑsː.tɑ#mˌɑːh.pɑh
poastamáhppa+N+Sg+Gen+PxDu2	boastamáhpade	pˈŏɑsː.tɑ#mˌɑːh.pɑ.de
poastamáhppa+N+Sg+Com+PxDu1	boastamáhpaineame	pˈŏɑsː.tɑ#mˌɑːh.pɑj.nˌĕæ.me
poastamáhppa+N+Sg+Com+PxDu2	boastamáhpaineatte	pˈŏɑsː.tɑ#mˌɑːh.pɑj.nˌĕæt.te
poastamáhppa+N+Sg+Com+PxPl3	boastamáhpaineaset	pˈŏɑsː.tɑ#mˌɑːh.pɑj.nˌĕæ.seh
poastamáhppa+N+Sg+Com+PxSg2	boastamáhpainat	pˈŏɑsː.tɑ#mˌɑːh.pɑj.nɑh
poastamáhppa+N+Sg+Com+PxSg3	boastamáhpainis	pˈŏɑsː.tɑ#mˌɑːh.pɑj.nis
poastamáhppa+N+Sg+Loc	boastamáhpas	pˈŏɑsː.tɑ#mˌɑːh.pɑs
poastamáhppa+N+Sg+Loc+PxDu1	boastamáhpasteame	pˈŏɑsː.tɑ#mˌɑːh.pɑs.tˌĕæ.me
poastamáhppa+N+Sg+Loc+PxDu2	boastamáhpasteatte	pˈŏɑsː.tɑ#mˌɑːh.pɑs.tˌĕæt.te
poastamáhppa+N+Sg+Loc+PxPl2	boastamáhpasteattet	pˈŏɑsː.tɑ#mˌɑːh.pɑs.tˌĕæt.teh
poastamáhppa+N+Ess+PxPl1	boastamáhppaneamet	pˈŏɑsː.tɑ#mˌɑhː.pɑ.nˌĕæ.meh
poastamáhppa+N+Sg+Gen+PxPl1	boastamáhppamet	pˈŏɑsː.tɑ#mˌɑhː.pɑ.meh
poastamáhppa+N+Sg+Ill+PxSg1	boastamáhppasan	pˈŏɑsː.tɑ#mˌɑhː.pɑ.sɑn
poastamáhppa+N+Sg+Nom+PxPl1	boastamáhppamet	pˈŏɑsː.tɑ#mˌɑhː.pɑ.meh
poastamáhppa+N+Der/viđá+Adv	boastamáhppaviđá	pˈŏɑsː.tɑ#mˌɑhː.pɑ»vˌi.ðɑː
poastamáhppa+N+Sg+Ill	boastamáhppii	pˈŏɑsː.tɑ#mˌɑhː.pij
pacificeret+V+TV+Ind+Prt+Du3	pacificeriiga	phˈɑ.tsi.fˌi.tse.rˌij.gɑ
pakeha+N+Pl+Acc+PxSg2	pakehaidat	phˈɑ.ke.hˌɑjː.tɑh
pelket+V+TV+Inf	pelket	phˈelə.hkeh
philosophicum+N+Sg+Nom	philosophicum	phˈi.lo.sˌop.hi.tsum
philosophicum+N+Pl+Gen+PxSg3	philosophicumaidis	phˈi.lo.sˌop.hi.tsˌu.mɑj.dis
philosophicum+N+Pl+Loc+PxSg1	philosophicumainan	phˈi.lo.sˌop.hi.tsˌu.mɑj.nɑn
philosophicum+N+Sg+Acc	philosophicuma	phˈi.lo.sˌop.hi.tsˌu.mɑ
philosophicum+N+Sg+Ill	philosophicumii	phˈi.lo.sˌop.hi.tsˌu.mij
piano+Adv	piano	phˈi.ɑ.no
piika+N+Der/viđá+Adv	piikaviđá	phˈijː.çkɑ»vˌi.ðɑː
pioneara+N+Der/viđá+Adv	pionearaviđá	phˈi.o.nˌeæ.rɑ»vˌi.ðɑː
pläderet+V+IV+Ind+Prt+Du3	pläderiiga	plˈæ.de.rˌijː.kɑ
pneumáhtalaš+A+Ess	pneumáhtalažžan	pnˈeu.mɑːh.tˌɑ.lɑdː.tʃɑn
pneumáhtalaš+A+Sg+Nom	pneumáhtalaš	pnˈeu.mɑːh.tˌɑ.lɑʃ
pneumáhtalaš+A+Sg+Ill	pneumáhtalažžii	pnˈeu.mɑːh.tˌɑ.lɑdː.tʃij
pointillisma+N+Ess	pointillisman	phˈojn.tilː.lˌisː.mɑn
polárajiehkki+N+Sg+Com+PxPl3	polárajihkiineaset	phˈo.lɑː.rɑ#jˌih.kij.nˌĕæ.seh
ponceret+V+TV+Ind+Prt+Pl2	ponceriidet	phˈonː.n̥tse.rˌijː.teh
pragmáhtalaš+A+Sg+Loc	pragmáhtalaččas	prˈɑg.mɑːh.tˌɑ.lɑt.tʃɑs
praktikántasadji+N+Ess	praktikántasadjin	prˈɑkː.hti.kˌɑːnː.n̥tɑ#sˌɑcː.cin
pseudonyma+N+Der/viđá+Adv	pseudonymaviđá	psˈeu.do.nˌy.mɑ»vˌi.ðɑː
pseudonyma+N+Sg+Ill	pseudonymii	psˈeu.do.nˌy.mij
psoriasisartritt+N+Sg+Ill	psoriasisartrittii	psˈo.ri.ˌɑ.sis#ˌɑrt.rit.tij
psykososiálalaš+A+Sg+Ill	psykososiálalažžii	psˈy.ko#sˌo.si.ˌɑː.lɑ.lˌɑdː.tʃij
pulvvar+N+Der/Dimin+N+Pl+Nom	pulvaraččat	phˈulə.vɑr»ˌɑt.tʃɑh
puritanisma+N+Der/viđá+Adv	puritanismaviđá	phˈu.ri.tˌɑ.nis.mɑ»vˌi.ðɑː
pusset+V+TV+Ger+PxDu2	pussedettiineatte	phˈus.se.ðˌet.tij.nˌĕæt.te
pyramidaspilla+G3+N+Sg+Ill	pyramidaspillii	phˈy.rɑ.mˌi.dɑ#spˌil.lij
pálla+N+Der/huhtti+V+TV+Ger	pálahuhtidin	phˈɑː.lɑ»hˌuh.ti.din
pálla+N+Der/laš+A+Attr	pálalaš	phˈɑː.lɑ»lɑʃ
pøŋka+N+Sg+Ill+PxDu1	pøŋkaseame	phˈøŋŋ.ŋ̊kɑ.sˌĕæ.me
pøŋka+N+Sg+Ill	pøŋkii	phˈøŋŋ.ŋ̊kij
pøŋka+N+Pl+Nom	pøŋkkat	phˈøŋŋ̊.kɑh
pøŋka+N+Sg+Loc+PxDu2	pøŋkkasteatte	phˈøŋŋ̊.kɑs.tˌĕæt.te
ruvdnaprinsa+N+Ess+PxSg3	kruvdnaprinsanis	krˈuβː.tnɑ#prˌinː.sɑ.nis
ruvdnaprinsa+N+Ess	kruvdnaprinsan	krˈuβː.tnɑ#prˌinː.sɑn
ruvdnaprinsa+N+Sg+Ill+PxSg2	kruvdnaprinsasat	krˈuβː.tnɑ#prˌinː.sɑ.sɑh
ruvdnaprinsa+N+Der/viđá+Adv	kruvdnaprinsaviđá	krˈuβː.tnɑ#prˌinː.sɑ»vˌi.ðɑː
ruvdnaprinsa+N+Sg+Ill	kruvdnaprinsii	krˈuβː.tnɑ#prˌinː.sij
ruvdnaprinsa+N+Pl+Nom	kruvdnaprinssat	krˈuβː.tnɑ#prˌins.sɑh
ruvdnaprinsa+N+Sg+Loc+PxSg3	kruvdnaprinssastis	krˈuβː.tnɑ#prˌins.sɑs.tis
ruvdnaprinsa+N+Der/huvva+V+IV+Pot+Prs+Sg3	kruvdnaprinssahuvaš	krˈuβː.tnɑ#prˌins.sɑ»hˌu.vɑʃ
ruvdnaprinsa+N+Sg+Acc+PxSg1	kruvnnaprinsan	krˈuβnː.nɑː#prˌinː.sɑn
ruvdnaprinsa+N+Sg+Ill+PxDu1	kruvnnaprinsaseame	krˈuβnː.nɑː#prˌinː.sɑ.sˌĕæ.me
ruvdnaprinsa+N+Der/viđá+Adv	kruvnnaprinsaviđá	krˈuβnː.nɑː#prˌinː.sɑ»vˌi.ðɑː
ruvdnaprinsa+N+Sg+Ill	kruvnnaprinsii	krˈuβnː.nɑː#prˌinː.sij
ruvdnaprinsa+N+Pl+Com	kruvnnaprinssaiguin	krˈuβnː.nɑː#prˌins.sɑj.gujn
ruvdnaprinsa+N+Pl+Ill+PxSg1	kruvnnaprinssaidasan	krˈuβnː.nɑː#prˌins.sɑj.dˌɑ.sɑn
ruvdnaprinsa+N+Pl+Nom+PxDu2	kruvnnaprinssaideatte	krˈuβnː.nɑː#prˌins.sɑj.dˌĕæt.te
ruvdnaprinsa+N+Pl+Nom+PxSg2	kruvnnaprinssaidat	krˈuβnː.nɑː#prˌins.sɑj.dɑh
ruvdnaprinsa+N+Sg+Gen+PxPl2	kruvnnaprinssadet	krˈuβnː.nɑː#prˌins.sɑ.deh
ruvdnaprinsa+N+Sg+Com+PxSg2	kruvnnaprinssainat	krˈuβnː.nɑː#prˌins.sɑj.nɑh
ruvdnaprinsa+N+Sg+Loc	kruvnnaprinssas	krˈuβnː.nɑː#prˌins.sɑs
ruvdnaprinsa+N+Sg+Loc+PxDu2	kruvnnaprinssasteatte	krˈuβnː.nɑː#prˌins.sɑs.tˌĕæt.te
ruvdnaprinsa+N+Sg+Loc+PxDu3	kruvnnaprinssasteaskka	krˈuβnː.nɑː#prˌins.sɑs.tˌeæs.kɑ
ruvdnaprinsa+N+Sg+Loc+PxSg2	kruvnnaprinssastat	krˈuβnː.nɑː#prˌins.sɑs.tɑh
radnet+V+TV+Der/PassL+V+IV+Actio+Com	radnejuvvomiin	rˈɑd.ne»jˌuv.vo.mijn
ramas+N+Sg+Gen	rapmasa	rˈɑpː.mɑː.sɑ
ravdat+V+IV+Der/stuvva+V+Ind+Prs+Sg1	ravddastuvan	rˈɑβtː.tɑː»stˌu.vɑn
ražžat+A+Superl+Attr	ražžadamos	rˈɑdː.tʃɑː.ðˌɑ.mos
rekonstrukšuvdna+N+Sg+Ill	rekonstrukšuvdnii	rˈeː.kon.strˌukː.ʃuv.tnij
reporttar+N+Sg+Acc+PxDu2	reportareatte	rˈeː.por.htˌɑ.rĕæt.te
ridda+N+Sg+Acc+PxDu2	rittade	rˈitː.tɑː.ðe
riktá+N+Pl+Loc+PxSg2	rivttáinat	rˈiβɸː.tɑːj.nɑh
rikča+N+Sg+Acc+PxSg2	rivččat	rˈiβɸː.tʃɑːh
rinzzas+A+Sg+Nom	rinzzas	rˈintː.tsɑːs
riđvái+A+Superl+Ess	riđvámussan	rˈiðə.vɑː.mˌus.sɑn
rohtiidit+V+TV+Imprt+ConNeg	rohtiit	rˈoːh.tijh
rohčat+A+AttrCmp+Der/máhtat+A+Der/vuohta+N+Sg+Ill	rohččesmáhtatvuhtii	rˈohː.tʃes»mˌɑːh.tɑh»vˌuh.tij
ronnet+N+Der/viđá+Adv	ronnetviđá	rˈon.neh»vˌi.ðɑː
rosvudit+V+TV+Der/meahttun+A+Sg+Acc	rosvutmeahttun	rˈos.vuh»mˌĕæhː.tun
rovvi+N+Sg+Loc+PxDu3	rovisteaskka	rˈoː.vis.tˌeæs.kɑ
rusá+A+Sg+Nom	rosá	rˈoː.sɑː
rusá+A+Der/at+Adv	rosát	rˈoː.sɑːh
ruccas+A+Comp+Sg+Nom	ruzzasit	rˈudː.tsɑː.sih
rugat+N+Der/huhtti+V+TV+Cond+Prs+Sg1	rugahuhtášedjen	rˈu.gɑː»hˌuhː.tɑː.ʃˌec.cen
rugat+N+Ess	ruhkan	rˈuhː.kɑːn
rujosmuvvat+V+IV+Der/ahtti+V+TV+Pot+Prs+ConNeg	rujosmuhteš	rˈuː.jos»mˌuh.teʃ
rumaš+N+Sg+Acc+PxPl3	rupmašeaset	rˈupː.mɑː.ʃˌĕæ.seh
ruobbut+V+IV+Der/NomAg+N+Sg+Ill	rubbui	rˈubː.pu»i
rytma+N+Sg+Ill	rytmii	rˈytː.mij
rytma+N+Sg+Com+PxPl1	rytmmaineamet	rˈytm.mɑj.nˌĕæ.meh
rytmihkka+N+Sg+Loc	rytmihkas	rˈytː.mih.kɑs
rytmihkka+N+Der/laš+A+Comp+Attr	rytmihkalat	rˈytː.mih.kɑ»lɑh
rádna+N+Pl+Acc+PxPl3	rátnaideaset	rˈɑːt.nɑj.dˌĕæ.seh
ráfuhit+V+TV+Der/meahttun+A+Ess	ráfutmeahttumin	rˈɑː.fuh»mˌĕæhː.tu.min
rámas+N+Pl+Nom	rápmasat	rˈɑːp.mɑ.sɑh
rápmi+N+Sg+Gen+PxSg3	rámis	rˈɑː.miːs
ráttas+A+Comp+Pl+Acc	ráddasabbuid	rˈɑːdː.tɑ.sˌɑbː.pujh
ráččas+A+Pl+Nom	rážžasat	rˈɑːdː.tʃɑ.sɑh
ráđus+A+Comp+Sg+Com	ráđđosabbuin	rˈɑːð.ðo.sˌɑbː.pujn
ráššu+N+Sg+Gen+PxDu2	rášode	rˈɑː.ʃo.ðe
røntgen+N+Der/viđá+Adv	røntgenviđá	rˈønt.gen»vˌi.ðɑː
røntgengovva+N+Sg+Ill	røntgengovvii	rˈønt.gen#kˌov.vij
røntgenossodat+N+Sg+Nom	røntgenossodat	rˈønt.gen#ˌos.so.dɑh
sahkat+V+IV+Ind+Prt+Sg3	sagai	sˈɑ.gɑːj
sakkamusat+Adv+Superl	sakkamusat	sˈɑkː.kɑː.mˌu.sɑh
schamponeret+V+TV+Der/PassL+V+IV+Ind+Prs+Sg1	schamponerejuvvon	stshˈɑmː.m̥po.nˌe.re»j»ˌuv.von
segmeanta+N+Der/viđá+Adv	segmeantaviđá	sˈeg.mĕænː.n̥tɑ»vˌi.ðɑː
shintoisma+N+Sg+Gen+PxDu2	shintoismmade	shˈinː.n̥tojsm.mˌɑ.de
shintoisma+N+Sg+Loc+PxDu1	shintoismmasteame	shˈinː.n̥tojsm.mˌɑsː.tĕæ.me
sjiisma+N+Sg+Nom+PxPl2	sjiismadet	sjˈi.is.mˌɑ.deh
sjåvinisma+N+Sg+Ill	sjåvinismii	sjˈoː.vi.nˌisː.mij
skierpmuhit+V+TV+Der/PassL+V+IV+Actio+Nom	skierpmuhuvvon	skˈierp.mu.hˌuv.von
skjeletteret+V+TV+Der/PassL+V+IV+Der/upmi+N+Sg+Ill	skjeletterejupmái	skjˈeː.let.tˌe.re»j»ˌup.mɑːj
skolas+A+Der/vuohta+N+Sg+Ill	skolasvuhtii	skˈo.lɑːs»vˌuh.tij
skovvi+N+Ess+PxPl1	skovvineamet	skˈov.vi.nˌĕæ.meh
skámuheapme+A+Ess	skámuheapmin	skˈɑː.mu.hˌeæp.min
sloveniagielat+A+Pl+Nom	sloveniagielagat	ʃlˈo.ve.nˌi.ɑ#kˌie.lɑ.gɑh
sloveniagielat+A+Der/vuohta+N+Sg+Ill	sloveniagielatvuhtii	ʃlˈo.ve.nˌi.ɑ#kˌie.lɑh»vˌuh.tij
slávalaš+A+Ess	slávalažžan	ʃlˈɑː.vɑ.lˌɑdː.tʃɑn
smiehca+N+Pl+Nom	smiezat	smˈie.dsɑh
smiđis+A+Sg+Nom	smiđis	smˈi.ðiːs
snárkkas+A+Comp+Der/Dimin+A+Attr	snárkasabboš	snˈɑːrə.hkɑ.sˌɑbː.po»ʃ
son+Pron+Pers+Du3+Nom	soai	sˈoɑj
spitnjut+V+IV+Imprt+Pl1	spidnjut	spˈid.ɲuːh
squash+N+Sg+Ill	squashii	skˈu.ɑs.hij
srukta+N+Pl+Nom	sruvttat	srˈuβɸː.tɑːh
srukta+N+Sg+Acc+PxSg3	sruvttas	srˈuβɸː.tɑːs
sráŋgavalljivuohta+N+Sg+Loc+PxDu1	sráŋgavalljivuođasteame	srˈɑːŋŋ.kɑ#vˌɑʎː.ʎi.vˌuo.ðɑs.tˌĕæ.me
stevvel+N+Der/viđá+Adv	stevvelviđá	stˈev.vel»vˌi.ðɑː
stežžet+V+TV+Ind+Prt+Pl2	stežžiidet	stˈedː.tʃij.deh
suahkásaš+A+Sg+Ill	suahkásažžii	sˈu#ˌɑh.kɑː.sˌɑdː.tʃij
sulla+N+Sg+Loc+PxSg1	sulastan	sˈu.lɑːs.tɑn
suokŋat+V+TV+Der/h+V+TV+VGen	suoŋat	sˈuo.ŋɑ»h
svennereive+N+Sg+Loc+PxSg3	svennereivvestis	svˈen.ne#rˌejv.ves.tis
sváinnas+N+Pl+Com+PxDu2	sváidnasiiddádeguin	svˈɑːj.tnɑ.sˌijtː.tɑː.dˌe.gujn
swingaeahket+N+Sg+Nom	swingaeahket	sβˈiŋŋ.kɑː#ˌĕæh.keh
swiŋga+N+Der/viđá+Adv	swiŋgaviđá	sβˈiŋŋ.kɑː»vˌi.ðɑː
swiŋŋaeahket+N+Ess	swiŋŋaeahkedin	sβˈiŋ.ŋɑː#ˌĕæh.ke.din
symptoma+N+Der/viđá+Adv	symptomaviđá	sˈymhp.to.mɑ»vˌi.ðɑː
synestesiija+N+Sg+Ill	synestesiijii	sˈy.nes.tˌe.sij.jij
sálaš+N+Ess	sálašin	sˈɑː.lɑ.ʃin
sánádeapmi+N+SgCmp+Der/viđá+Adv	sánádanviđá	sˈɑː.nɑːd»ˌɑn.vi.ðɑː
sássa+N+Der/huvva+V+IV+Ger+PxDu2	sásahuvadettiineatte	sˈɑː.sɑ»hˌu.vɑ.dˌet.tij.nˌĕæt.te
sŋiran+N+Ess	sŋiramin	sŋˈi.rɑː.min
sŋiran+N+Pl+Com+PxPl1	sŋiramiiddámetguin	sŋˈi.rɑː.mˌijtː.tɑː.mˌet.gujn
sŋiran+N+Sg+Nom	sŋiran	sŋˈi.rɑːn
show+N+Der/Dimin+N+Der/Dimin+N+Sg+Nom	šovažaš	ʃˈo.vɑː»dʃɑʃ
show+N+Der/heapmi+A+Comp+Sg+Nom	šovahut	ʃˈo.vɑː»huh
show+N+Der/heapmi+A+Ess	šovaheapmin	ʃˈo.vɑː»hˌeæp.min
show+N+Der/heapmi+A+Pl+Gen	šovahemiid	ʃˈo.vɑː»hˌe.mijh
show+N+Der/heapmi+A+Sg+Com	šovahemiin	ʃˈo.vɑː»hˌe.mijn
show+N+Der/heapmi+A+Attr+Der/vuohta+N+Sg+Ill	šovahisvuhtii	ʃˈo.vɑː»his»vˌuh.tij
show+N+Der/heapmi+A+Attr+Der/vuohta+N+Sg+Acc+PxSg3	šovahisvuođas	ʃˈo.vɑː»his»vˌuo.ðɑs
show+N+Der/huhtti+V+TV+VAbess+A+Attr	šovahuhtikeahtes	ʃˈo.vɑː»hˌuh.ti.kˌĕæh.tes
show+N+Der/huhtti+V+TV+VAbess	šovahuhtikeahttájin	ʃˈo.vɑː»hˌuh.ti.kˌĕæhː.tɑː.jin
show+N+Der/huhtti+V+TV+VGen	šovahuhti	ʃˈo.vɑː»hˌuhː.ti
show+N+Der/huvva+V+IV+Cond+Prs+Sg2	šovahuvašedjet	ʃˈo.vɑː»hˌu.vɑ.ʃˌec.ceh
show+N+Der/huvva+V+IV+VAbess	šovahuvahaga	ʃˈo.vɑː»hˌu.vɑ.hˌɑ.gɑ
show+N+Der/huvva+V+IV+ConNegII	šovahuvvo	ʃˈo.vɑː»hˌuv.vo
show+N+Sg+Nom	šovv	ʃˈovː
show+N+Ess+PxSg3	šovvanis	ʃˈovː.vɑː.nis
show+N+Pl+Com	šovvaiguin	ʃˈovː.vɑːj.gujn
show+N+Pl+Gen	šovvaid	ʃˈovː.vɑːjh
show+N+Sg+Ill	šovvii	ʃˈov.vij
takseret+V+TV+Ind+Prt+Sg3	takserii	thˈɑkː.se.rij
takteret+V+TV+Ind+Prt+Du3	takteriiga	thˈɑkː.hte.rˌijː.kɑ
taxeret+V+TV+Ger+PxDu1	taxeredettiineame	thˈɑks.e.rˌe.det.tˌij.nĕæ.me
teajat+N+Der/huvva+V+IV+VAbess	teajahuvahaga	thˈeæ.jɑ»hˌu.vɑ.hˌɑ.gɑ
teflonagásterola+N+Sg+Ill	teflonagásterolii	thˈe.flo.nɑ#kˌɑːsː.te.rˌo.lij
teipet+V+TV+Ind+Prt+Du1	teipiime	thˈejː.çpij.me
tempus+N+Pl+Loc+PxPl3	tempusiinniset	thˈemː.m̥pu.sˌijn.ni.seh
teáhterdoaibma+N+Sg+Loc	teáhterdoaimmas	thˈe.ɑːh.ter#tˌoɑjm.mɑs
thaigiella+N+Sg+Ill	thaigillii	thˈɑj#kˌil.lij
thomisma+N+Pl+Com	thomismmaiguin	thˈoː.mis.mˌɑjː.kujn
thomisma+N+Pl+Nom	thomismmat	thˈoː.mis.mɑh
thymusráksá+N+Der/viđá+Adv	thymusráksaviđá	thˈy.mus#rˌɑːkː.sɑ»vˌi.ðɑː
tibehtalaš+A+Ess	tibehtalažžan	thˈiː.beh.tˌɑ.lɑdː.tʃɑn
tibehtalaš+A+Der/vuohta+N+Sg+Ill	tibehtalašvuhtii	thˈiː.beh.tˌɑ.lɑʃ»vˌuh.tij
tibehtalaš+A+Der/vuohta+N+Sg+Loc+PxPl3	tibehtalašvuođasteaset	thˈiː.beh.tˌɑ.lɑʃ»vˌuo.ðɑs.tˌĕæ.seh
tienas+N+Sg+Nom	tienas	thˈie.nɑs
tiggedit+V+TV+Imprt+Sg2	tigget	thˈigː.keh
tituleret+V+TV+Der/PassL+V+IV+Actio+Nom	titulerejuvvon	thˈi.tu.lˌe.re»jˌuv.von
tiŋga+N+Ess+PxDu1	tiŋganeame	thˈiŋŋ.kɑː.nˌĕæ.me
tiŋga+N+Sg+Loc	tiŋggas	thˈiŋk.kɑːs
toassa+N+Sg+Ill	tossii	thˈos.sij
toavva+N+Der/viđá+Adv	toavvaviđá	thˈoɑv.vɑ»vˌi.ðɑː
toffaseabbo+A+Comp+Attr	toffas	thˈof.fɑːs
toffaseabbo+A+Superl+Der/at+Adv	toffasamosit	thˈof.fɑː.sˌɑ.mo.sih
tohppa+N+Sg+Acc+PxSg2	tohpat	thˈohː.pɑːh
toija+N+Sg+Com+PxPl2	toijaineattet	thˈoj.jɑːj.nˌĕæt.teh
tolereret+V+TV+Ind+Prt+Pl1	tolereriimet	thˈo.le.rˌe.rij.meh
toppláhka+N+Sg+Acc+PxSg2	topplágat	thˈopː#lˌɑː.gɑh
torve+N+Der/viđá+Adv	torveviđá	thˈorə.ve»vˌi.ðɑː
transistor+N+Der/viđá+Adv	transistorviđá	trˈɑnː.sis.tor»vˌi.ðɑː
triáŋgel+N+Der/Dimin+N+Sg+Nom	triáŋgelaš	trˈi.ɑːŋ.gel»ɑʃ
troandinlaš+N+Pl+Nom	troandinlaččat	trˈŏɑnː.tin.lˌɑt.tʃɑh
tsara+N+Pl+Nom+PxDu2	tsaraideatte	tsˈɑ.rɑːj.dˌĕæt.te
tsara+N+Der/viđá+Adv	tsaraviđá	tsˈɑ.rɑː»vˌi.ðɑː
tuberkuliidna+N+Sg+Acc+PxPl1	tuberkuliidnamet	thˈuː.ber.hkˌu.lij.tnˌɑ.meh
turtilduvvá+N+Pl+Acc+PxPl2	turtilduvváideattet	thˈurə.htil#tˌuvː.vɑːj.dˌĕæt.teh
tyatiralaš+N+Sg+Loc+PxDu1	tyatiralaččasteame	thˈy.ɑ.tˌi.rɑ.lˌɑt.tʃɑs.tĕæ.me
typiseret+V+TV+Ind+Prt+Pl1	typiseriimet	thˈy.pi.sˌe.rij.meh
tyránna+N+Pl+Com+PxSg1	tyránnaidanguin	thˈy.rɑːn.nˌɑjː.tɑn.gujn
táhpa+N+Der/viđá+Adv	táhpaviđá	thˈɑːh.pɑ»vˌi.ðɑː
táiga+N+Pl+Com	táigaiguin	thˈɑːjː.kɑj.gujn
táiga+N+Sg+Nom+PxSg1	táigan	thˈɑːjː.kɑn
tálla+N+Sg+Com+PxPl2	tálaineattet	thˈɑː.lɑj.nˌĕæt.teh
tásku+N+Sg+Gen+PxPl1	táskomet	thˈɑːsː.ko.meh
táŋggat+N+Der/Dimin+N+Pl+Loc	táŋggažiin	thˈɑːŋk.kɑ»dʃijn
tøffa+A+Pl+Ill	tøffaide	thˈøf.fɑj.de
tøffa+A+Sg+Acc	tøffa	thˈøf.fɑ
tøffa+A+Sg+Ill	tøffii	thˈøf.fij
ubmesápmelaš+N+Pl+Nom	ubmesápmelaččat	ˈub.me#sˌɑːp.me.lˌɑt.tʃɑh
udnu+N+Pl+Ill	utnuide	ˈut.nuj.de
udnu+N+Sg+Com+PxDu2	utnuineatte	ˈut.nuj.nˌĕæt.te
ugralaš+A+Sg+Nom	ugralaš	ˈug.rɑː.lɑʃ
ugralaš+A+Der/vuohta+N+Sg+Ill	ugralašvuhtii	ˈug.rɑː.lɑʃ»vˌuh.tij
uhccut+V+IV+Der/h+V+TV+VAbess	uhcutkeahttájin	ˈuh.tsu»h#khˌĕæhː.tɑː.jin
uhcánaš+A+Sg+Ill	uhcánažžii	ˈuhː.tsɑː.nˌɑdː.tʃij
uitu+N+Sg+Acc+PxPl2	uittodet	ˈujç.to.ðeh
ujostallat+V+IV+Der/PassS+V+IV+Ind+Prt+Sg3	ujostallui	ˈuː.jos.tˌɑl.lu»i
ujošit+V+TV+Pot+Prs+Pl3	ujošežžet	ˈu.jo.ʃˌedː.tʃeh
ujusvuohta+N+Sg+Ill	ujusvuhtii	ˈuː.jus.vˌuh.tij
uksu+N+Der/laš+A+Superl+Ess	uvssoleamosin	ˈuβs.so»lˌĕæ.mo.sin
umassi+A+Pl+Acc	umassiid	ˈu.mɑːs.sijh
unjárgalaš+N+Pl+Nom	unjárgalaččat	ˈu.ɲɑːr.gˌɑ.lɑt.tʃɑh
unjárgalaš+N+Sg+Ill	unjárgalažžii	ˈu.ɲɑːr.gˌɑ.lɑdː.tʃij
urra+N+Pl+Ill+PxSg3	uraidasas	ˈu.rɑːj.dˌɑ.sɑs
urra+N+Der/heapmi+A+Sg+Com	urahemiin	ˈu.rɑː»hˌe.mijn
urra+N+Der/huhtti+V+TV+Ind+Prs+Sg1	urahuhtán	ˈu.rɑː»hˌuhː.tɑːn
urra+N+Sg+Ill	urrii	ˈur.rij
utkka+N+Der/heapmi+A+Sg+Com	utkkahemiin	ˈutk.kɑː»hˌe.mijn
utnolaš+A+AttrCmp+Der/lágaš+A+Ess	utnolašlágažin	ˈut.no.lɑʃ»lˌɑː.gɑ.dʃin
uuuuh+Interj	uuuuh	ˈuːuːh
uvrrus+N+Sg+Com+PxPl3	uvrosiinniset	ˈuβː.ro.sˌijn.ni.seh
uđas+N+Ess	uđasin	ˈu.ðɑː.sin
uđas+N+Der/geahtes+A+Attr	uđaskeahtes	ˈu.ðɑːs»kˌĕæh.tes
uđas+N+Der/laš+A+Ess	uđaslažžan	ˈu.ðɑːs»lˌɑdː.tʃɑn
uđasohcanbeana+N+Pl+Nom	uđasohcanbeatnagat	ˈu.ðɑːs#ˌoh.tsɑn#pˌeæt.nɑ.gɑh
uŋggar+N+Pl+Nom	uŋgarat	ˈuŋŋ.kɑː.rɑh
uŋggar+N+Sg+Ill	uŋgarii	ˈuŋŋ.kɑː.rij
uš+Interj	uš	ˈuʃ
váikkuhangaskoapmegeavaheapmi+N+Pl+Gen+PxDu3	gaskgaskaoapmegeavahemiideaskka	kˈɑsk#kˌɑsː.kɑ#ˌŏɑp.me#kˌeæ.vɑ.hˌe.mij.dˌeæs.kɑ
váikkuhangaskoapmegeavaheapmi+N+Pl+Loc	gaskgaskaoapmegeavahemiin	kˈɑsk#kˌɑsː.kɑ#ˌŏɑp.me#kˌeæ.vɑ.hˌe.mijn
váikkuhangaskoapmegeavaheapmi+N+Pl+Nom+PxDu1	gaskgaskaoapmegeavahemiideame	kˈɑsk#kˌɑsː.kɑ#ˌŏɑp.me#kˌeæ.vɑ.hˌe.mij.dˌĕæ.me
váikkuhangaskoapmegeavaheapmi+N+Pl+Nom+PxPl1	gaskgaskaoapmegeavahemiideamet	kˈɑsk#kˌɑsː.kɑ#ˌŏɑp.me#kˌeæ.vɑ.hˌe.mij.dˌĕæ.meh
váikkuhangaskoapmegeavaheapmi+N+Sg+Com+PxDu3	gaskgaskaoapmegeavahemiineaskka	kˈɑsk#kˌɑsː.kɑ#ˌŏɑp.me#kˌeæ.vɑ.hˌe.mij.nˌeæs.kɑ
váikkuhangaskoapmegeavaheapmi+N+Sg+Com+PxSg3	gaskgaskaoapmegeavahemiinis	kˈɑsk#kˌɑsː.kɑ#ˌŏɑp.me#kˌeæ.vɑ.hˌe.mij.nis
váikkuhangaskoapmegeavaheapmi+N+Sg+Acc+PxDu3	gaskgaskaoapmegeavaheamiska	kˈɑsk#kˌɑsː.kɑ#ˌŏɑp.me#kˌeæ.vɑ.hˌeæ.mis.kɑ
váikkuhangaskoapmegeavaheapmi+N+Sg+Nom+PxDu3	gaskgaskaoapmegeavaheapmiska	kˈɑsk#kˌɑsː.kɑ#ˌŏɑp.me#kˌeæ.vɑ.hˌeæp.mis.kɑ
váikkuhangaskoapmegeavaheapmi+N+Sg+Nom+PxSg3	gaskgaskaoapmegeavaheapmis	kˈɑsk#kˌɑsː.kɑ#ˌŏɑp.me#kˌeæ.vɑ.hˌeæp.mis
váikkuhangaskoapmegeavaheapmi+N+Sg+Acc+PxSg2	gaskgaskaoapmegeavaheamát	kˈɑsk#kˌɑsː.kɑ#ˌŏɑp.me#kˌeæ.vɑ.hˌeæ.mɑːh
váikkuhangaskoapmegeavaheapmi+N+Sg+Ill+PxDu3	gaskgaskaoapmegeavaheapmáseaskka	kˈɑsk#kˌɑsː.kɑ#ˌŏɑp.me#kˌeæ.vɑ.hˌeæp.mɑː.sˌeæs.kɑ
váikkuhangaskoapmegeavaheapmi+N+SgCmp+Der/viđá+Adv	gaskgaskaoapmegeavahanviđá	kˈɑsk#kˌɑsː.kɑ#ˌŏɑp.me#kˌeæ.vɑh»ˌɑn.vi.ðɑː
váikkuhangask'oapmegeavaheapmi+N+Pl+Nom+PxDu1	gask'gaskaoapmegeavahemiideame	kˈɑsk'#kˌɑsː.kɑ#ˌŏɑp.me#kˌeæ.vɑ.hˌe.mij.dˌĕæ.me
váikkuhangask'oapmegeavaheapmi+N+Sg+Com+PxDu1	gask'gaskaoapmegeavahemiineame	kˈɑsk'#kˌɑsː.kɑ#ˌŏɑp.me#kˌeæ.vɑ.hˌe.mij.nˌĕæ.me
váikkuhangask'oapmegeavaheapmi+N+Sg+Com+PxDu2	gask'gaskaoapmegeavahemiineatte	kˈɑsk'#kˌɑsː.kɑ#ˌŏɑp.me#kˌeæ.vɑ.hˌe.mij.nˌĕæt.te
váikkuhangask'oapmegeavaheapmi+N+Sg+Com+PxSg3	gask'gaskaoapmegeavahemiinis	kˈɑsk'#kˌɑsː.kɑ#ˌŏɑp.me#kˌeæ.vɑ.hˌe.mij.nis
váikkuhangask'oapmegeavaheapmi+N+Ess+PxPl2	gask'gaskaoapmegeavaheapmineattet	kˈɑsk'#kˌɑsː.kɑ#ˌŏɑp.me#kˌeæ.vɑ.hˌeæp.mi.nˌĕæt.teh
váikkuhangask'oapmegeavaheapmi+N+Ess+PxSg2	gask'gaskaoapmegeavaheapminat	kˈɑsk'#kˌɑsː.kɑ#ˌŏɑp.me#kˌeæ.vɑ.hˌeæp.mi.nɑh
váikkuhangask'oapmegeavaheapmi+N+Pl+Nom	gask'gaskaoapmegeavaheamit	kˈɑsk'#kˌɑsː.kɑ#ˌŏɑp.me#kˌeæ.vɑ.hˌeæ.mih
váikkuhangask'oapmegeavaheapmi+N+Sg+Acc	gask'gaskaoapmegeavaheami	kˈɑsk'#kˌɑsː.kɑ#ˌŏɑp.me#kˌeæ.vɑ.hˌeæ.mi
váikkuhangask'oapmegeavaheapmi+N+Sg+Loc	gask'gaskaoapmegeavaheames	kˈɑsk'#kˌɑsː.kɑ#ˌŏɑp.me#kˌeæ.vɑ.hˌĕæ.mes
váikkuhangask'oapmegeavaheapmi+N+Sg+Nom	gask'gaskaoapmegeavaheapmi	kˈɑsk'#kˌɑsː.kɑ#ˌŏɑp.me#kˌeæ.vɑ.hˌeæp.mi
váikkuhangask'oapmegeavaheapmi+N+Sg+Acc+PxPl2	gask'gaskaoapmegeavaheamádet	kˈɑsk'#kˌɑsː.kɑ#ˌŏɑp.me#kˌeæ.vɑ.hˌeæ.mɑː.deh
váikkuhangask'oapmegeavaheapmi+N+SgCmp+Der/viđá+Adv	gask'gaskaoapmegeavahanviđá	kˈɑsk'#kˌɑsː.kɑ#ˌŏɑp.me#kˌeæ.vɑh»ˌɑn.vi.ðɑː
vajus+N+Pl+Acc+PxDu1	vadjosiiddáme	vˈɑc.co.sˌijtː.tɑː.me
vakŋut+V+IV+Der/stuvva+V+Cond+Prs+Sg3	vaŋostuvalii	vˈɑ.ŋo»stˌu.vɑ.lij
vaksit+V+TV+Ind+Prs+ConNeg	vavsse	vˈɑβs.se
valjus+N+Der/viđá+Adv	valjusviđá	vˈɑʎ.ʎus»vˌi.ðɑː
valas+N+Sg+Ill	vallasii	vˈɑlː.lɑː.sij
vazadat+N+Sg+Ill+PxPl2	vazadahkaseattet	vˈɑ.dsɑː.ðˌɑh.kɑ.sˌĕæt.teh
vebba+N+Sg+Ill	vebbii	vˈebː.pij
vebba+N+Der/huhtti+V+TV+Sup	veppahuhtážit	vˈepː.pɑː»hˌuhː.tɑː.dʃih
vegetarisma+N+Der/viđá+Adv	vegetarismaviđá	vˈe.ge.tˌɑ.ris.mɑ»vˌi.ðɑː
veiggodit+Der/PassL+V+IV+Ind+Prt+Sg3	veiggoduvvui	vˈejk.kod»ˌuv.vuj
veliidna+N+Pl+Nom	veliinnat	vˈeː.lijn.nɑh
veđor+N+Der/geahtes+A+Attr	veđorgeahtes	vˈeː.ðor»gˌĕæh.tes
viežžat+V+TV+Imprt+Pl2	vižžet	vˈidː.tʃeh
viežžat+V+TV+Imprt+Du2	viežži	vˈiedː.tʃiː
vihttu+N+Sg+Nom	vihttu	vˈihː.tuː
vomeret+V+TV+Cond+Prs+Sg3	vomerelii	vˈo.me.rˌe.lij
votum+N+Ess	votumin	vˈo.tu.min
vovdnet+V+TV+Ind+Prt+Du3	vovdniiga	vˈoβː.tnij.gɑ
vuhččot+V+IV+Ind+Prt+Du2	vuhččuide	vˈuhː.tʃuj.de
vuktii+A+Sg+Acc	vukte	vˈukː.hte
vustolat+N+Sg+Loc+PxPl1	vustolagasteamet	vˈusː.to.lˌɑ.gɑs.tˌĕæ.meh
vuvdot+V+IV+Ind+Prs+Sg1	vuvdon	vˈuβː.ton
várra+N+Sg+Gen+PxPl2	váradet	vˈɑː.rɑ.ðeh
vássu+N+Pl+Nom	vásut	vˈɑː.suːh
váđas+N+Sg+Ill+PxSg3	váhtasasas	vˈɑːh.tɑ.sˌɑ.sɑs
váža+N+Pl+Nom	váhčamat	vˈɑːh.tʃɑ.mɑh
wagnerianisma+N+Sg+Acc+PxPl1	wagnerianismamet	βˈɑg.ne.rˌi.ɑ.nˌis.mɑ.meh
wagnerianisma+N+Der/viđá+Adv	wagnerianismaviđá	βˈɑg.ne.rˌi.ɑ.nˌis.mɑ»vˌi.ðɑː
wagnerianisma+N+Sg+Ill	wagnerianismii	βˈɑg.ne.rˌi.ɑ.nˌis.mij
wagnerianisma+N+Pl+Gen+PxSg3	wagnerianismmaidis	βˈɑg.ne.rˌi.ɑ.nˌis.mɑj.dis
wagnerianisma+N+Pl+Loc+PxPl3	wagnerianismmaineaset	βˈɑg.ne.rˌi.ɑ.nˌis.mɑj.nĕæ.seh
wagnerianisma+N+Sg+Loc	wagnerianismmas	βˈɑg.ne.rˌi.ɑ.nˌis.mɑs
wagnerianisma+N+Sg+Loc+PxDu3	wagnerianismmasteaskka	βˈɑg.ne.rˌi.ɑ.nˌis.mɑs.teæs.kɑ
webbáiki+N+Sg+Nom	webbáiki	βˈeb#pˌɑːjː.çki
webdoaimmaheaddji+N+NomAg+Sg+Com+PxDu3	webdoaimmaheddjiineaskka	βˈeb.doɑjm.mˌɑ.heɟː.cˌij.neæs.kɑ
webgálvu+N+Der/viđá+Adv	webgálvoviđá	βˈeb#kˌɑːlə.vo»vˌi.ðɑː
webgálvu+N+Sg+Gen+PxSg3	webgálvvus	βˈeb#kˌɑːlv.vus
webgálvu+N+Der/huhtti+V+TV+Pot+Prs+Pl2	webgálvvuhuhtežehpet	βˈeb#kˌɑːlv.vu»hˌuh.te.dʃˌeh.peh
weblogan+N+Der/viđá+Adv	webloganviđá	βˈeb#lˌo.gɑn»vˌi.ðɑː
websiidu+N+Sg+Acc+PxDu1	websiidome	βˈeb#sˌijː.to.me
websiidu+N+Der/Dimin+N+Sg+Ill	websiiddožii	βˈeb#sˌijt.to»dʃij
whiskey+N+Ess+PxPl1	whiskeyneamet	βhˈisː.ke.ˌy.nĕæ.meh
whiskey+N+Ess+PxPl3	whiskeyneaset	βhˈisː.ke.ˌy.nĕæ.seh
whiskey+N+Pl+Loc+PxSg3	whiskeyinis	βhˈisː.ke.ˌyj.nis
whiskey+N+Pl+Nom+PxSg1	whiskeyidan	βhˈisː.ke.ˌyjː.tɑn
whiskey+N+Pl+Nom	whiskeyt	βhˈisː.ke.yh
whiskey+N+Sg+Acc+PxSg1	whiskeyn	βhˈisː.ke.yn
whiskey+N+Sg+Nom+PxSg2	whiskeyt	βhˈisː.ke.yh
wienergáhkku+N+Pl+Gen+PxPl2	wienergáhkuideattet	βˈĭe.ner#kˌɑːh.kuj.dˌĕæt.teh
wienergáhkku+N+Pl+Loc+PxDu2	wienergáhkuineatte	βˈĭe.ner#kˌɑːh.kuj.nˌĕæt.te
wienergáhkku+N+Sg+Acc+PxPl3	wienergáhkuset	βˈĭe.ner#kˌɑːh.ku.seh
wienergáhkku+N+Sg+Ill+PxDu1	wienergáhkkoseame	βˈĭe.ner#kˌɑhː.ko.sˌĕæ.me
wienerklassisisma+N+Der/viđá+Adv	wienerklassisismaviđá	βˈĭe.ner#klˌɑs.si.sˌisː.mɑ»vˌi.ðɑː
wienerklassisisma+N+Sg+Ill	wienerklassisismii	βˈĭe.ner#klˌɑs.si.sˌisː.mij
wienerklassisisma+N+Sg+Gen+PxDu2	wienerklassisismmade	βˈĭe.ner#klˌɑs.si.sˌis.mɑ.de
wienerválsa+N+Der/viđá+Adv	wienerválsaviđá	βˈĭe.ner#vˌɑːlə.sɑ»vˌi.ðɑː
woaw+Interj	woaw	βˈoɑβ
wobbler+N+Sg+Nom+PxSg2	wobblerat	βˈobː.le.rɑh
wobbler+N+Der/viđá+Adv	wobblerviđá	βˈobː.ler»vˌi.ðɑː
wokket+V+TV+Der/PassL+V+IV+Imprt+Sg2	wokkejuvvo	βˈok.ke»j»ˌuv.vo
worldcup+N+Sg+Nom	worldcup	βˈorld#tsup
wátta+N+Pl+Nom+PxSg3	wáttaidis	βˈɑːt.tɑj.dis
wátta+N+Der/viđá+Adv	wáttaviđá	βˈɑːt.tɑ»vˌi.ðɑː
wátta+N+Sg+Ill	wáttii	βˈɑːt.tij
xantoma+N+Pl+Gen	xantomaid	ks.ɑnː.n̥to.mɑjh
xantoma+N+Pl+Loc+PxSg2	xantomainat	ks.ɑnː.n̥to.mɑj.nɑh
xantoma+N+Sg+Com+PxPl1	xantomaineamet	ks.ɑnː.n̥to.mɑj.nĕæ.meh
xantoma+N+Der/huvva+V+IV+VAbess+A+Attr	xantomahuvakeahtes	ks.ɑnː.n̥to.mɑ»hˌu.vɑ.kˌĕæh.tes
xantoma+N+Der/viđá+Adv	xantomaviđá	ks.ɑnː.n̥to.mɑ»vˌi.ðɑː
xantoma+N+Sg+Ill	xantomii	ks.ɑnː.n̥to.mij
xerograferet+V+TV+Ind+Prt+Du3	xerograferiiga	ks.e.ro.grɑ.fe.rij.gɑ
xerografiija+N+Ess+PxSg2	xerografiijanat	ks.e.ro.grɑ.fij.jɑ.nɑh
xerografiija+N+Sg+Com+PxSg1	xerografiijainan	ks.e.ro.grɑ.fij.jɑj.nɑn
xerografiija+N+Sg+Ill	xerografiijii	ks.e.ro.grɑ.fij.jij
xerográfa+N+Pl+Loc	xerográfain	ks.e.ro.grɑː.fɑjn
xerográfa+N+Sg+Ill+PxPl2	xerográfaseattet	ks.e.ro.grɑː.fɑ.sĕæt.teh
xerográfa+N+Der/huhtti+V+TV+VAbess+A+Attr	xerográfahuhtikeahtes	ks.e.ro.grɑː.fɑ»hˌuh.ti.kˌĕæh.tes
xerográfa+N+Sg+Ill	xerográfii	ks.e.ro.grɑː.fij
xylograferet+V+TV+Pot+Prs+Sg3	xylografereš	ks.y.lo.grɑ.fe.reʃ
xylograferet+V+TV+Sup	xylograferežit	ks.y.lo.grɑ.fe.re.dʃih
xylograferet+V+TV+Der/PassL+V+IV+Actio+Nom	xylograferejuvvon	ks.y.lo.grɑ.fe.re»jˌuv.von
xylograferet+V+TV+Der/PassL+V+IV+Der/upmi+N+Sg+Acc+PxPl1	xylograferejupmámet	ks.y.lo.grɑ.fe.re»j»ˌup.mɑː.meh
xylograferet+V+TV+Ind+Prt+Du2	xylograferiide	ks.y.lo.grɑ.fe.rij.de
xylograferet+V+TV+Ind+Prt+Pl1	xylograferiimet	ks.y.lo.grɑ.fe.rij.meh
xylografiija+N+Ess+PxPl2	xylografiijaneattet	ks.y.lo.grɑ.fij.jɑ.nĕæt.teh
xylografiija+N+Sg+Loc+PxPl2	xylografiijasteattet	ks.y.lo.grɑ.fij.jɑs.tĕæt.teh
xylografiija+N+Sg+Ill	xylografiijii	ks.y.lo.grɑ.fij.jij
yeh+Interj	yeh	ˈyeh
yena+N+Pl+Com	yenaiguin	ˈye.nɑj.gujn
yena+N+Sg+Ill	yenii	ˈye.nij
yoghurt+N+Pl+Nom	yoghurtat	ˈyog.hur.htɑh
yoghurt+N+Sg+Acc+PxPl1	yoghurteamet	ˈyog.hur.htˌĕæ.meh
yoghurt+N+Sg+Gen	yoghurta	ˈyog.hur.htɑ
yoghurt+N+Sg+Ill+PxSg3	yoghurtasas	ˈyog.hur.htˌɑ.sɑs
yoghurt+N+Sg+Ill	yoghurtii	ˈyog.hur.htij
yoghurt+N+Der/Dimin+N+Der/Dimin+N+Der/viđá+Adv	yoghurtaččašviđá	ˈyog.hurh»ˌɑt.tʃɑ»ʃ»vˌi.ðɑː
yoghurt+N+Der/Dimin+N+Sg+Gen+PxSg2	yoghurtaččat	ˈyog.hurh»ˌɑt.tʃɑh
yoghurt+N+Der/viđá+Adv	yoghurtviđá	ˈyog.hurh»vˌi.ðɑː
yupikgielat+A+Sg+Gen	yupikgielaga	ˈyu.pik#kˌie.lɑ.gɑ
yup’ik+N+Sg+Nom	yup’ik	ˈyup’ik
yup’ik+N+Ess+PxDu2	yup’ikaneatte	ˈyup’i.kɑ.nĕæt.te
yup’ik+N+Sg+Ill	yup’ikii	ˈyup’i.kij
yurta+N+Der/viđá+Adv	yurtaviđá	ˈyurə.htɑ»vˌi.ðɑː
yurta+N+Sg+Ill	yurtii	ˈyurə.htij
yurtadealtá+N+Ess	yurtadealtán	ˈyurə.htɑ#tˌĕælː.l̥tɑːn
yurtadealtá+N+Pl+Com+PxPl3	yurtadealttáideasetguin	ˈyurə.htɑ#tˌeæll̥.tɑːj.dˌĕæ.set.gujn
yurtatealtá+N+Sg+Gen+PxSg2	yurtatealttát	ˈyurə.htɑ#thˌeæll̥.tɑːh
yurtatealtá+N+Sg+Com+PxPl1	yurtatealttáineamet	ˈyurə.htɑ#thˌeæll̥.tɑːj.nˌĕæ.meh
yurta+N+Sg+Loc	yurttas	ˈyurr̥.tɑs
zapatista+N+Ess	zapatistan	zˈɑ.pɑː.tˌisː.tɑn
zapatista+N+Sg+Ill+PxSg1	zapatistasan	zˈɑ.pɑː.tˌisː.tɑ.sɑn
zapatista+N+Der/viđá+Adv	zapatistaviđá	zˈɑ.pɑː.tˌisː.tɑ»vˌi.ðɑː
zapatista+N+Sg+Ill	zapatistii	zˈɑ.pɑː.tˌisː.tij
zapatistaveahka+N+Sg+Ill	zapatistavehkii	zˈɑ.pɑː.tˌisː.tɑ#vˌeh.kij
zapatistaveahka+N+Der/viđá+Adv	zapatistaveahkaviđá	zˈɑ.pɑː.tˌisː.tɑ#vˌeæh.kɑ»vˌi.ðɑː
zapatista+N+Pl+Nom	zapatisttat	zˈɑ.pɑː.tˌis.tɑh
zenbuddhisma+N+Der/viđá+Adv	zenbuddhismaviđá	zˈen#pˌud.dhis.mɑ»vˌi.ðɑː
zenbuddhisma+N+Sg+Ill	zenbuddhismii	zˈen#pˌud.dhis.mij
zenbuddhisma+N+Sg+Loc+PxPl2	zenbuddhismmasteattet	zˈen#pˌud.dhis.mˌɑsː.tĕæt.teh
zenbuddhista+N+Sg+Ill	zenbuddhistii	zˈen#pˌud.dhis.tij
zenbuddhista+N+Pl+Nom+PxSg3	zenbuddhisttaidis	zˈen#pˌud.dhis.tˌɑjː.tis
zoologa+N+Pl+Com+PxDu2	zoologaideatteguin	zˈo.o.lˌo.gɑj.dˌĕæt.te.gujn
zoologa+N+Der/viđá+Adv	zoologaviđá	zˈo.o.lˌo.gɑ»vˌi.ðɑː
zoologa+N+Sg+Ill	zoologii	zˈo.o.lˌo.gij
zoologiija+N+Pl+Loc+PxPl1	zoologiijaineamet	zˈo.o.lˌo.gij.jˌɑj.nĕæ.meh
zoologiija+N+Pl+Loc+PxSg3	zoologiijainis	zˈo.o.lˌo.gij.jˌɑj.nis
zoologiija+N+Sg+Loc+PxDu2	zoologiijasteatte	zˈo.o.lˌo.gij.jˌɑs.tĕæt.te
zoologiija+N+Sg+Ill	zoologiijii	zˈo.o.lˌo.gij.jij
Ándenbeaivahkku+N+Sg+Acc+PxPl2	Ándenbeaivahkodet	ˈɑːnː.ten#peæj#vˌɑh.ko.deh
Ándenbeaivahkku+N+Sg+Gen+PxDu2	Ándenbeaivahkode	ˈɑːnː.ten#peæj#vˌɑh.ko.de
Ándenbeaivahkku+N+Sg+Gen+PxPl2	Ándenbeaivahkodet	ˈɑːnː.ten#peæj#vˌɑh.ko.deh
Ándenbeaivahkku+N+Der/Dimin+N+Der/viđá+Adv	Ándenbeaivahkošviđá	ˈɑːnː.ten#peæj#vˌɑh.ko»ʃ»vˌi.ðɑː
Ándenbeaivahkku+N+Der/Dimin+N+Pl+Nom	Ándenbeaivahkožat	ˈɑːnː.ten#peæj#vˌɑh.ko»dʃɑh
Ándenbeaivahkku+N+Der/Dimin+N+Sg+Acc+PxPl1	Ándenbeaivahkožeamet	ˈɑːnː.ten#peæj#vˌɑh.ko»dʃˌĕæ.meh
Ándenbeaivahkku+N+Der/laš+A+Ess	Ándenbeaivahkolažžan	ˈɑːnː.ten#peæj#vˌɑh.ko»lˌɑdː.tʃɑn
Ándenbeaivahkku+N+Der/laš+A+Superl+Sg+Nom	Ándenbeaivahkoleamos	ˈɑːnː.ten#peæj#vˌɑh.ko»lˌĕæ.mos
Ándenbeaivahkku+N+Der/laš+A+Superl+Sg+Ill	Ándenbeaivahkolaččamussii	ˈɑːnː.ten#peæj#vˌɑh.ko»lˌɑt.tʃɑ.mˌus.sij
Ándenbeaivahkku+N+Der/laš+A+Sg+Nom	Ándenbeaivahkolaš	ˈɑːnː.ten#peæj#vˌɑh.ko»lɑʃ
Ándenbeaivahkku+N+Sg+Gen+PxPl3	Ándenbeaivahkuset	ˈɑːnː.ten#peæj#vˌɑh.ku.seh
Ándenbeaivahkku+N+Sg+Com+PxSg2	Ándenbeaivahkuinat	ˈɑːnː.ten#peæj#vˌɑh.kuj.nɑh
Ándenbeaivahkku+N+Sg+Com+PxSg3	Ándenbeaivahkuinis	ˈɑːnː.ten#peæj#vˌɑh.kuj.nis
Ándenbeaivahkku+N+Sg+Loc	Ándenbeaivahkus	ˈɑːnː.ten#peæj#vˌɑhː.kus
Ándenbeaivahkku+N+Sg+Loc+PxDu1	Ándenbeaivahkusteame	ˈɑːnː.ten#peæj#vˌɑhː.kus.tˌĕæ.me
Ándenbeaivahkku+N+Der/heapmi+A+Comp+Attr	Ándenbeaivahkuhut	ˈɑːnː.ten#peæj#vˌɑh.ku»huh
Ándenbeaivahkku+N+Der/heapmi+A+Attr	Ándenbeaivahkuhis	ˈɑːnː.ten#peæj#vˌɑh.ku»his
Ándenbeaivahkku+N+Sg+Nom+PxDu1	Ándenbeaivahkkome	ˈɑːnː.ten#peæj#vˌɑhː.ko.me
Ándenbeaivahkku+N+Der/Dimin+N+Der/viđá+Adv	Ándenbeaivahkkošviđá	ˈɑːnː.ten#peæj#vˌɑhː.ko»ʃ»vˌi.ðɑː
Ándenbeaivahkku+N+Der/huhtti+V+TV+Imprt+Sg2	Ándenbeaivahkkohuhte	ˈɑːnː.ten#peæj#vˌɑhː.ko»hˌuh.te
Ándenbeaivahkku+N+Der/huhtti+V+TV+Ind+Prt+Du2	Ándenbeaivahkkohuhtiide	ˈɑːnː.ten#peæj#vˌɑhː.ko»hˌuh.tij.de
Ándenbeaivahkku+N+Der/viđá+Adv	Ándenbeaivahkkoviđá	ˈɑːnː.ten#peæj#vˌɑhː.ko»vˌi.ðɑː
Ándenbeaivahkku+N+Pl+Nom	Ándenbeaivahkkut	ˈɑːnː.ten#peæj#vˌɑhː.kuh
Ándenbeaivahkku+N+Pl+Com	Ándenbeaivahkkuiguin	ˈɑːnː.ten#peæj#vˌɑhː.kuj.gujn
Ándenbeaivahkku+N+Pl+Nom+PxDu1	Ándenbeaivahkkuideame	ˈɑːnː.ten#peæj#vˌɑhː.kuj.dˌĕæ.me
Ánnávahkku+N+Sg+Acc+PxPl2	Ánnávahkodet	ˈɑːn.nɑː#vˌɑh.ko.deh
Ánnávahkku+N+Sg+Acc+PxSg2	Ánnávahkot	ˈɑːn.nɑː#vˌɑh.koh
Ánnávahkku+N+Sg+Gen+PxPl2	Ánnávahkodet	ˈɑːn.nɑː#vˌɑh.ko.deh
Ánnávahkku+N+Der/laš+A+Comp+Sg+Gen	Ánnávahkolabbo	ˈɑːn.nɑː#vˌɑh.ko»lˌɑbː.po
Ánnávahkku+N+Der/laš+A+Sg+Nom	Ánnávahkolaš	ˈɑːn.nɑː#vˌɑh.ko»lɑʃ
Ánnávahkku+N+Der/laš+A+Der/vuohta+N+Sg+Ill	Ánnávahkolašvuhtii	ˈɑːn.nɑː#vˌɑh.ko»lɑʃ»vˌuh.tij
Ánnávahkku+N+Sg+Gen	Ánnávahku	ˈɑːn.nɑː#vˌɑhː.ku
Ánnávahkku+N+Sg+Com+PxSg1	Ánnávahkuinan	ˈɑːn.nɑː#vˌɑh.kuj.nɑn
Ánnávahkku+N+Sg+Loc+PxPl2	Ánnávahkusteattet	ˈɑːn.nɑː#vˌɑhː.kus.tˌĕæt.teh
Ánnávahkku+N+Sg+Nom+PxPl1	Ánnávahkkomet	ˈɑːn.nɑː#vˌɑhː.ko.meh
Ánnávahkku+N+Der/huhtti+V+TV+Ind+Prs+Sg1	Ánnávahkkohuhtán	ˈɑːn.nɑː#vˌɑhː.ko»hˌuhː.tɑːn
Ánnávahkku+N+Der/viđá+Adv	Ánnávahkkoviđá	ˈɑːn.nɑː#vˌɑhː.ko»vˌi.ðɑː
Ánnávahkku+N+Sg+Gen+PxDu3	Ánnávahkkuska	ˈɑːn.nɑː#vˌɑhː.kus.kɑ
Ánnávahkku+N+Sg+Com+PxPl1	Ánnávahkkuineamet	ˈɑːn.nɑː#vˌɑhː.kuj.nˌĕæ.meh
Ánnávahkku+N+Sg+Ill	Ánnávahkkui	ˈɑːn.nɑː#vˌɑhː.kuj
áviisavalljivuohta+N+Sg+Ill	aviisavalljivuhtii	ˈɑ.vij.sɑ#vˌɑʎː.ʎi.vˌuh.tij
áviisavalljivuohta+N+Pl+Com	aviisavalljivuođaiguin	ˈɑ.vij.sɑ#vˌɑʎː.ʎi.vˌuo.ðɑj.gujn
áviisavalljivuohta+N+Pl+Gen+PxDu3	aviisavalljivuođaideaskka	ˈɑ.vij.sɑ#vˌɑʎː.ʎi.vˌuo.ðɑj.dˌeæs.kɑ
áviisavalljivuohta+N+Pl+Gen	aviisavalljivuođaid	ˈɑ.vij.sɑ#vˌɑʎː.ʎi.vˌuo.ðɑjh
áviisavalljivuohta+N+Pl+Ill+PxDu3	aviisavalljivuođaidasaska	ˈɑ.vij.sɑ#vˌɑʎː.ʎi.vˌuo.ðɑj.dˌɑ.sɑs.kɑ
áviisavalljivuohta+N+Pl+Loc+PxPl3	aviisavalljivuođaineaset	ˈɑ.vij.sɑ#vˌɑʎː.ʎi.vˌuo.ðɑj.nˌĕæ.seh
áviisavalljivuohta+N+Sg+Acc+PxPl3	aviisavalljivuođaset	ˈɑ.vij.sɑ#vˌɑʎː.ʎi.vˌuo.ðɑ.seh
áviisavalljivuohta+N+Sg+Com+PxDu1	aviisavalljivuođaineame	ˈɑ.vij.sɑ#vˌɑʎː.ʎi.vˌuo.ðɑj.nˌĕæ.me
áviisavalljivuohta+N+Sg+Loc	aviisavalljivuođas	ˈɑ.vij.sɑ#vˌɑʎː.ʎi.vˌuo.ðɑs
áviisavalljivuohta+N+Sg+Loc+PxPl3	aviisavalljivuođasteaset	ˈɑ.vij.sɑ#vˌɑʎː.ʎi.vˌuo.ðɑs.tˌĕæ.seh
áviisavalljivuohta+N+Ess+PxDu3	aviisavalljivuohtaneaskka	ˈɑ.vij.sɑ#vˌɑʎː.ʎi.vˌuoh.tɑ.nˌeæs.kɑ
áviisavalljivuohta+N+Ess+PxPl1	aviisavalljivuohtaneamet	ˈɑ.vij.sɑ#vˌɑʎː.ʎi.vˌuoh.tɑ.nˌĕæ.meh
áviisavalljivuohta+N+Ess+PxSg2	aviisavalljivuohtanat	ˈɑ.vij.sɑ#vˌɑʎː.ʎi.vˌuoh.tɑ.nɑh
áviisavalljivuohta+N+Ess	aviisavalljivuohtan	ˈɑ.vij.sɑ#vˌɑʎː.ʎi.vˌuoh.tɑn
áviisavalljivuohta+N+Sg+Acc+PxSg1	aviisavalljivuohtan	ˈɑ.vij.sɑ#vˌɑʎː.ʎi.vˌuoh.tɑn
áviisavalljivuohta+N+Sg+Gen+PxPl1	aviisavalljivuohtamet	ˈɑ.vij.sɑ#vˌɑʎː.ʎi.vˌuoh.tɑ.meh
áviisavalljivuohta+N+Sg+Ill+PxDu3	aviisavalljivuohtaseaskka	ˈɑ.vij.sɑ#vˌɑʎː.ʎi.vˌuoh.tɑ.sˌeæs.kɑ
áviisavalljivuohta+N+Sg+Nom+PxSg1	aviisavalljivuohtan	ˈɑ.vij.sɑ#vˌɑʎː.ʎi.vˌuoh.tɑn
ábit+N+Pl+Acc+PxSg2	ábiidat	ˈɑː.bij.dɑh
ábit+N+Der/Dimin+N+Pl+Nom	ábážat	ˈɑː.bɑː»dʃɑh
ábbut+V+IV+Der/d+V+Cond+Prs+Pl3	áppodivčče	ˈɑːp.po»dˌivhː.tʃe
áccuhit+V+IV+Der/adda+V+Ind+Prs+Pl2	áccohaddabehtet	ˈɑːt.tsoh»ˌɑdː.tɑ.bˌeh.teh
ádreassa+G3+N+Der/Dimin+N+Der/viđá+Adv	ádreassašviđá	ˈɑː.dreæs.sɑ»ʃ»vˌi.ðɑː
áfáiduvvat+V+IV+Imprt+Du1	áfáiduvvu	ˈɑː.fɑːj.dˌuvː.vu
ággi+N+Sg+Ill	ággái	ˈɑːgː.kɑːj
áhci+N+Der/huhtti+V+TV+Ger+PxSg2	ázehuhtidettiinat	ˈɑː.dse»hˌuh.ti.dˌet.tij.nɑh
áiru+N+Pl+Nom	áirrut	ˈɑːjr.ruːh
ája+N+Sg+Nom	ája	ˈɑː.jɑ
ájihit+V+TV+Ger+PxDu3	ájihettiineaskka	ˈɑː.ji.hˌet.tij.nˌeæs.kɑ
állu+N+Sg+Acc+PxPl3	áluset	ˈɑː.lu.seh
ámadadju+N+Der/viđá+Adv	ámadadjoviđá	ˈɑː.mɑ.ðˌɑc.co»vˌi.ðɑː
ámmozan+Interj	ámmozan	ˈɑːm.mo.dsɑn
ánjis+N+Der/geahtes+A+Attr	ánjesgeahtes	ˈɑːnː.jes»gˌĕæh.tes
ánjis+N+Sg+Nom+PxPl2	átnjáseattet	ˈɑːt.ɲɑː.sˌĕæt.teh
árga+N+Ess+PxPl2	árganeattet	ˈɑːrə.kɑ.nˌĕæt.teh
ássat+V+IV+Der/stuvva+V+Ind+Prs+Sg3	ásastuvvá	ˈɑː.sɑ»stˌuvː.vɑː
ása+N+Sg+Acc+PxPl1	ássageamet	ˈɑːs.sɑ.gˌĕæ.meh
átnut+V+TV+Ind+Prs+Sg2	ánut	ˈɑː.nuːh
átnut+V+TV+Der/NomAg+N+Der/viđá+Adv	ádnuviđá	ˈɑːd.nu»vˌi.ðɑː
átlas+N+Der/viđá+Adv	átlasviđá	ˈɑːt.lɑs»vˌi.ðɑː
ávus+N+Ess	ávusin	ˈɑː.vu.sin
ávus+N+Der/geahtes+A+Attr	ávusgeahtes	ˈɑː.vus»gˌĕæh.tes
ávvu+N+Pl+Com+PxPl3	ávuideasetguin	ˈɑː.vuj.dˌĕæ.set.gujn
áššu+N+Sg+Acc+PxDu3	ášuska	ˈɑː.ʃus.kɑ
áššu+N+Sg+Com+PxDu2	ášuineatte	ˈɑː.ʃuj.nˌĕæt.te
ášešeatni+N+Pl+Nom+PxDu2	ášešeniideatte	ˈɑː.ʃeʃ#ˌe.nij.dˌĕæt.te
áŧesmielalaš+A+Attr	áŧismielalaš	ˈɑː.θis#mˌie.lɑ.lɑʃ
ødema+N+Ess+PxDu3	ødemaneaskka	ˈø.de.mˌɑ.neæs.kɑ
ødema+N+Sg+Acc+PxDu2	ødemade	ˈø.de.mˌɑ.de
ødema+N+Sg+Com+PxSg2	ødemainat	ˈø.de.mˌɑj.nɑh
ødema+N+Sg+Loc+PxPl3	ødemasteaset	ˈø.de.mˌɑsː.tĕæ.seh
ødema+N+Der/viđá+Adv	ødemaviđá	ˈø.de.mɑ»vˌi.ðɑː
ødema+N+Sg+Ill	ødemii	ˈø.de.mij
økonomiseret+V+TV+Ger	økonomiseredin	ˈø.ko.nˌo.mi.sˌe.re.din
økonomiseret+V+TV+Inf	økonomiseret	ˈø.ko.nˌo.mi.sˌe.reh
økonomiseret+V+TV+Der/PassL+V+IV+Actio+Loc	økonomiserejuvvomis	ˈø.ko.nˌo.mi.sˌe.re»jˌuv.vo.mis
økonomiseret+V+TV+Der/PassL+V+IV+Actio+Nom	økonomiserejuvvon	ˈø.ko.nˌo.mi.sˌe.re»jˌuv.von
økonomiseret+V+TV+Der/PassL+V+IV+Der/upmi+N+Sg+Gen+Allegro	økonomiserejume	ˈø.ko.nˌo.mi.sˌe.re»j»ˌu.me
økonomiseret+V+TV+Der/PassL+V+IV+Der/upmi+N+Sg+Ill+PxDu3	økonomiserejupmáseaskka	ˈø.ko.nˌo.mi.sˌe.re»j»ˌup.mɑː.sˌeæs.kɑ
økonomiseret+V+TV+Der/PassL+V+IV+Inf	økonomiserejuvvot	ˈø.ko.nˌo.mi.sˌe.re»j»ˌuv.voh
økonomiseret+V+TV+Ind+Prt+Du1	økonomiseriime	ˈø.ko.nˌo.mi.sˌe.rij.me
økonomiseret+V+TV+Ind+Prt+Du3	økonomiseriiga	ˈø.ko.nˌo.mi.sˌe.rij.gɑ
økonomiseret+V+TV+Ind+Prt+Pl2	økonomiseriidet	ˈø.ko.nˌo.mi.sˌe.rij.deh
økonomiseret+V+TV+Ind+Prt+Sg3	økonomiserii	ˈø.ko.nˌo.mi.sˌe.rij
østrogena+N+Pl+Acc+PxDu3	østrogenaideaskka	ˈøst.ro.gˌe.nɑj.dˌeæs.kɑ
østrogena+N+Pl+Gen+PxSg3	østrogenaidis	ˈøst.ro.gˌe.nɑj.dis
østrogena+N+Sg+Acc+PxDu3	østrogenaska	ˈøst.ro.gˌe.nɑs.kɑ
østrogena+N+Sg+Com+PxSg2	østrogenainat	ˈøst.ro.gˌe.nɑj.nɑh
østrogena+N+Sg+Com+PxSg3	østrogenainis	ˈøst.ro.gˌe.nɑj.nis
østrogena+N+Sg+Loc	østrogenas	ˈøst.ro.gˌe.nɑs
østrogena+N+Der/huvva+V+IV+Cond+Prs+Du1	østrogenahuvašeimme	ˈøst.ro.gˌe.nɑ»hˌu.vɑ.ʃˌejm.me
østrogena+N+Der/huvva+V+IV+Ind+Prs+Sg3	østrogenahuvvá	ˈøst.ro.gˌe.nɑ»hˌuvː.vɑː
østrogena+N+Der/laš+A+Attr	østrogenalaš	ˈøst.ro.gˌe.nɑ»lɑʃ
østrogena+N+Sg+Ill	østrogenii	ˈøst.ro.gˌe.nij
čalmmustahttit+V+TV+VAbess	calmmustahtekeahttá	tsˈɑlmː.mus.tˌɑh.te.kˌĕæhː.tɑː
čalmmustahttit+V+TV+VAbess	calmmustahtekeahttájin	tsˈɑlmː.mus.tˌɑh.te.kˌĕæhː.tɑː.jin
čalmmustahttit+V+TV+Ger+PxDu3	calmmustahtidettiineaskka	tsˈɑlmː.mus.tˌɑh.ti.dˌet.tij.neæs.kɑ
čalmmustahttit+V+TV+Ger+PxPl3	calmmustahtidettiineaset	tsˈɑlmː.mus.tˌɑh.ti.dˌet.tij.nĕæ.seh
čalmmustahttit+V+TV+Ger+PxSg1	calmmustahtidettiinan	tsˈɑlmː.mus.tˌɑh.ti.dˌet.tij.nɑn
čalmmustahttit+V+TV+Ger+PxSg2	calmmustahtidettiinat	tsˈɑlmː.mus.tˌɑh.ti.dˌet.tij.nɑh
čalmmustahttit+V+TV+Ger	calmmustahtidiin	tsˈɑlmː.mus.tˌɑh.ti.dijn
čalmmustahttit+V+TV+Ind+Prt+Pl2	calmmustahtiidet	tsˈɑlmː.mus.tˌɑh.tij.deh
čalmmustahttit+V+TV+VAbess	calmmustahtihaga	tsˈɑlmː.mus.tˌɑh.ti.hˌɑ.gɑ
čalmmustahttit+V+TV+Cond+Prs+Pl2	calmmustahtášeiddet	tsˈɑlmː.mus.tˌɑhː.tɑː.ʃˌejt.teh
čalmmustahttit+V+TV+Ind+Prs+Sg1	calmmustahtán	tsˈɑlmː.mus.tˌɑhː.tɑːn
čalmmustahttit+V+TV+Ind+Prs+Sg2	calmmustahtát	tsˈɑlmː.mus.tˌɑhː.tɑːh
čalmmustahttit+V+TV+Sup	calmmustahtážit	tsˈɑlmː.mus.tˌɑhː.tɑː.dʃih
čalmmustahttit+V+TV+Imprt+Pl2	calmmustahttet	tsˈɑlmː.mus.tˌɑhː.teh
čalmmustahttit+V+TV+Der/meahttun+A+Sg+Com	calmmustahttemeahttumiin	tsˈɑlmː.mus.tˌɑhː.te»mˌĕæhː.tu.mijn
čalmmustahttit+V+TV+Der/meahttun+A+Der/at+Adv	calmmustahttemeahttusit	tsˈɑlmː.mus.tˌɑhː.te»mˌĕæhː.tu.sih
čalmmustahttit+V+TV+Imprt+Du2	calmmustahtti	tsˈɑlmː.mus.tˌɑhː.ti
čalmmustahttit+V+TV+Der/muš+N+Sg+Nom	calmmustahttimuš	tsˈɑlmː.mus.tˌɑhː.ti»muʃ
čalmmustahttit+V+TV+ConNegII	calmmustahtto	tsˈɑlmː.mus.tˌɑhː.to
čalmmustahttit+V+TV+Der/PassS+V+IV+PrfPrc	calmmustahtton	tsˈɑlmː.mus.tˌɑhː.to»n
čalmmustahttit+V+TV+Der/PassS+V+IV+Der/goahti+V+ConNegII	calmmustahttogohto	tsˈɑlmː.mus.tˌɑhː.to»gˌoh.to
čalmmustahttit+V+TV+Der/PassS+V+IV+Der/goahti+V+Ind+Prt+Sg3	calmmustahttošgođii	tsˈɑlmː.mus.tˌɑhː.to»ʃgˌo.ðij
čalmmustahttit+V+TV+Der/PassS+V+IV+Ind+Prt+Pl1	calmmustahttuimet	tsˈɑlmː.mus.tˌɑhː.tu»ˌi.meh
čalmmustahttit+V+TV+Der/PassS+V+IV+Ind+Prt+Pl2	calmmustahttuidet	tsˈɑlmː.mus.tˌɑhː.tu»ˌi.deh
čalmmustahttit+V+TV+Imprt+Pl1	calmmustahttut	tsˈɑlmː.mus.tˌɑhː.tuh
čalmmustahttit+V+TV+Der/NomAg+N+Sg+Gen+PxPl1	calmmustahttámet	tsˈɑlmː.mus.tˌɑhː.tɑː»meh
čalmmustahttit+V+TV+Der/NomAg+N+Sg+Ill	calmmustahttái	tsˈɑlmː.mus.tˌɑhː.tɑː»i
čalmmustahttit+V+TV+Ind+Prt+ConNeg	calmmustahttán	tsˈɑlmː.mus.tˌɑhː.tɑːn
č.ortnet+N+Pl+Nom	č.ortnegat	tʃ.ort.ne.gɑh
č.ortnet+N+Sg+Nom+PxSg1	č.ortnegan	tʃ.ort.ne.gɑn
č.ortnet+N+Sg+Ill+PxPl3	č.ortnegasaset	tʃ.ort.ne.gɑ.sɑ.seh
čalbmeáhkku+N+Sg+Loc	čálbmeáhkus	tʃˈɑːlə.pme#ˌɑːh.kus
čalbmeáhkku+N+Sg+Gen+PxSg1	čálbmeáhkkon	tʃˈɑːlə.pme#ˌɑhː.kon
čalbmeáhkku+N+Ess+PxPl2	čálbmeáhkkuneattet	tʃˈɑːlə.pme#ˌɑhː.ku.nˌĕæt.teh
čalbmeáhkku+N+Sg+Ill	čálbmeáhkkui	tʃˈɑːlə.pme#ˌɑhː.kuj
čeahppulit+V+IV+Der/adda+V+Imprt+Du2	čehppoladdi	tʃˈehː.pol»ˌɑdː.ti
čeargut+V+IV+Sup	čerggožit	tʃˈerk.ko.dʃih
čeabi+N+Sg+Nom	čeabi	tʃˈeæ.biː
čelodit+V+IV+Ind+Prs+ConNeg	čelot	tʃˈeː.loh
čevllohallat+V+IV+Imprt+Du1	čevllohallu	tʃˈeβl.lo.hˌɑlː.lu
čezá+N+Der/viđá+Adv	čezaviđá	tʃˈe.dsɑː»vˌi.ðɑː
čibbi+N+Pl+Com	čippiiguin	tʃˈip.pij.gujn
čidnái+A+Sg+Acc	čidná	tʃˈid.nɑː
činus+N+Der/Dimin+N+Sg+Nom	čitnosaš	tʃˈit.nos»ɑʃ
čoaskasahá+N+Der/viđá+Adv	čoaskasahaviđá	tʃˈŏɑsː.kɑ#sˌɑ.hɑ»vˌi.ðɑː
čollut+V+TV+Ger	čolodiin	tʃˈo.lo.ðijn
čomas+A+Comp+Sg+Nom	čopmasut	tʃˈopː.mɑː.suh
čomas+A+Sg+Loc	čopmasis	tʃˈopː.mɑː.sis
čudjosit+V+IV+Pot+Prs+Du1	čudjosežže	tʃˈuc.co.sˌedː.tʃe
čuget+N+Der/Dimin+N+Pl+Nom	čugehaččat	tʃˈuː.geh»ˌɑt.tʃɑh
čuget+N+Der/Dimin+N+Sg+Nom	čugehaš	tʃˈuː.geh»ɑʃ
čurge+N+Der/viđá+Adv	čurgeviđá	tʃˈurə.ke»vˌi.ðɑː
čuska+N+Sg+Gen+PxDu2	čuskkade	tʃˈus.kɑː.ðe
čuđeš+N+Der/viđá+Adv	čuđešviđá	tʃˈuː.ðeʃ»vˌi.ðɑː
čásmagas+N+Sg+Com	čásmagasain	tʃˈɑːsː.mɑ.gˌɑ.sɑjn
šahkkebilidanvearju+N+Sg+Nom	šahkkebilidanvearju	ʃˈɑhː.ke#pˌi.li.dɑn#vˌĕærə.ju
šakŋa+N+Sg+Ill	šakŋii	ʃˈɑk.ŋij
šallju+N+Pl+Gen+PxPl1	šaljuideamet	ʃˈɑʎ.ʎuj.dˌĕæ.meh
šargoŋŋa+N+Pl+Gen	šargoŋŋaid	ʃˈɑrə.koŋ.ŋɑjh
šatain+Adv	šatain	ʃˈɑ.tɑːjn
šeaffa+G3+N+Sg+Ill	šeffii	ʃˈef.fij
šealši+N+Sg+Com+PxSg3	šelššiinis	ʃˈelʃ.ʃij.nis
šeaffa+G3+N+Ess+PxDu3	šeaffaneaskka	ʃˈeæf.fɑ.nˌeæs.kɑ
šelge+N+Der/viđá+Adv	šelgeviđá	ʃˈelə.ke»vˌi.ðɑː
šeneret+V+TV+Ind+Prt+Du1	šeneriime	ʃˈe.ne.rˌij.me
šerosmuvvat+V+IV+Imprt+ConNeg	šeros	ʃˈeː.ros
šerpet+V+TV+Ind+Prt+Du2	šerpiide	ʃˈerə.hpij.de
šiggut+V+TV+VAbess	šikkukeahttá	ʃˈik.ku.kˌĕæhː.tɑː
šihtti+N+Sg+Nom	šihtti	ʃˈihː.tiː
šimuhit+V+TV+VGen	šimut	ʃˈi.muːh
šlaggat+V+TV+Imprt+Sg2	šlakka	ʃlˈɑkː.kɑː
šluppul+Adv	šluppul	ʃlˈupː.puːl
šláhpardit+V+IV+VAbess+A+Attr	šláhparkeahtes	ʃlˈɑːh.pɑr#khˌĕæh.tes
šnjakkehit+V+IV+Imprt+Pl1	šnjakkiheatnot	ʃɲˈɑk.ki.hˌĕæt.noh
šnjeahcat+V+IV+ConNegII	šnjehco	ʃɲˈeh.tso
šnjoarrat+V+IV+VGen	šnjoara	ʃɲˈoɑ.rɑ
šoavaidit+V+IV+Pot+Prs+Sg3	šoavaideš	ʃˈoɑ.vɑj.deʃ
šohkka+N+Pl+Nom	šohkat	ʃˈohː.kɑːh
šongleret+V+TV+Ind+Prt+Pl2	šongleriidet	ʃˈong.le.rˌijː.teh
šordot+V+IV+Der/NomAct+N+Sg+Nom	šordon	ʃˈorə.to»n
šuhkoláda+N+Sg+Ill	šukkoládii	ʃˈuk.ko.lˌɑː.dij
šušmi+N+Sg+Gen+PxDu2	šušmmáde	ʃˈuʃ.mɑː.ðe
šveicalaš+A+Ess	šveicalažžan	ʃvˈejː.çtsɑ.lˌɑdː.tʃɑn
šveicalaš+A+Sg+Gen	šveicalačča	ʃvˈejː.çtsɑ.lˌɑt.tʃɑ
šveicalaš+A+Der/vuohta+N+Ess	šveicalašvuohtan	ʃvˈejː.çtsɑ.lɑʃ»vˌuoh.tɑn
šveicalaš+A+Sg+Ill	šveicalažžii	ʃvˈejː.çtsɑ.lˌɑdː.tʃij
šáhkka+N+Sg+Ill	šáhkkii	ʃˈɑhː.kij
šákšamárran+N+Der/viđá+Adv	šákšamárranviđá	ʃˈɑːkː.ʃɑ#mˌɑːr.rɑn»vˌi.ðɑː
šárrat+V+IV+VAbess	šárahaga	ʃˈɑː.rɑ.hˌɑ.gɑ
šárggihit+V+IV+Der/meahttun+A+Comp+Sg+Nom	šárggitmeahttusut	ʃˈɑːrk.kih»mˌĕæhː.tu.suh
šávvat+V+IV+Der/d+V+Ind+Prs+ConNeg	šávat	ʃˈɑː.vɑ»h
