[word = "biila"][msd = ".*V.*"]

Boađus: 390
						

    « ‹ 1 › » 

goto_page of 1
Cealkkačájeheapmi
	Administrative texts –
Mannolat lea dagahan ahte 	biila lea 	šaddan dárbbašlaš doallobierggasin buot boazoeaiggádiidda . #other
Guhkit gaskkaid lei divrras vuodjit ovdal_go 	biila bođii 	, čálii bajimusingeniora Fixdal 1938:s ( Fixdal 1938 : 58 ) . #boahtit
Geaidnodirektora Baalsrud čálii 1926:s ahte 	biila lea 	dakkar fievru mii lea heive Norgii , gos leat guhkes gaskkat ja gos nu bieđggus ásset olbmot ahte ruovdemáđidoaibma ii leat gánnáhahtti ( ibid s. 139 ) . #other
Go 	biila bođii 	, de unno golut ja šattai eambbo gánnáhahttin guhkes gaskkaid vánddardit . #boahtit
Masa 	biila adno 	bargoáiggis ? #other
11 Gos lea 	biila čuožžumin 	maŋŋil bargoáiggi ? #other
Jus 	biila lea 	boarrásat go 3 jagi boahtojagi ođđajagimánu 1. b. ja vearromáksi duođašta ahte fidnovuodjin boahtojagis lea badjel 40_000 km , de váldo rehkenastimis vuođđun 56,25_% biilla listahattis ođasnaga .  #other
Jus 	biila lea 	el-biila ja vearromáksi duođašta ahte fidnovuodjin boahtojagis lea badjel 40_000 km , de váldo rehkenastimis vuođđun 50_% biilla listahattis ođasnaga .
Biilasoahpamušain boahtojagi osiin , čađahuvvo ovduvearuheapmii gorálaččat nu galle olles ja álggahuvvon manu go 	biila lea 	leamaš du hálddus . #other
Ovdamearkan dasa goas 	biila ferte 	lohkkot boarrásabbun go 3 jagi boahtojagi ođđajagimánu 1. b. , lea go biila vuosttas geardde registrerejuvvo ođđajagimánu 5. b. 2008 . #other
n = galle álggahuvvon boahtojagi 	biila lea 	logahallon ovdal guoski boahtojagi . #other
7099 poasta Ealáhusbiila iežas anus Dása máhcahuvvo ovdu go ealáhus - 	biila lea 	iežas anus dan láhkai ahte ovdu meroštallo 30_% vuođus , gitta jilmanni vuođus . #other
Meroštallanvuođđu lea biilla listahaddi ođasnaga , muhto jus 	biila lea 	boarrasat go 3 jagi ođđajagemánu 1. b. boahtojagis , dahje jus vearromáksi duođašta ahte fidnovuodjin boahtojagis lea badjel 40_000 km , de lea vuođđu 75_% biilla listahattis ođasnaga . #other
Állaha 	biila lei 	gáskojuvvon visot , ja Állahis lei váivi . #other
Mus ii leat 	biila iige 	mopeda . #other
Mus ii leat 	biila iige 	mopeda . #other
Meahccebiila vuodjá hárve olggobealde luotta go 	biila ii 	lea ráhkaduvvon dan gierdat , muhto ATV:in sáhttá álkit vuodjit juohke saji . #other
Meahccebiila vuodjá hárve olggobealde luotta go 	biila ii 	lea ráhkaduvvon dan gierdat , muhto ATV:in sáhttá álkit vuodjit juohke saji . #other
	Aššu –
Go son lei čohkkedan biilii , de gal fas 	biila johtigođii 	albmaládje . #johtit
Min biilavuoddji lei nu suorganan ahte ille šat nagoda duolmmastit gása dan mađe ahte 	biila vuolgá 	viidáseappot . #vuolgit 
Skihpaguras lea leamaš biillabearráigeahčču , ja 50 	biila bissehuvvoje 	. #other
Dál leat muhtin olbmot vásihan ahte boares 	biila ii 	gierdda dien oasi , ja billahuvva . #other
– Luodda lea nu seaggi ahte ii báljo čága hoigat muohttaga , 	biila láve 	measta guoskkadit ravddaide , muitala Lemet . #other
MEASTTA UNNI : – Mu ovddit 	biila lei 	dákkár Messerschmidt , muhto dál lea mus nu stuora joavku , ahte eat čáhkan šat dainna vánddardit , muitala Janne Peterson . #other
Dát somás ja earenoamáš 	biila skuvihii 	Guovdageainnu Shell-gávppi olggobeallái muhtin beaivvi mannan vahkkus . #skuvihit
STUORA DOLLA , ČÁHPPES SUOVVA : Gal lei stuora dolla ja čáhppes suovva go 	biila buollái 	albma ládje . #other
Dása čoahkkanedje olu biillat dán botta go 	biila bulii 	, go ii dákko soahpan bálljo meattá vuoddjit . #other
Muhto go 	biila bisánii 	, de lei álkit oaidnit mii dat oba lei ge . #bisánit
Ii son gal diehtán man olu lihttariid dat boksa geassá , muhto diđii muitalit ahte 	biila doalvu 	eambbo diesel « a go dát boksa lea dáhke alde . #doalvut
Son ii vuollánan ovdal eará 	biila bođii 	, de son gal vuoddjái eret . #boahtit
Bearjadaga sullii njealji áigge beaivet , buollái okta suoma 	biila vuojidettiin 	. #other
	biila lea 	áibbas ortnegis , vuddjon dušše 44.000 km , Biillas lea servostivren , ABS-goazanat , 2 kollišuvdnadustenseahka , goallostat , stereo , 2:it juvllat , hekkspoiler , alu . #other
Jon Karlsen Ráissa leansmánnikántuvrras muitala ahte stuora fámut orrot leat leamaš jođus go 	biila bávkkehii 	báktái . #other
– Go biilaeaiggádat fuobmájit ahte 	biila ii 	dohkkehuvvo iskkadeamis , de geahččalit baicca verrošit dáhkádusain go dan ahte oamastit dohkkemeahttun biilla , daddjo ovtta čilgehusas Kriposis . #other
Fártamihttideaddji čájeha ges 300 km // d , ja 	biila oažžu 	measta nu leahtu . #other
Biilla olles namma lea Chevrolet Corvette Coupe , ja 	biila lea 	98-málle . #other
Ja go Áššu journalista gulai ahte 	biila lea 	doppe , na de gal lei oalle mihá jođán vuolgit geahččat niegu . #other
Ii oktage hálit dadjat man olu bensiinna 	biila doalvu 	, ja muhtimat lohket ahte ii dat leat ge nu dehálaš . #doalvut
Mii máksit lahka 10 ruvnno bensinlittaris , ja go 	biila njiellá 	badjel guokte littara juohke miillas , de gal orru oalle dehálaš dat vuodjinekonomiija . #other
Biilla leahttu , ja biila muđui , gal lea hejot heivehuvvon davvi luottaide , muhto 	biila lea 	goitge oallugiid niehku . #other
Son muitala ahte 	biila lei 	meastta áibbas ođas . #other
Mii doaivut buohkat ahte lea nohkka go 	biila manná 	, ja ahte mutuvra lea liekkas . #mannat
Muhtun drošševuoddji , gean Áššu deaivvai Álttás , muitalii ahte sii lávejit dieselbiillaide lasihit parafiinna vel dieselii , vai 	biila manná 	buolašin . #mannat
Dát dagaha ahte diesel buollá geahppaseappot , ja 	biila ii 	leat nu bahá galbmot . #other
Nordlys-govvejeaddji Yngve Olsen Sæbbe lei massán biilla iežas viesu olggobealde , ja son lei dieđihan politiijaide ahte 	biila lea 	suoladuvvon . #other
Álttá leansmánnikántuvrras lohket ahte sii eai ge leat leamaš doppe , muhto muitalit ahte ii oktage roasmmuhuvvan go 	biila vujii 	badjel luotta . #vuodjit
Nuppes go oainnát luoddabargiid ja sudno 	biila bisánan 	, ale suhtastuva vaikko šattat unnidit leahtu . #bisánit 
Mitsubishi Galant GLSi 88-málle , 	biila lea 	buori ortnegis .
Jus beare stuora juvllaid , dahje beare unna juvllažiid bijat , de sáhttá dat rievdadit movt 	biila láhtte 	luotta alde . #other
FIIDNÁT ADNON : Siskkobealde oidno , ahte 	biila lea 	bures ortnegisdollon . #other
– Nubbi ovdagoazat lei ruston gitta dandihte go 	biila ii 	leat nu dávjá anus . #other
	Avvir –
– Mis lea muhtin cavgileapmi man iskat lagabui , go amas 	biila lea 	oainnahallan ihkku . #other 
– Mis ii leat gal gelbbolašvuohta veardidit doallá go dat áidi jus mahkáš 	biila vuoddjá 	njeaiga , dahje biilajorri . #vuodjit
Biila šleaŋggehii , geahččalin njulget , muhto 	biila jorggihii 	, ožžon ain eambo leahtu ja de beaškkehii . #other 
– Ikte šattai nu ahte muhtin 	biila bođii 	dasa go beana lei vuddjon gasku luotta ja geaidnu buot varran , de lei dat oalle issoras , lihkus lei " dušše " beana dán háve , jus sáhttá nie lohkat , deattuha son . #boahtit
Maiddái sudno 	biila billahuvai 	buollimis . #other
– Son vujii badjel luotta olgeš_bealde , ja deaddásii eatnama ja biilla gaskii go 	biila gopmánii 	, muitala leansmánni Leo Johanssen , gii ii sáhte dadjat eanet ášši birra , go ii leat vel ožžon iskkadanraportta . #other
Garrasit roasmmehuvvan Vaikko 	biila lei 	fasttit cuovkanan , de eai roasmmehuvvan nuorat geat maŋŋegeahčen čohkkejedje nu garrasit . #other
Dasto lea 	biila jorihan 	geaidnoáiddi geaži badjel ja girdán johkii , čilge Kárášjoga leansmánni ja lihkuhisvuođabáikki jođiheaddji Svein Arnt Hanssen . #girdit
avvir.no : ealga vuddjon , 	biila reakčanan #other	
ealga vuddjon , 	biila reakčanan 	Astrid on 09 December , 2008 12:01:00 #other
– Lea vuosttaš ealga mii lea vuddjon dán jagi Kárášjogas , lohká Johansen ja muitala son ii loga dan ealgga maid muhtin 	biila guoskkahii 	. #other
Muhto 	biila lasihii 	leavttu ja politiija divttii biilla mannat . #other
Álttá leansmánni Geir Kolstad dieđiha ahte nubbi 	biila lei 	čierastan vearu beallái luotta ja danin roaškkeheigga biillat oktii . #čierastit
Olbmot besset čohkkát dan biillas ja vásihit mii dáhpáhuvvá go 	biila joriha 	birrat_birra , muitala son . #other
– Borgemánu álggu geahčen lihkken iđđes árrat ja galgen Omasvutnii vuoddját doaktára lusa , muhto de in gávdnan šat iežan biilla , muittaša biilaeaiggát gii mátketelefovnna bokte oaččui dieđuid gos su 	biila lea 	. #other
– Munnje lei hui buorre oažžut biilla ruovttoluotta , danin_go 	biila lea 	áibbas dehálaš munnje gii in goastá nu bures . #other
Tienas Nordlys valáštallansearvái Maŋimuš tiimma ovdalgo 	biila vuorbáduvvui 	, lei gárži birra vuorbevuvddiid beavdi . #other
avvir.no : – Doivon 	biila vujii 	viesu njeaiga #vuodjit
– Doivon 	biila vujii 	viesu njeaiga Svein Nordsletta čállán svein@avvir.no on 29 April , 2010 02:58:00 #vuodjit
Ole Henrik Gaino , Láhpoluobbalis Guovdageainnu_suohkanis , muitala son jurddašii 	biila vujii 	seaidnái . #vuodjit
Nils A. Gaup lohká sin buohkaid dieđusge leamaš suorganan , ja orru issoras jurddašit mo lei sáhttit mannat jus eai lean fuobmát gobi luottas dahje jus lei 	biila boahtit 	ovddal eai ge livčče sáhttán bonjastit nuppe beallái luotta . #boahtit
5:a dáid lobiide gáibiduvvo lassin birasgáibádusat ahte 	biila galgá 	birasgáibádusaid gokčat mas lea unnimus 140g/km/140g CO2 . #other
Munnos ii leat 	biila ean 	ge beasaše nu álkit vuolgit nuppi lusa finadit márkanbáikkis , lohká Johan K. #vuolgit
Son oaččui dieđu mannan vahkku Romssa politiijakantuvrras ahte muhtun 	biila lei 	vuodján orohaga čorraga njeaiga . #vuodjit
	biila reakčanan 	 #other
Badjel geainnu mannan 	biila lea 	reakčanan ovddabealde , ja biilaklássa lea luovvanan . #other
– Lea vuosttaš ealga mii lea vuddjon dán jagi Kárášjogas , lohká Johansen ja muitala son ii loga dan ealgga maid muhtin 	biila guoskkahii 	. #vuodjit
– Son vujii badjel luotta olgeš_bealde , ja deaddásii eatnama ja biilla gaskii go 	biila gopmánii 	, muitala leansmánni Leo Johanssen , gii ii sáhte dadjat eanet ášši birra , go ii leat vel ožžon iskkadanraportta . #other
Vaikko 	biila lei 	fasttit cuovkanan , de eai roasmmehuvvan nuorat geat maŋŋegeahčen čohkkejedje nu garrasit . #other
– Politiijat ožžo dieđu sotnabeaivvi iđđes diibmu beal logi áigge ahte Nieidagoržži guovllus Guovdageainnu_suohkanis lea 	biila vuodján 	badjel luotta , fierran ja bisánan dáhki ala . #vuodjit
Johansen čilge ahte 	biila lei 	bisánan dáhki ala birrasiid golbma mehtera eret geainnus , ja go ambulánsa ollii lihkohisvuođabáikái , de lei olbmot lihkohisvuođabáikkis . #bisánit
Gáregasnjárggas nuppelot kilomehtera Ohcejoga guvlui 	biila čeasai 	johkii ovddit ija . #čeassat
Gaskavahku čuovganeapmái 	biila čeasai 	johkii Steažžalotnjárgga bokte , lahka Roavvesavvona . #čeassat
Busse ja 	biila beaškkehedje 	oktii #other
Vihtta olbmo roasmmehuvve go busse ja 	biila beaškkehedje 	oktii Máze buohta sotnabeaivvi . #other
Bártnáš lei jođus skuvlii ja lei hoigamin sihkkela rastá luotta go 	biila bođii 	ja vujii sihkkela njeaiga . #boahtit
Subaru 	biila lei 	oajuhuvvon . #other
Guovttis roasmmohuvaiga go 	biila vujii 	badjel luotta Ruoššamuotkkis Jáhkovuona ja Smiervuona gaskkas . #vuodjit
– Luottaid mielde orru 	biila leamaš 	doares bealde 150 mehtera ovdal gopmánii . #other
Jáhkkimis lea 	biila álgán 	sugadit nu ahte vuoddji manai fas badjel geainnu ja gopmánii , Børre Paulsen . #other
Govva8 : Mattis Ailo Hætta joraha olbmuid birra biillain , vai dovdet man ávki lea biilaboahkánis go vuodjá doaresbeallái , ja 	biila joriha 	. #other
Duo moadde beaivvi dás ovdal vuddjojedje njeallje bohcco jámas , 	biila manai 	moallun . #mannat
Lea go du 	biila ordnejuvvon 	dálvvi vuostá ? #other
- Dálvvi vuostá ordnejuvvon 	biila lea 	mávssolaš sihke johtalussihkarvuhtii ja biilii , muitala son . #other
Batteriija mii lea 5-7 jagi boaris ii gierdda garra dálvvi jus 	biila ii 	adno beaivválaččat . #other
Deahkka mas lea unnán jorrancakkadeapmi dagaha ahte 	biila boaldá 	unnánit ja dakko_bokte lea unnit CO2-luoitin , lohká Engebretsen . #other
Ii oktage 	biila leat 	nu sihkar ahte vuoddji sáhttá vánddardit luottaid alde almma ollislaš áicilvuođain vuojidettiin , lohká NAF oktavuođahoavda Inger Elisabeth Sagedal . #other
– Olmmoš geas lea šleđggon oidno 140 mehtera duohken go 	biila čuovgá 	. #other
– Mu mielas ii leat divrras bileahtta go mis leat earánoamáš buorit vuoittut gos 	biila lea 	dat buot stuorámus vuoitu , lohká lágideaddji . #other
Formel 1 gilvvus lea dábálaččat bisánastinbáiki gos gilvvu oktavuođas besset jođánit vuodjit bisánastit iskat mot 	biila doaibmá 	, earret_eará juvllaid . #other
GÁRŽI : Reidar Johnsena 	biila leai 	okta daid golbma biillain , mat ledje geaidno ravdii bisánan , ja mii reakčanii oktiibeaškkeheamis Buolbmágis . #other
Mannan maŋŋebárgga dáhpáhuvai biilalihkohisvuohta nuorttabeale Buolbmága go muhtun 	biila vujii 	nubbái mii leai jorgaleamen geainnu alde Buolbmága rohkosvistti bokte . #vuodjit
Lihkohisvuohta dáhpáhuvai go muhtun 	biila leai 	jorgaleamen de nubbi bođii vuoji ala . #other
Gaup muittuha daid olu lihkohisvuođaid mat ledje moadde jagi dás ovdal_go guorbmebiillat česse dálvit geainnu badjel go 	biila bođii 	ovdal dan sivas go geaidnu lei nu baski . #boahtit
Go ođđa 	biila bisánii 	ovddeš Shell bensinstašuvnna lusa , de lei dego albmi maid sávai biilii bures_boahtima go fáhkka čuorpmastii ja iige dat bistán go áibbas oanehis botta . #bisánit HERE
– Dát 	biila lea 	huksejuvvon boahtteáiggi várás , ja lea erenomážit ráhkaduvvon ahte galgá doaibmat buollašis ja danne šaddá ge gelddolaš oaidnit doaibmá go nu go lea lohpiduvvon , logai Alf Isaksen . #other
Dát 	biila lea 	máksán sullii 3,3 miljovnna ruvnno . #other
– Biillat leatba njunnádasat beaškkihan oktii , ja dat orru dego stuorát 	biila lea 	boahtán vearu beallái geainnu ja deaivan smávit biilla njuni . #boahtit
Muhto 	biila lasihii 	leavttu ja politiija divttii biilla mannat . #other
Álttá leansmánni Geir Kolstad dieđiha ahte nubbi 	biila lei 	čierastan vearu beallái luotta ja danin roaškkeheigga biillat oktii . #čierastit
– Mun lean dál jurddašan hui guhká man ollu 	biila nuoskkida 	. #other
Maŋimuš tiimma ovdalgo 	biila vuorbáduvvui 	, lei gárži birra vuorbevuvddiid beavdi . #vuorbádit
In geavat mohtorlieggasa go 	biila lea 	biilastállas . #other
Go Ávvir finai rektoriin liggenrusttetlanjas , de lei Statoila 	biila deavdime 	oljju oljoliggenrusttegii . #other
Dán stuora " konga " rumbbu lei Piera Joavnna vissui váldán eahkeda ovdal_go 	biila suoláduvvui 	. #other
– Borgemánu álggu geahčen lihkken iđđes árrat ja galgen Omasvutnii vuoddját doaktára lusa , muhto de in gávdnan šat iežan biilla , muittaša biilaeaiggát gii mátketelefovnna bokte oaččui dieđuid gos su 	biila lea 	. #other
– Munnje lei hui buorre oažžut biilla ruovttoluotta , danin_go 	biila lea 	áibbas dehálaš munnje gii in goastá nu bures . #other
Olbmot besset čohkkát dan biillas ja vásihit mii dáhpáhuvvá go 	biila joriha 	birrat_birra , muitala son . #other
Mun deiven ollu ođđa olbmuid ja ožžon maid ođđa olbmáid , ja jurddaš , mun ožžon nu ollu dávviriid ahte min 	biila lei 	áibbas dievva , muitala Peder Haugfos . #other
Duorastateahkeda diibmu 19.30 oaččui Nuorta-Finnmárkku politiguovlu dieđu ahte muhtun 	biila lei 	vuodján badjel luotta Dorvonjárggas , Kárášjoga_gielddas . #vuodjit
– Bargi lea čilgen munnje ahte luodda lei borgon ja galjiin go 	biila massii 	coavccu . #other
Son geahččalii njulget biilla , muhto 	biila jorragođii 	gitta bálkestuvvui luottas eret , dadjá Sivertsen gii maiddái dieđiha soai eaba lean bávččagan ja ahte sudnuin manná bures . #other
Go de čuččodii das de son gullá 	biila boahtimin 	Gáregasnjárgga guovllus . #boahtit
Go 	biila lei 	joavdan nuppelogi kilomehtera Guovžajávrái , de geavai nu ahte mielle vuolde bođii ovddal biila . #joavdat
Dagahii goitge dan ahte stuorra 	biila ii 	fidnen leahtu vustolahkii , ja nu han de mielli alde gulul hiđui oalát . #other
Mielli alde 	biila orustii 	ja Ovllá lávkii sisa ja muitalii mojunjálmmiid ahte ammat sus lea velá gálvu biila maŋábealde . #other
Máze dollačáskadeaddjit sáddejuvvo báikái , muhto 	biila ollii 	goitge oalát buollit . #ollet
Dál besset Kárášjoga ássit nuvttá eret elektrovnnalaš doabbariin , váralaš doabbariin ja kroavvásat doabbariin , go Finnmárkku Birasbálvalus // Finnmark Miljøtjeneste 	biila vuodjá 	dáid ruvttuid Kárášjoga_gielddas : #vuodjit
Dál besset Kárášjoga ássit nuvttá eret elektrovnnalaš doabbariin , váralaš doabbariin ja kroavvásat doabbariin , go Finnmárkku Birasbálvalus // Finnmark Miljøtjeneste 	biila vuodjá 	maŋŋebárgga čakčamánu 15. beaivve 2009 dáid ruvttuid Kárášjoga_gielddas : #vuodjit
Válddes oktavuođa Stáhta geaidnodoaimmahagain jus gáttát siva váilevaš merkii lea : Biillas lea ođđa eaiggát , dáhkádus lea loahpahuvvon , EU-dárkkisteapmi váilu , Eiseválddit leat gáibidan biillas eret váldit šilttaid dahje biilagalbbaid , 	biila lea 	suoláduvvon , biilas leamaš váldán eret registrerema . #other
Nubbi 	biila ferte 	olgun juohkelágan dálkkis . #other
Muhtun 	biila vujii 	šalddi rastá . #vuodjit
Måsø muitala eai lean olbmot roasmmehuvvan , muhto 	biila lei 	olu reakčanan . #other
Lei Kárášjoga Fredeng Transport gálvobiila mii lei fievrredeame mielkki , go 	biila gopmánii 	luoddagurrii ja goallosvovdna fas gopmánii luotta nala . #other
Son vuodjá ge de geađggi njeaiga , ja 	biila billohuvvo 	nu ahte dainna ii sáhte šat vuodjit . #other
Ii dieđusge bisánanbáikkis leat čađat biillat birra jagi , muhto jus okta 	biila addá 	352 ruvnno beaivválaččat , de dine bisánanbáikki eaiggát 105_600 ruvnno jahkásaččat . #other
Olmmái lei okto jođus go ribahii badjel geainnu , nu ahte 	biila jorai 	birra . #other
Vuossárgga iđida buollái 	biila vuojidettiin 	, Nuovasmuotkkis Ráissa ja Návuona gaskkas , Romssa fylkkas . #other
Nils A. Gaup lohká sin buohkaid dieđusge leamaš suorganan , ja orru issoras jurddašit mo lei sáhttit mannat jus eai lean fuobmát gobi luottas dahje jus lei 	biila boahtit 	ovddal eai ge livčče sáhttán bonjastit nuppe beallái luotta . #boahtit
Nieidda irgi ii roasmmohuvvan go son háhppehii njuiket eret geainnus go 	biila bođii 	. #boahtit
Biilavuoddji dieđihii ahte ealga ruohtastii viidáseappot , vaikko 	biila bávkkihii 	oalle garrasit dan njeaiga . #other
Gaskavahkku oaččui Nuorta-Finnmárkku politiijaguovlu dieđu ahte muhtun 	biila lei 	vuodján muhtun čorraga njeaiga Njávdámis , Mátta-Várjjagis . #vuodjit HERE
Oarje-Finnmárkku politiijaguovlu dieđiha sii ožžo dieđu lávvardaga maŋŋit eahkedis ahte 	biila lea 	geavvan badjel geainnu Oskal báikkis , Guovdageainnu ja riikarájá gaskal . #other
Sotnabeaivvi duššai Romssa dievdu go su 	biila buollái 	, maŋŋil go beaškkehii oktii guorbmebiillain , Laksvatn báikkis , Báhccavuona gielddas . #other
Dievdu gii vujii biilla , jámii go 	biila buollái 	. #other
Dál ávžžuha Romssa fylkka " Trygg Trafikk " diktit 	biila čuožžut 	, nu guhká go ii leat duođaid dárbu vuodjit . #other
Čuovudettiin geaidnoravdda lea 	biila guoskan 	ja sojahan 60 km galbba ja báhccan rastá geainnu ja bisánan čuoččat biilanjunni rođus . #other
Kristian Øvernes , Stáda geaidnodoaimmahagas , muitala ahte šaddá sullii 40_000 ruvnno máksit go boazu ja 	biila beaškkehit 	oktii . #other
– Mu bártnáš lei stoahkamin dákko gokko 	biila vujii 	, dušše moadde minuhta ovdal_go dáhpáhuvai , muitala Máret Elle Oskal . #vuodjit
BÁŊKOBIILA : Ovddabealde báŋkobiila man njeaiga 	biila bisánii 	. #bisánit
Berit Kirsti Gaino lei čohkohallamin beaŋkkas olggobealde Gjensidige báŋkku go 	biila bođii 	meattá olles leahtuin . #boahtit
Son ii oaidnán ahte 	biila deaivvai 	olbmuid , muhto finai lagabus geahččamin , go politiijat ollejedje dasa . #other
Jurdilin ahte 	biila lei 	sáhttit deaivat mu . #other
Go 	biila deaivvai 	báŋkobiilla , de orru nubbi nisu šaddan báŋkobiilla vuollái . #other
– Mis lea muhtin cavgileapmi man iskat lagabui , go amas 	biila lea 	oainnahallan ihkku . #other
Buollinčáskadan meahccejuvllat 	biila ribahii 	darvánit gieddái . #other
Okta eará 	biila fertii 	vuodjilit eret nu ahte ii beaškkehan oktii eará biillain . #vuodjilit
– Doivon 	biila vujii 	 #vuodjit
Ole Henrik Gaino , Láhpoluobbalis Guovdageainnu_suohkanis , muitala son jurddašii 	biila vujii 	seaidnái . #vuodjit
Olgoriikka registrerejuvvon 	biila lei 	vuodján badjel luotta ja fierran máŋgii , muitala Romssa politiijaguovllu operašunjođiheaddji , Roy Tore Meyer . #vuodjit
Stáhta geaidnodoaimmahat lea guhkidan áigemeari rása rájes dassái go 	biila galgá 	dohkkehuvvon , mánus guovtti mánnui . #other
Leavnnjas ii dárbbaš dál šat gieldda 	biila čuojahit 	musihka miessemánu 17. beaivvi go dál lea viimmat ođđa korpsa boahtán johtui . #other
Leavnnjas leat olbmot geat vázzet ráiddus miessemánu 17 beaivvi , maŋimuš jagiid dušše muittašan korpsa ealli jienaid , go gieldda 	biila lea 	skájaniid badjel čuojahan lávlagiid ja musihka . #other
Son muitala sii fuomášedje 	biila lei 	goahcan čeassan olu sajiin ja go iske ovtta luotta mii manai badjel geainnu , de lei gálvobiila gilgga alde 20 mehtera vulobealde . #other
Buollašat dieđihuvvojit bistit gitta juovllaide ja NAF loguid mielde dáid maŋimuš beivviid buollaša geažil leat olus dárbbašan veahki go 	biila orusta 	. #other
Danin ávžžuha NAF Norges Automobil-Forbund olbmuid dárkkistit ja ráhkkanahttit biilla buollaša vuostá , ja ahte 	biila gierdá 	čuožžut muhttin beivviid buollašis , lohká NAF gulahallanráđđeaddi , Jan Ivar Engebretsen . #other
Šleđggona haga ii oidno olmmoš ovdal_go 	biila lea 	25-30 mehtera eret , muhto jus leat bidjan šleđggona , de oidno olmmoš 140 mehteris . #other
Nu mo mun lean ádden , de lea nubbi 	biila billašuvvan 	ja lea addon diehtu boazoeaiggádii ja dat lea fitnan doppe . #other
Dat čájeha ahte olbmot eai jáhke šat nuppi olbmo morálalažžan , muhto seammás vuordit ieža ahte earát dieđihit jus iežas 	biila lea 	rokčejuvvon . #other
Dat čájeha ahte olbmot eai jáhke šat nuppi olbmo morálalažžan , muhto seammás vuordit ieža ahte earát dieđihit jus iežas 	biila lea 	rokčejuvvon . #other
Dávjjimus roakčaneamit leat ge go 	biila vuodjá 	nuppi biilabahtii , lohká direktevra Anne Stine Mollestad , DnB NOR Dáhkádusfitnodagas . #vuodjit
Ferteje maid čiehkat dan juohke háve go 	biila galgá 	divohahkii . #other
Dát 	biila lea 	beare lahka čáhcebohcci ! #other
Okta nubbi 	biila bođii 	su ovddal . #boahtit
Risten bidjalii biilla maŋosgiirii , muhto 	biila ii 	lihkastan ge . #other
Vikkai murddihit , muhto 	biila ii 	lihkastan báljo . #other
VG lea rehkenastán ahte jus vuodjá 15.000 gilomehtera jagis , ja 	biila doalvu 	0,8 littara miillas , de divru biilavuodjin 3000 ruvnnuin jagi 2012:s , dan ektui maid dál máksá vuodjit lihkka ollu . #doalvut
Bártniin manai bures , muhto 	biila cuovkanii 	veaháš . #other
Fred Persen 	biila billašuvai 	oalát duorastaga , muhto Persen lohká ahte biilla gal gávdná fas oastit , ja ahte heagga gal lea mealgat divraseabbo . #other
Sara muitala 	biila bođii 	boasttubealde luotta ja deaivvai sudno goallosjorri ja vujii murrii . #boahtit
Son lohká ahte dán rádjái lea áibbas sihkar ahte mohtorsihkkel ja 	biila leat 	beaškkehan oktii , ja mohtorsihkkelvuoddji lea duššan ja mohtorsihkkel bulii buot . #other
Go 	biila lea 	jorran 100_000 kilomehtera de biila boarásmuvvagoahtá ja divuhangolut lassánit . #other
Go biila lea jorran 100_000 kilomehtera de 	biila boarásmuvvagoahtá 	ja divuhangolut lassánit . #other
Dat logis geat dušše_go ledje mátkkošteamen biillain , masse guđas heakkas go 	biila beaškkehii 	oktii nuppi mohtorfievrruin ja njealjis ges dušše_go biila manai badjel geainnu ( okta lihkohisvuohta ) . #other
Dat logis geat dušše_go ledje mátkkošteamen biillain , masse guđas heakkas go biila beaškkehii oktii nuppi mohtorfievrruin ja njealjis ges dušše_go 	biila manai 	badjel geainnu ( okta lihkohisvuohta ) . #other
Álggos čilget makkár divvumiid 	biila dárbbaša 	, ja dalle oažžut biiladivvunsajiin fálaldagaid e-boasttas dahje poasttas . #other
Dan 16 olbmos geat dušše , ledje 14 geat dušše_go 	biila beaškkehii 	oktii eará mohtorfievrruin . #other
Okta olmmoš duššai muohtarihtus ja okta duššai go 	biila čuolastii 	eret luottas . #čuolastit D?
Ále gátte ahte du áibbas ođđa 	biila ii 	bisán dán gease guoros báhttera dihtii . #other
NAF-miellahttuvuohta bođii ávkin olusiidda diibmá , muhto vaikke lea veahkki fidnemis go 	biila ii 	vuolgge dahje go vuodjá eret luottas , de aŋkke eatnašat eai livčče háliidan daid vásáhusaid . #vuolgit
Álkit sáhttá 	biila válbmet 	dálvái vai ii bártit biillain buolašin , loahpaha Jan Ivar Engebretsen preassadieđáhusas . #other
Eatnasat livčče várra nimmordan jus livččii gullan čuoččuhusa ahte Škoda nammasaš 	biila lea 	máilmmi buoremus . #other
Dáhkádusfitnodagat muitalit eanemus lihkohisvuođat maid olbmot dieđihit leat murdin , ovttaskas lihkohisvuođat , maŋegeahčái vuddjon , bissehuvvon 	biila vuddjon 	ja luoddaearu lihkohisvuođat . #vuodjit
Dát 	biila atná 	unnánit go desilihttara diesela miilii , čállá broom.no . #other
Háliidan ahte mu 	biila galgá 	sulastahttit mu . #other
Galggašeimmego iskat makkár stánddas 	biila lea 	? #other
Measta bealli duššai go 	biila geavai 	luottas eret , ja 13:s dušše deaivvadanlihkohisvuođain . #other
Nymann deattuha juohkehaččas lea ovdasvástádus fuolahit 	biila lea 	ortnegis ja iige váralaš johtolagas . #other
Dan maid boazu dieđus ii sáhte diehtit lea ahte 	biila ii 	goasttašii doares bealde oaguhit #other
Dás ii dieđe okta ge mii livčče sáhttit geavvat , jus ovdamearkadihti 	biila livčče 	boahtán ovddal . #other
Vudjen jagi dassá_go mus 	biila gopmánii 	. #other
Biilasuovva leavvá miehtá biilabisánansaji , go olbmot guđđet biilamohtora jorrat amas mohtor dahje 	biila galbmot 	. #other
De álgá gullot : Biila boahtá , 	biila boahtá 	! #boahtit
Nuba 	biila hurgá 	badjel luotta johkii . #other
Dál sáhttá muhtin biillain main lea stuora maŋŋestuollu , ja ii leat makkárge liigegáibádus biilaboahkánii , čohkkat okta liige olmmoš vuollel 15 jagi , lassin masa 	biila lea 	dohkkehuvvon . #other
Ii ovttage biillas sáhte leat eanet olbmot go masa 	biila lea 	dohkkehuvvon . #other
– Lea buoret jus losimus gálvu lea nu lahka eatnama go vejolaš ja 	biila šaddá 	maid sihkkarabbon geainnu alde , iige gálvu johttá jus biilla fáhkka bisseha , lohká son . #other
Biillabeaškkehangeahččalemiin leat mihtidan man olu iešguđet dávvirat lossot go fáhkka 	biila bissána 	. #bissánit
Jus 	biila beaškkeha 	masa_nu 50 km // t , de lassána guokte pára sabeha deaddu logi kilos 150 kiloi , guokte pára čuoiganstevvelat lossot viđa kilos 75 kiloi ja termos beannot kilos 45 kiloi . #other
NAF ávžžuha ahte geahčat biilla servicegirjji vai beasat dárkkistit man ollu 	biila lea 	mannan ja man dávjá lea services leamaš . #mannat
Jus vázziolbmos ii leat šelggon ja 	biila vuodjá 	50 kilomehtera leahtuin , de fuomáša biilavuoddji birrasii guokte sekundda ovdal dan olbmo seavdnjadin . #vuodjit
Nieiddaš lei sihkkelastime iežas skuvlageainnus go muhtun 	biila guoskkehii 	sutnje , ja son gahčai ja nordadii oaivvi nu garrasit ahte sihkkeljealbma luoddanii . #other
Dalle dajai ieš ironiijalaččat ahte dat 	biila ii 	čága stohpui sisa bassat su ásodaga dahje molsut sutnje gávnniid veahkkin . #other
Go Ávvir riŋgesta Ingá Rávnái de lea son juste Leavnnjas káfestallamin kafeas dan_botta_go 	biila lea 	divodusas . #other
Dárkkut fal ahte 	biila lea 	ortnegis ovdal_go vuoddját . #vuoddját
– De oččošit bártnážan , muhto 	biila ii 	leat nu boaris vel ahte dan sáhttá luoikat . #other
Vástádus : Ja 	biila doaibmá 	nu go galgá ? #other
Munno 	biila lea 	dies olgun ! #other
GUOVDAGEAIDNU : Sotnabeaivvi eahkeda ožžo politiijat dieđu ahte Šuoššjávrris , Guovdageainnu ja Kárášjoga suohkanrájás , lei muhtin 	biila buollán 	. #other
Vuoddji biillas mii deaivvahalai rehkii muitala ahte son lei Gávvuona bokte vuodjime E6-luotta mielde , go nubbi 	biila bođii 	su ovddal . #boahtit
– Buollinčáskadeaddjit ledje báikkis , muhto 	biila lei 	oalát biillahuvvan buollimis , čállet Oarje-Finnmárkku politiijat politiijaloggas . #other
Politiijat leat liikká álggahan ášši , vai gávnnahit manne 	biila buollái 	. #other
– Fakta lea ahte okta 	biila lea 	vuodján boazočorraga sisa gaskavahkku , ja 16 heakka jápme dán dáhpáhusas . #vuodjit
Ii leat dábálaš ahte 	biila vuodjá 	dien mađe čorraga . #vuodjit
Vuoddji biillas mii deaivvahalai rehkii muitala ahte son lei Gávvuona bokte vuodjime E6-luotta mielde , go nubbi 	biila bođii 	su ovddal . #boahtit
– Buollinčáskadeaddjit ledje báikkis , muhto 	biila lei 	oalát biillahuvvan buollimis , čállet Oarje-Finnmárkku politiijat politiijaloggas . #other
Politiijat leat liikká álggahan ášši , vai gávnnahit manne 	biila buollái 	. #other
Oarje-Finnmárkku politiijat dieđihedje lávvordaga maŋŋelgaskabeaivi ovdalaš njealji Twitteris ahte 	biila lea 	vuodján nuppi biilla maŋágeahčái . #vuodjit
Politiijat muitaledje ahte lihkohisvuohta dáhpáhuvai go 	biila goazastii 	eará biilla dihte mii lei luoddabeallás , ja de bođii goalmmát biila ja vujii nuppi biilla bahtii . #other
	Non-fiction texts –
Imaš , muhto duohta lea ahte dego ámmátvuodji de lean buorremielas juohke háve go lea beaivvádat ja in dárbbaš smiehttat ja ballat ahte 	biila čeassá 	eret geainnus , dahje ferte gehtegiid bidjagoahtit . #čeassat
Dovden ahte 	biila bumpii 	man_nu badjel , ja ii lean vejolaš bisánit . #other
Mu ránnjá , geas ii leat 	biila iige 	goassege vuoje , son ii galgga máksit geaidnodivvagiid ja bummaruđaid . #vuodjit
Dálvit 	biila guđđojuvvo 	Anár-Gihttel-eatnangeainnu gurrii ja vázzojuvvo s. 500 mehtera stobo lusa . #other
Geasi áigge 	biila vuodjá 	guktii beaivvis , dálvvi áigge vahkkobeivviid mielde oktii dahje guktii beaivvis . #vuodjit
Bálgá goappat geažis leat bisánansajit , maidda 	biila sáhttá 	guođđit . #other
Maŋimus kilomehteriid berre vuodjit varrugasat ja 	biila leage 	buorre guođđit ovdal Palsinoja leahkki ceahki ala . #other
Prográmmas lea mielde maiddái jakuhttabagadalli Mihail Lukatshevski iešlágálaš drámá Vilges beaivi fárrolagaid johtti olmmošjovkkožis , geaid 	biila bieđgana 	guovu sibirjjálaš jiekŋamáilmmi . #other
Bidjat ovtta guoros gaskka rihku ja beallečuoggá maŋábeallái ( muhto ii ovddabeallái ) : In ollen čoahkkimii ; 	biila cuovkanii 	. #other
Jus 	biila ferte 	heivehuvvot earenoamážit vinttain dahje gorgŋestagain , de addo reanto ja oassemávssukeahtes loana juogu 2 biilii , nugohčoduvvon kássabiila . #other
Muhto jus 	biila lea 	áibbas dárbbašlaš buozanvuođa geažil , ja biila lea earenoamážitheivehuvvon , sáhttet duohta lassigolut mat eai gokčojuvvo vuođđodoarjagiin biiladoaimmaheapmái , leat vuođđun sierragessosii . #other
Muhto jus biila lea áibbas dárbbašlaš buozanvuođa geažil , ja 	biila lea 	earenoamážitheivehuvvon , sáhttet duohta lassigolut mat eai gokčojuvvo vuođđodoarjagiin biiladoaimmaheapmái , leat vuođđun sierragessosii . #other
Viimmat ožžo goit stuora táŋkka mainna 	biila geasehii 	čázi – dat buoridii olu , muhto mávssii 10 ruvnno beaivái , mii dovdui bures sin bušeahtas . #other
Son lei gullán go 	biila goazastii 	šiljus ja lei láseráigge oaidnán mu ja muhtuma sallalagaid vázzimin biillas ja internáhta duogábeallái . #other
Sutnje 	biila sáhttá 	mearkkašit eará go Skandinavialaččaide . #other
Skandinavialaččaid mielas 	biila lea 	fievru , mainna beassa báikkis nubbái . #other
Tansalialas mielas 	biila sáhttá 	leat mearkka das , ahte olmmoš ii boađe gillát nealggis . #other
Nillá 	biila nuppástuhttá 	 #other
Sutnje 	biila sáhttá 	mearkkašit eará go Skandinavialaččaide . #other
Skandinavialaččaid mielas 	biila lea 	fievru , mainna beassa báikkis nubbái . #other
Tansalialas mielas 	biila sáhttá 	leat mearkka das , ahte olmmoš ii boađe gillát nealggis . #other
Vuosttas han galggašii leat cealkimin ahte « Mun ja 	biila manaime 	... #mannat
	Fiction texts –
Fáhkka 	biila bisánii 	, orustii . #bisánit
Seammás_go 	biila bisánii 	, de Máhtte rabestii uvssa ja measta juo njuikii olggos biillas , dego livččii fáŋgan leamašan logi jagi . #bisánit
Juohke háve go 	biila vujii 	meattá , de son ii orron mearkkašeame ge dan . #vuodjit
Son lei juste fas giddeme uvssa , go muhtin 	biila mannagođii 	. #mannat
Seammás_go 	biila bisánii 	, de uksa rahppui . #bisánit
Juvllat jorragohte luottas , muhto 	biila ii 	johtán gosage . #johtit
Máhte-Máhtte lei máŋga beaivve hui jávoheapme , go 	biila lei 	viežžan heastta . #viežžat
Čáhppes 	biila boađášii 	fargga gisttuin ja dolvvošii jávohis muorračuolli . #boahtit
Sudno hálešteapmi gaskkalduvai , go čáhppes 	biila čierastii 	šilljui . #čierastit
Čáhppes 	biila gavccádii 	luohkkái ja jávkkai Badjenjárgga guvlui . #other D?
Čáhppes 	biila láidestii 	eará biillaid maŋŋásis ja guhkes ráidun gurggiidii mieđušteaddjiid joavku Badjenjárgga guvlui . #láidestit HERE
Ođđa geaidnu geasuhii vierrásiid geasi áigge ja okta nubbi 	biila šuvihii 	meattá luohká mielde . #šuvihit
Veaigin Heaika oinnii mo 	biila njiejai 	gulul luohkás , dat ii lean Nillá , dát lávii eambbo luoitilit bodnái . #njiedjat
Nillá 	biila ii 	oidnon šiljus , dat lei viellja vuot gos nu mátkkiid alde , dasa ii duođaidge šaddan áigi guhkkin . #other
Son lei máttil boahtimin , go de ribahii badjel geainnu ja 	biila beaškkehii 	garra leavttuin njuolgga telefonstolpui . #other
Biret-Káre lei háše bardimin ja orustii geahččat , ja Heaika fas iežas ruohtasšaddobealddu hilskemin ja gaivágođii gosa 	biila manai 	. #mannat HERE
De gulloje ráhtamat ; 	biila jurramin 	mađija mielde , guhkkin . #other
Báikki ala čoahkkanedje dievva olbmot , meattávuoddji duiskalaš 	biila bisánii 	: olbmot ledje geainnu alde . #bisánit
Maiddái soames duiskalaš 	biila lei 	veahkkin fievrrideamen báikkálaš olbmuid ja šibihiid joga rasttildansajiide . #other
Soldatkin čárvvodii nissona siidduid ja njávkkadii suoli su čiččiidge nu guhká dassáigo árvalii ruoŧŧelaš soalddáha fuobmán sudno , muhto go 	biila vuoddjái 	tuollu gátti guvlui , de son hoigadii Marja dobbelii ja dajai : Go it juo geardde dan biergasage atte , de dušši lea boahtit mus jeđđehusa goardit . #vuoddját
Son váccašii ávdin lanjain muoseheamet iige duostan šat vuolgit gillái : 	biila galggai 	boahtit juo iđitbeaivve . #boahtit
Gosason dat 	biila lei 	darvánan ? #other
Measta juohke beaivve , go 	biila buvttii 	sidjiide biepmu , de dan lávddi alde ledje maiddái stuorra bivttaskássat : birrasiid olbmuin čoggojuvvon dahje togaid mielde máddelis boahtán bivttasgálvu oaččui sin jáhkkit ahte oppa Ruoŧa ustitlaš álbmot lei jorgalan sidjiide láđis muođuidis ja geahččalii leat ná buoremus lági mielde sidjiide veahkkin . #buktit
Dalán go 	biila lei 	jávkan , de suvddár manai njunušgoddevistti guhkes seakkamuđot offiseara ságaide ja háleštii suinna dulkka bokte moadde diimmu . #other
Dušše soames 	biila vujii 	šat meattá ja johtolat goasii nogai , ovtta nuppi lásas játtai čuovga , eallin nogai . #vuodjit
	Min Aigi –
GUOVDAGEAIDNU : Sotnabeaivve čuovganeapmái vujii muhtin Norgga 	biila bissetkeahttá 	rukses čuvgii Toallus Kivilompolis . #other
Go 	biila ollii 	Guovdageidnui de boles bissehii dan . #ollet
Biila seaivvuhii gaskkohagaid 120-kilomehtera diimmus ja 	biila skirvehalai 	ravddas ravdii . #other
Doarjja njagagii 5-6 mehtera , ovdal 	biila bisánii 	. #bisánit
Muhtin 	biila girddihii 	141 km // d dakko gokko ii leat lohpi vuodjit go 80 km // d. – Biila ii beroštan ii veaháge ložžet leahtu , dušše deaddilii . #girdihit
– Álggos lea 	biila čálistan 	olgešbeal geaidnoravdii , ja orru nu ahte almmái lea viggan njulget biilla . #other
– Muhto son baicce dalle vujii njuolgga gurutbeallái , badjel geainnu , áiddi čađa muhtin gieddái , ja 	biila deaivvai 	geaidnoearu ja jorragođii birrat_birra , lohká politimeašttir Odd M. Nymoen . #other
Sáhttu finada boares skuvlla šiljus gos lei maid nubbi 	biila vuordimen 	jos sadji gáržu menddo sakka . #other
Suoma 	biila bulii 	#other
ČuohppanJus 	biila lea 	reakčanan garrasit , de sáhttá gártat veagal rahpat uvssaid ja čuohppat , vaikke gáhttu eret . #other
Dát dieđusge dagaha ahte 	biila šaddá 	guovdážii márkanbáikkis . #other
– Leago stuorra gažaldat go jearrá man boares 	biila lea 	. #other
PORSÁŊGU : Muhtun 	biila vujii 	suodjalusbusse njeaiga johtolatrieggás Leavnnjas . #vuodjit
Ealga ja 	biila oktii  #other	
Teáhterlaččaid 	biila oidnui 	duogábealde . #other
Go bohccot galget eallin sirdot Suomas Norgga njuovahagaide , de fertejit dearvvasvuođaduođaštusat leat gárvásat ovdal_go 	biila vuolgáge 	viežžat bohccuid . #vuolgit
Válddahalai go boares 	biila bisánii 	 #bisánit
Hætta lei čállán ahte Sámi Áigi lei oastán lagabui 5.000 ruvnnu ovddas ladjobensiinna vaikko áviissa 	biila geavahii 	lajohis bensiinna . #other
GUOVDAGEAIDNU : Bearjadateahkeda ožžo Guovdageainnu bolesat dieđu ahte 	biila lei 	vuodján badjel luotta Mironis . #vuodjit
Politiiját ja Máze časkadanjoavku vuoddjaje dohko , muhto 	biila bulii 	gudnan . #other
Leansmánne fertii bissehit fievrru dasa go okta dávggiid čohkkenboaltu lei rastá ja 	biila jođii 	geaidnoráigge doarrás . #johtit
Bálddas lei biila mii lei gárvásit čatnojuvvon seaidnái ja dainna verddešat seaivvuhedje gitta Avvilii gos 	biila gávdnui 	lávvardaga . #other
Earot bealde iskkai vuoddji oažžut vuojánis ruovttoluotta geidnui , muhto mátki nogai gaskan ja 	biila fierralii 	siiddu ala ceakko vieltái . #fierrat
Báikkis , gosa 	biila gopmánii 	, lea mátki detnui sullii kilomehtera ja luondu lei ráhkadan dasa gováža gosa olju bisánii . #other
Báiki , gos 	biila gopmánii 	, lei bures válljejuvvon . #other
– Lei maid lihkku , ahte 	biila ii 	lean jođus bensiinnain , dalle livčče buollánvára lean stuoris , go biila gopmánii dan beallái gos billas lea EL-rávdnjebotkon . #leat jođus
– Lei maid lihkku , ahte biila ii lean jođus bensiinnain , dalle livčče buollánvára lean stuoris , go 	biila gopmánii 	dan beallái gos billas lea EL-rávdnjebotkon . #leat jođus
Šilljui galbmon 	biila lea 	bidjan máŋgasiid iđđedis bargui , manadettin čuojahit táksii . #other
– Vuossárgga rájes lea 	biila jorran 	ovttatláhkai . #jorrat
Dán guovllu olbmot leat hárjánan buollašiidda , ja sis leat biktasiid lassin maid buolláhagat fárus,<\!#9 > jos 	biila orusta 	, muitala Erkki Marttiini Avvil bolesis . #other
Biillas ledje vel guokte eará nuora , go 	biila vujii 	badjel geainnu 8 kilomehtara Leavnnjas Kárášjoga guvlui . #vuodjit
Dan rájes árvádallet movt 	biila lea 	fas ollen luotta nala , muhto árvideamis lea njuiken ja fierran , čilge Pedersen . #ollet
Ii leat ovdal vásihan ahte 	biila buollá 	ja lohká iežas lihkolažžan go ledje dušše guorosbohttalat guorbmin . #other
Dán oktavuođas ii roasmmahuvvan mánná , vaikko gahčai go 	biila bođii 	su njeaiga . #boahtit
Ovddit geardde lei mánáid biillas cuvkkejuvvon lásat ja dál lei maid 	biila ožžon 	iežas oasi bilideamis . #other
Rievváriid 	biila lea 	leamašan bissehuvvon bátnedikšunbálvalusa ja Min_Áiggi gaskii . #other
DEATNU : < B > Guokte 	biila boŋkkiheigga 	oktii muohtasoiccas Horpmás lávvardaga . #other
< P > Bildámis dieđihuvvui suovvabiipobuollin ja Skuggis lei vuot okta 	biila suovastišgoahtán 	. #other
Sii dihtet gii eaiggáda biilla , muhto eai sáhte čilget movt 	biila lea 	šaddan ráfáidahtton rávdojávrái . #other
Osmo Pieskki diđii maiddái , ahte 	biila lea 	jávrebeaŋkká // ahpparasravdda duohkai darvánan . #other
Ii leat áibbas vissis mot 	biila lea 	dohko geavvan . #other
Ovdalaš go busse ribahii skievvadit olggobeallái asfáltta ravdda , lea muhtin 	biila boahtán 	ovddal . #boahtit
Biillain ferte leat " veltebøyle " , mii mearkkaša ahte jus 	biila gopmána 	de ii cuovkan . #other
Bearraša 	biila čuččodii 	olggobealde . #other
Okta 	biila lei 	vuodján badjelgeainnu Kárášjoga márkanis . #vuodjit
Diibmobeale ovdal_go politiijá eskorta ja gonagaslaš 	biila bođii 	ledje olbmot ráhkkaneamen iešguđetge láhkai . #boahtit
Guldalin jogo 	biila boahtá 	. #boahtit
Álohii go 	biila gullui 	verráha luhtte , de viehkalii Øystein bidjat gáfe duldet . #other
NRK_Sámi radio 	biila vuojista 	Ájonjárgii . #vuodjit
Filmmas oainnát go lea biilla siste filbmejuvvon dan_botta_go 	biila vuodjá 	luoddaráigge Ivgobađas . #vuodjit
Suoma tuollárat illá jáhkke dasa maid oidne , go 	biila boahtá 	Ruošša bealde . #boahtit
Son čuoččuhii ahte lei viellja gii lei vuodján biilla , ja ahte vieljja lei mannan vácci go 	biila ii 	mannan šat albmaláhkái . #mannat
Ealgabivdi duššai go 	biila fierai 	šaldis #fierrat
Ealgabivdi duššai go 	biila fierai 	šaldis #fierrat
Politiijaid teoriija mielde , de lea 	biila beaškkehan 	šaldái ja jávkkihan olggobeallai . #other
Dál vel vel beasat 500 ruvndosaš sáhkuin , jus váldot mobiltelefuvnnain hupámin 	biila vuojedettiin 	dahje rassamin eará elektrovnnalaš biergasiin mat sáhttet muosehuhttit vuodjima . #other
Vihtanguoktá čilgehusa mielde lea 	biila boahtán 	vuoji Láttošluohká vulos . #boahtit
Lei norgga registrerejuvvon 	biila muitala 	vuosttaš politijjá bálva Winther nuorta-Finnmárkku politiguovddážis . #other
Čuolbma-čoavdin iskan ferte vuordit dassá_go 	biila čiŋahuvvo 	. #other
Politiijat eai dieđe vuos leago 	biila loktanan 	ja jorran , muhto sii jáhkket ahte leaktu lea sivvan lihkuhisvuhtii . #other
Guovdageainnu leansmánnekantuvrra politibálvá Kjell Magne Grønnli muitala ahte 	biila lea 	boahtán Biedjovákki guovllus ja ribahan olggobeallái luotta olgeš_bealde . #boahtit
Politiijat eai vuos dieđe lea go 	biila loktanan 	ja jorran . #other
Soai vujiiga váldogeainnu ala gos eará 	biila vujii 	njeaiga . #vuodjit
– Dat mii dán rádjái lea čielggas , lea ahte 	biila lea 	beaškkehan oktii heaŋgariin mii lei lastabiilla maŋis . #other
Dan njeaiga lea mot nu 	biila boahtán 	, mii bođii márkán guovllus . #boahtit
Leansmánni Evenáššis Skániin lea ožžon cávgilemiid ahte muhtun boares Ford Escort nammasaš 	biila lea 	oidnon guovllus . #other
SIFO lea rehkenastán ahte dakkár olbmos geas ii leat 	biila ferte 	unnimusat leat 6500,- ruvnno mánnui dábalaš birgejupmái nu go earret_eará borramuššii , telefuvdnii , biktasiidda ja dearvvašvuhtii . #other
– Ii várra mana guhká ovdal_go šaldi gahččá dahje muhtun stuorra 	biila bártida 	das . #other
Dieđáhusas dáhkádusfitnodahkii dieđihii son ahte su 	biila lei 	suoláduvvon ja gávdnon maŋŋil billahuvvan . #other
Dát 	biila fievrrida 	gorudiid Kemi gávpogii ja doppe de buvttadit bierggu . #fievrridit
Silisávžžis bearraša 	biila beaškkehii 	oktii poastta tráiláriin . #other
Jus leat fitnodatbiilaortnet muhtin áiggi bálkájagis , dalle čađahuvvo ovdamunnevearromáksin gorelogu geavahettiin daid olles dahje álgojuvvon mánuid ovddas go 	biila lea 	leamaš anus . #other
Boađus šattai , nugo dávjá dáhpáhuvvá dákkár bárttiin , ahte 	biila čeasai 	eret luottas ja vel dan beallái gos alla vielti lea . #čeassat
Dárkkistuvvon fievrruid gaskkas vuorbádit mii ovtta 300 ruvnno sturrosaš skeaŋkakoartta juohke johtalusstašuvnnas , ja du 	biila lea 	maid mielde riikkaviidosaš gilvvus šaddat « Dán jagáš ruoššabiilan » . #other
Kárášjoga leansmánnibálvá Frank Nilsen muitala ahte stuorra 	biila galggai 	vuodjit sisa bisananbáikái ja bonjastii ovddabeallái biilla mii bođii lulil ja manai Leavnnja guvlui . #vuodjit
Smávit 	biila lea 	ge nu ollu cuovkanan ovddabealde ahte lea áibbas veadjemeahttun dovdat biilamearkka . #other
Ránskalaš nissonguovttos , Claude Bescond ja Giséle D urand , leigga vuodjimin davás Suoma čađa , go 	biila čeasai 	njuoska geainnu alde ja fierai birrat_birra badjel geainnu . #čeassat
- Diet čáhppes Citroen lea mu biila , muitala šlundon Jacques Bescond ja čujuha guorbmebiilasteallái gosa su reakčanan oktii máinnolmas čáppa 	biila lea 	garcojuvvon gitta . #other
Soai eaba lohkan iežaska vuos geargan geahččalit man johtilit 	biila hurgá 	. #other
Ja nubbi 	biila lea 	boađi boađi . #boahtit
Jus lea fitnodatbiilaortnet muhtin áiggi bálkájagis , čađahuvvo ovdamunnevearromáksin gorrelogu geavahettiin daid olles dahje álgojuvvon mánuid ovddas go 	biila lea 	leamaš anus . #other
Skoglund lohká iskan man ollis son ieš lea go 	biila bisánii 	, muhto oassi ealggas lei iežas alde . #bisánit
Skoglund lohká maiddái ahte vuosttaš 	biila ii 	bisánan , vaikke son vikkai seavvit ja bissehit . #bisánit
Go sutno 	biila lei 	olggobealdi , eabage soai goabbáge vástidan telefovnna , de lei stuorra eahpádus ahte soai leaba sorbmahuvvan dállui . #other
Das 	biila jorihii 	birra ja almmái lábmii iežas nu sakka , ahte su dolvo vuos Kárášjoga buohccevissui ja doppe viidáseappot Hámmarfeastta buohccevissui . #jorihit
Riekti lei maid geahččame báikki gokko lihkuhisvuohta dáhpáhuvai , ja hálidedje erenoamážit iežaset čalmmiiguin oaidnit gaskka dan rájes gokko 	biila vujii 	olbmuid njeaiga , dan rádjái gokko duššan eadni mánáinis ja vovnnain ledje . #vuodjit
Njeallje jagi dan maŋŋel_go ruošša generála vujii oaivegávpoga Kabula gáhtaid mielde iežas bargosadjái , su 	biila lei 	juohke bealde suddjejuvvon assás ruovdepláhtaiguin , ahte suollemas báhčči luođat eai livčče goddán su . #other
Ii dárbbaš eahpiditge ahte 	biila lea 	unni iige leat nu vuogas . #other
Suomas lei okta čeahpes lávlu ja diktačálli Juha Watt Vainio , guhte deaivvai muhtimin leat jođus skihppáriiguin davás aiddo Evá-Jovnna buvdda buohta , go 	biila šlivgasii 	badjelgeainnu nu leavttuin ahte geaidnoravda dušše lei sáttoborgan . #other
Deanu bearráigeahččiid 	biila saboterejuvvui 	Áhguoikkas mannan maŋŋebárgga dan_botta_go bearráigeahččit ledje dárkkisteamen .
Kárášjoga politiiját šadde maiddái vuoddját Gárggoluobbalii , gos 	biila lei 	vuodján badjel . #vuodjit 
Kárášjoga Leansmánni kántuvrras muitalit ahte 	biila roakčanii 	álfárot , muhto eai dieđe siva lihkohisvuhtii . #other
Diggi mearkkaša ahte fárremis galgá 	biila čuožžut 	« oaneheamos lági mielde » bákkis gos ii leat lohpi bissehit biilla . #other
Jus leat fitnodatbiilaortnet muhtin áiggi sisaboahtojagis , dalle čađahuvvo ovdamunnevearromáksin gorelogu geavahettiin daid olles dahje álgojuvvon mánuid ovddas go 	biila lea 	leamaš anus . #other
Su 15. 	biila bođii 	skeaŋkkas #boahtit
Dat ruovddit , mas mu 	biila galggai 	rahkaduvvot lea ain nu čiekŋalasas eatnán vuoldi , ahte daid ii rokka doppe oktage . #other
Bolesa álgodutkamiid mielde Norgii vuoddjiid 	biila lei 	heajos siivvu geažil gártan boasttu beallái geainnu ja deaivvai Suoma guvlui johtti biilii , mas lei vel skohter maŋŋevovnnas . #other
studentii geas ii leat 	biila ii 	ge borggut . #other
Lihkuhisvuođa báikkis áššáskuhtton olmmái beasai čájehit gokko 	biila bisanii 	ja movt son jáhkká ášši dáhpáhuvvan . #bisánit
Aktorat čujuheigga ahte olmmái lea goitge vuodján fuollatmeahttumin leaččai dál guorbmebiila boahtán ovddal vai ii , dainna vuođuštemiin ahte mánávonna ii lean sáhttit garvit goitge luohka nalde , jus 	biila livččii 	boahtán ovddal . #boahtit
Okta biilavuoddji muitalii ahte dát 	biila lei 	vuodján su meattá garra leavttuin veaháš ovdalis . #vuodjit 
Le a go du 	biila gámahuvvon 	dálvái ? #other
Le a go du 	biila gámahuvvon 	dálvái ? #other
Iska ahte du 	biila doaibmá 	ovdal vuoddját . #vuoddját
Skuter ja 	biila beaškkehedje 	oktii sotnabeaivve #other
Dalle sáhttá 	biila deaddit 	3500 kilo . #other
- Dus sáhttá leat gálvojorri maŋis man alimus ollislaš deaddu lea badjel 750 kilo , muhto dalle ii galgga 	biila leat 	nu lossat , dadjá son ja lohká dieid njuolggadusaid leat váttisin ja daid ferte dárkilit iskat ovdal_go vuolgá geasehit maidege . #other
	Science texts –
Lokatiivva geavaheami sáhttá čilget fas dainna , ahte lokatiiva almmuha maid oamasteami , omd. Mus lea 	biila vrd. 	gen . #other
áigge dadjat 	biila bassui 	arvvi ovddas , lihtti bassašuvvá ( omd go beare bijat dan #other
O ( b ) lea stoahkame biillain ja 	biila manná 	vulosguovlluid ja várra danne son hutká ođđa #mannat
Máhtte lea vuodján biillain ovtta bohcco njeaiga , ja dan gal oidnet buohkat , go 	biila lea 	boazonaga . #other
NP 	biila oažžu 	gal iežas temáhtalaš rolla ( TEMÁ ) D-struktuvrras . #other
Dárogiela málle mielde biddjojuvvo passiivacealkaga lohppii vel lokatiivvahápmásaš dahkki : Du 	biila lea 	divvojuvvon mis ( O. H. Magga 1987 : 133 ) . #other
