Boađus: 73
Dovddatgo	daid ? #dovdat
Eanas suohkanat	dovddadit	liikká #recip
Mun lean fuolastuvvan go dat rámmat mat dán rádjai leat biddjojuvvon , eai čielgasit	dovddat	dan , dadjá Sara .  #dovddahit + Acc kaus
Dovddatgo	dán sáni ?  #dovdat
Dovddatgo	spahčat-vearbba ?  #dovdat
Avvir – 
– Mun sávan dieđusge ahte beasan viidáseappot go lea gal nuge ahte Kárášjohka lea unna servodat gos buohkat	dovddadit	ja soitet de buohkat jienastit iežaset guovllu nieidda viidáseappot .  #recip
– Mun in dieđe geasa dat gullet , muhto dieđán Suoma beale badjeolbmot leat fitnan	dovddadeamen	mearkkaid ja sii sáhttet dan duođaštit , čilge son . #recip kont + acc
Dan lohká váttisin go	dovddadeaba	nu bures . #recip
Su teavsttain oažžu dan dovddu ahte Niko lea dilálašvuođain geahčči mii čuovvu mielde , geahččá olggul , iige	dovddat	maidege - ovdal go su vásáhusat šaddet muitalussan su teavsttain . #dovddahit + acc kaus
Maŋimuš áiggiid leatge hárjehallan áŋgirit bihtáža « gonagas riehpu » ja Joks lohká dál juo vuohttán ahte mánát bures	dovddadit	. #recip
Dan lohká váttisin go	dovddadeaba	nu bures .  #recip
Oktasaš Gámmir evttohii ,	dovddatkeahttá	persovnnalaš dahje virge máhtuid ovttasge dain golmma sámi ovddasteddjiin Gámmáris , nammadit jur dan olbmo gii fuomášii jurdaga ráhkadit ( sámi ) ráđi guovllu ráđđehussii . #dovddahit + acc
Sii jáhkket ge ahte givssideapmi sáhttá maid das boahtit go nuorat eai	dovddat	. #recip
– Moai	dovddadeadnu	ja ledne oadjebasa iežame dáiddalašvuhttiid . #recip
Soai eaba	dovddadan	eabage áddehaddan , muhto soai logaiga « Oabbá , dán lean mun áibbašan , duinna deaivvadit » . #recip
– Oktavuohta olbmos olbmui álbmogis álbmogii , lea buoremus dáhkádus dasa ahte áddejupmi ja ráfi bistá máilmmis , go oktavuođat leat čadnojuvvon ja olbmot	dovddadit	. #recip
Son muitala ahte eai han sii	dovddadan	go ledje goabbat gilis eret ja ii lean nu ollu oktavuohta giliid gaskka dalle . #recip
Vuordinlanjas leat ollu olbmot ja buohkat čalbmetbealit , eatnašat sis leat ovddit jagiid oaidnalan dán vuordinlanjas ja muhtimat	dovddadit	oalle bures . #recip
Sii	dovddadit	bures , lujávrilaččat ja kárášjohkalaččat , maŋŋágo guoktelogi jagi leat leamaš ustibat . #recip
Religion texts – 
Dovddatgo	don almmi lágaid , oaččutgo don dan ortnega gustot eatnama alde ? #dovdat
Non-fiction texts – 
Mii beassat	dovddadit	árgabeaivválaš dáhpáhusaide ja muittuide . #ill ??? continuative?
dovddadat	dan albmái gii máhccá beahttašumiin ruovttoluotta Máhtebáikái . #ill ?? continuative?
Mii beassat	dovddadit	Ándde #error should be dovddiidit
Mii beassat álggos jo románas	dovddadit	#recip
Olbmot leat	dovddadan	ja diehtán geat sin fuolk kit leat . #recip
Mii	dovddadit	bures ja leat ovdal nai ovttasbargan , lohká Aili Keskitalo . #recip
Máhte guovttos Márehiin	dovddadeaba	 #recip
Moai	dovddadeimme	dalánaga . #recip
Lei maiddái buorre go skuvla lei unni , buohkat	dovddadedje	, ja dat dagai oadjebasvuođa buohkaide . #recip
Ean moai šat	dovddadan	. #recip
Fiction texts – 
- Mun lean Mártte-Iŋgá , ean dáidde	dovddadit	, mun orun dál doppe Kajaanis . #recip
Hemmo jámii , Áhkku jámii , eallimis jávke bealit , maiguin	dovddadii	ja sadjái bohte ođđa áššit . #recip + com
Guokte olbmo goabbatlágan máilmmis goabbatlágan eallinoainnuigu in leigga	dovddadan	ja vajáldahttán dan , mii earuhii ja leigga addán válddi dovdduide . #recip
Eamida ja Hemmo jápmima maŋŋá son ii šat riekta	dovddadan	ruovttubáikkiinis . #recip + com
Sohkabuolvvat eai šat	dovddadan	, dološ bearašvuogádat lei bieđganeamen . #recip
Soai	dovddadeigga	vuoiŋŋalaččat ja luossabivdu lei dušše čiekŋudan dán oktiigullevašvuođadovddu . #recip
Lei ártet , mo muhtun olbmot	dovddadedje	bures eallimiin ja soapmásat ledje juo eatniheakkas vierrásat dasa . #recip
Ja dát leige máilbmi , mainna	dovddadii	ollu buo rebut go dainna ovddibuin , masa lei goas nu riegádan . #recip + com
Hánno-Hánsa gulai daidda olbmuide , gii	dovddadii	bures ođđaáigásaš eallinvugiin . #recip + com
Son lei loahpalaččat luohpan fárrenjurdagis , go lei mihcamáraid 68 deaivan Hánno-Ovllá , geainna lei dalán bures	dovddadan	ja juo dan seamma čavčča náitalan . #recip + com
Dát lei dat máilbmi , mainna	dovddadii	bures . #recip + com
Risten lei áidna , geainna lei álo bures	dovddadan	. #recip + com
Olmmoš , gii lei riegádan gilážis , juogo	dovddadii	dainna dahje háliidii das guhkás eret , jos veháge vejolaš . #recip + com
Son ii šat	dovddadan	govvačehpiin , lei beanta ballagoahtán dás , oahpes olbmos . #recip + com
Jearaldathan lei buiga amas olbmos , iige dakkára jápmin sáhttán goassige gohccáhit seammalágan dovdduid go olmmoš , geainna lei duođaidge	dovddadan	. #recip + com
Muhto juoga sivas	dovddadii	Heaikkain . #recip + com
Manin viggat veagal doalahit oktavuođa juogamasa , mainna ii	dovddadan	? #recip + com
Dušše jápmimiin orui	dovddadeamen	. #recip + com
Son lei álo bures	dovddadan	girjeráju nuorat bargiin ja áiggi mielde sudno gaskii lei šaddan ustitvuohta ja loahpas ráhkisvuohta . #recip + com
Soai	dovddadeigga	vuoiŋŋalaččat ja hálešteigga muhtumin gitta idjii . #recip
Son	dovddadii	iežainis , diđii gii lei ja maid áiggui eallimis . #recip + com
Doaihan	dovddadeidde	bures ? #recip
Go sáhttá leat nu ahte buohkat eai	dovddat	ovddežis , de dáidá leat buoremus ahte mun muitalan gii lea gii - mun gii dovddan din buohkaid . #dovdat
Snihkkenbarggut ledje guhká leamaš su birgenláhkin , ja dát lei dat máilbmi , mainna lei	dovddadan	, ollu buorebut go kafea doallamiin . #recip + com
Muhto Ánná lei gal áican ; muittii dovdomearkan — man bakte mu maŋŋel	dovddadii	, bessen láddan áigái diehtit . #recip + acc
Muhto	dovddatgo	mu ? #dovdat
Gávpogiin ja stuorra báikegottiin ášši lea nuppeláhkai - olbmot eai	dovddat	seammaláhkai dego dáppe . #recip
Law texts – 
Cealkámuš ii	dovddat	mieđiheamen álbmogii goahccevuovdái geavahanvuoigatvuođa , ja ferte juohke dáfus leat čielggas ahte lei áigga sihkkarastit Gonagassii goahccevuovdái eanet vuoigatvuođa go lastavuovdái . #dovddahit + Acc kaus
Min Aigi – 
De son gal	dovddadii	gos son lea , go ovdal lei dakko vázzán . #recip + fs (acc)
Eadni váibmu vardá go mánát su eai šat	dovddat	#dovddahit + acc kaus
Dalá olbmot elle árbevirolaš servodagas , mas buohkat	dovddadedje	ja olbmuin lei lagas oktavuohta . #recip
Rasisma gal baicca gávdno juohkesajes gos olbmot leat , vaikko olbmot eai	dovddat	dan . #dovddahit + acc kaus
Smávva báikkažis	dovddadit	buohkat , dahje leat fulkkežagat . #recip
Ii leat dihtosis manin nu lea , muhto muhtun spábbačiekčandovdit Kárášjogas árvalit ahte gánddat	dovddadit	buorebut goabbatge joavkkus . #recip
Lea ollu mii šaddá álkkit go mii	dovddadat	! #recip
Hætta mielas lea stuorámus hástalus oažžut joavkku ovttas doaibmat , muhto oaidná ovdamuni go ollu čiekčit	dovddadit	guhte guimmiideaset . #recip + acc
Gilli lea smávis ja buohkat	dovddadit	. #recip
Seamma jávregáttis riegádan , muhto eaba	dovddadan	#recip
- Dat mii lei mearkkašahtti lea ahte guktot leaba bajásšaddan Durdnosjávregáttis , muhto eaba	dovddadan	mánnán ja nuorran , go leaba ássán goabbatge beale stuora jávrri . #recip
- Mu mielas lea dehálaš ahte nieiddat šaddet oadjebasat ja	dovddadit	earáiguin joavkkus . #recip + Com
Ártet han dán oktavuođas lea go dážaid iežas eaktodáhtolaš servviid ( Jeger og fiskeforening ) departemeanta ii	dovddat	seamma eahpádusa . #dovddahit + acc kaus
Science texts – 
Automatiiva passiivva diskursa ii	dovddat	gáldu guđege láhkai − dušše áicanvearbbat #dovddahit + acc kaus
suorggádusat eai nappo	dovddat	gáldu ja gažaldatge dan hárrái lea irrelevánta . #dovddahit + acc kaus
