Boađus: 1 481
								
	Administrative texts –
Dálveguohtun mas lea aivvefal jeagil , šaddá dalle go muohta lea badjel 30 cm ja temperatuvra 	njiedjá 	–10°C . #temperatuvra XT-Acc
Dušše ovtta jagis , 1957 rájes -58 rádjái 	njiejai 	lohku 37 % ja jagis 1981 rájes -82 rádjái njiejai lohku 31 % ja njiedjanlohku lea jagis 1990 rájes 91 rádjái ges 25 % .  #lohku XT-Acc  #lohku XT-Acc
Dušše ovtta jagis , 1957 rájes -58 rádjái njiejai lohku 37 % ja jagis 1981 rájes -82 rádjái 	njiejai 	lohku 31 % ja njiedjanlohku lea jagis 1990 rájes 91 rádjái ges 25 % . #lohku XT-Acc  #lohku XT-Acc
Østre-Nååmesjevuemies leat deattut bisson dássedin , muhto Skjækerfjellas leat deattut 	njiedjan 	daid maŋemus jagiid . #deaddu
Dálveguohtun mas lea aivvefal jeagil , šaddá dalle go muohta lea badjel 30 cm ja temperatuvra 	njiedjá 	–10°C . #temperatuvra XT-Acc
Dušše ovtta jagis , 1957 rájes -58 rádjái 	njiejai 	lohku 37 % ja jagis 1981 rájes -82 rádjái njiejai lohku 31 % ja njiedjanlohku lea jagis 1990 rájes 91 rádjái ges 25 % . #lohku XT-Acc  #lohku XT-Acc
Dušše ovtta jagis , 1957 rájes -58 rádjái njiejai lohku 37 % ja jagis 1981 rájes -82 rádjái 	njiejai 	lohku 31 % ja njiedjanlohku lea jagis 1990 rájes 91 rádjái ges 25 % . #lohku XT-Acc  #lohku XT-Acc
Østre-Nååmesjevuemies leat deattut bisson dássedin , muhto Skjækerfjellas leat deattut 	njiedjan 	daid maŋemus jagiid . #deaddu
Praktihkkalaš váttisvuođat oahpahusain sámegielas ja sámegilli Norgga , Suoma ja Ruoŧa rádjeguovlluin lea stuora eretfárren , mii lea duogaš dasa go mánáidlohkku geat skuvlii álget lea 	njiedjan 	.
Ohcejoga gielddas lea olmmošlohkku 	njiedjan 	sullii 10% 1995 rájes , mii čielgasit boahta oidnosii mánáid logus geat skuvlii álget .
Váldosivvan lea ahte biergohaddi boazoeaiggadiidda lea 	njiedjan 	25% maŋimus jagi .
Oarjilsámegiela dáfus , de oahppiid lohku lea 	njiedjan 	123 oahppis jagi 2005-2006 gitta 105 oahppái jagi 2008-2009 . #lohku LO-Loc DE-Ill
Julevsámegiela dáfus , de oahppiid lohku lea 	njiedjan 	88 oahppi rájis skuvlajagi 2005-2006 gitta 79 oahppi rádjai jagi 2008-2009 . #lohku LO-Loc DE-Ill
maid Sámi statistihka fágalaš guorahallanjoavku lea ráhkadan , muitaluvvo ahte sámegiela oahppiid lohku lea 	njiedjan 	nubbegiel- lafágas ja ahte livččii sivva divaštallat erenoamážit nubbegiellafága eavttuid . #lohku
Earret eará oaidnit ahte daid oahppiid ollislaš lohku guđet válljejit sámegiela fágan , lea 	njiedjan 	veahá maŋŋágo Máhttolokten álggahuvvui , ja sin lohku guđet válljejit sámegiela rievddalda fylkkain . #lohku
Dáčča ássiid logu 	njiedjan 	lei eahpitkeahttá áittan formálalaš eananvuoittuide máid muđui ledje ožžon .  #njiedjan-N
Dáčča ássiid logu 	njiedjan 	lei guovddášeiseválddiid oainnu mielde nu duođalaš ahte 1600-logu maŋit oasis gávnnahedje dárbbašlažžan áibbas earenoamáš čađahemiid lasihan dihte dáčča ássiid .  #njiedjan-N
Earret eará sáhttá siidda boazolohku lassánit náitaleami geažil , muhto nuppe jagi sáhttá fas 	njiedjat 	go soames náitala eará siidii . #lohku
Ceahkkelinnjá čájeha ahte buvttadeapmi 	njiedjá 	juohke bohcco nammii go guohtundeaddu lassána .
Olles linnjá čájeha ahte buvttadeapmi lassána areála mielde go guohtundeaddu lassána vuollegis dásis gaskadássái , ja buvttadeapmi 	njiedjá 	go guohtundeaddu lassána gaskadásis alla dássái .
Jus guohtundeaddu lassána vel eambbo , de boahtá dattege šaddu juohke bohccos 	njiedjat 	go gilvu guohtunriggodagaid nalde lassána .
Nubbe váttisvuohta lea ahte šaddá atnit heajut bohccuid ealihanboazun , ja dat sáhttá guhki vuollái váikkuhit ahte gaskamearálaš deattut 	njidjet 	.
Dát mearkkaša ahte lohku lea 	njiedjan 	134 ohppiin , ja mearkkaša sullii 5 proseanta njiedjama skuvlajagi 2006–07 ektui . #lohku XT-Com
Bohccobiergohattit lea 	njiedjan 	bahás ja sámi ealáhusat leat
Dat dagahii ahte boazolohku 	njiejai 	drástalaččat . #haddi #lohku
Seammás lea olbmuid beroštupmi 	njiedjan 	ii-sámi báikkálašmediain informašuvdnakanálan sámi áššiide . #beroštupmi
Olmmošlohku SED-guovllus lea 	njiedjan 	16 proseanttain maŋemus 20 jagis . #lohku XT-Com
Čielgaseamos tendeansa sámegiela loguin mánáidgárddiin ja skuvllain jagi 2009/10/2009 lea ahte vuođđoskuvlaohppiid lohku geain lea sámegiella fágan 	njiedjá 	. #lohku
Oktiibuot lea dat 	njiedjan 	23 % jagi 2005 rájes .
Eanemus 	njiedjá 	ohppiid lohku geain lea davvisámegiella nubbingiellan . #lohku
Ságat áviissas lassánan deaddilanlohku– sámegielat áviissain 	njiedjan  #lohku	
Seammás lea beroštupmi 	njiedjan 	dárogielat báikkálašmediaide diehtooarrin sámi áššiide . #beroštupmi
beliin unnon , 16 % gitta 8% dan bottu go joavku mii válljii NRK guovllusáddagiid , 	njiejai 	19 % gitta 5 % . #0 XT-Acc DE-gitta
2.4.1 Ságat áviissas lassánan deaddilanlohku– sámegielat áviissain 	njiedjan  #lohku	
dán guovtti áviissas deaddilanlohku mii dagai oktiibuot 2112 gáhppálaga , dan bottu go Ávviris lei 1204 jagi 2009 , 	njiedjan 	43 % . #lohku XT-Acc
lea oalle mihtilmas gahččan , mii doaivumis mearkkaša ahte sámegieláviissaid lohkiid lohku lea 	njiedjan 	maŋŋel ovttasteami . #lohku
ahte go guđat sámediggeválggat ledje 2009 , de lei válgabiiriid lohku 	njiedjan 	čiežai . #lohku
Lullisámeguovllu oassi Sámedikki jienastuslogus 	njiejai 	seamma áigodagas ovttain proseanta-čuoggáin ; 7 % rájes 6 % rádjái .
Eanemus čalbmáičuohcci Govadat 6 lea ahte lohku suohkaniin , main eai lean dieđiheaddjit , 	njiejai 	38 , ja ahte lassánedje 26 eanet suohkana main leat gaskal okta ja golbma olbmo čálihan . #lohku
Namuhit ahte Norggas suohkaniid lohku 	njiejai 	433 rájes jagi 2005 , gitta 430 rádjái jagi 2009 . #lohku LO-rájes DE-rádjái
Deatnu bealistis 	njiejai 	14 olbmuin , dan bottu go Kárášjohka massii 37 olbmo jienastuslogus .
Deanus ja Kárášjogas čájehuvvo gaskadássásaš relatiiva ovdáneapmi jagi 1989 rájes 2009 rádjái , ja veaháš 	njiedjan 	čielga loguin 2005 rájes 2009 rádjái .
Njealji suohkanis fas 	njiejai 	jienastuslohku eanet go 10 dieđiheddjiin : #lohku XT-Com
Viidásit boahtá ovdan ahte 2001 rájes 2005 rádjái njealji dan 13 biires 	njiejai 	nissonoassi .
Go váldá vuhtii jienastuslogu oppalaš ahkejuogu , de čájeha Tabealla 3.10 vuosttažin ahte 2005 rájes 2009 rádjái 	njiejai 	oassi áibbas nuorra jienastuslogu čáliheddjiin 5% rájes 3 % rádjái .
Diet mearkkaša vaikko proseanttaid mielde lea válgaoassálastin 	njiedjan 	, 2009 lei 9 % unnit go 1989 , de ledje ráinnas loguid ektui eambbogat geat jienastedje sámediggeválggas 2009 go 1989 .
Go buohtastahttá stuoradiggeválgga oassálastimiin seamma áigodagas , de 	njiejai 	doppe maid 7 % .
Govva 3.17 boahtá ovdán , ahte sihke jienastuslogu lassáneapmi ja lassáneapmi sin gaskkas geat jienastedje , 	njidje 	válggas válgii gitta 2001
Mearkkašanveara tendeansa Govva 3.19 lea , ahte válgaoassálastin 	njiedjá 	veahážiid mielde , mađi lullelis riikkas muhtin válgabiire lea .
Tabealla 1 čájeha nissonolbmuin leamaš unnán 	njiedjan 	sin gaskkas , geat ožžo bargonávccahisvuođaoaju áigodagas 1992 gitta 2004 rádjái , sihke siskkobealde ja olggobealde SED guovllu .
dievdoolbmuin , gea ožžot barggonávccahisvuođaoaju , 	njiejai 	guhkit áiggi badjel dušše dan boarráseamos ahkejoavkkus .
Sosiálaveahki vuostáiváldit lohkku lei alimusas 1993 , go dalle ledje lagabui 165 000 vuostáiváldi , ja dan rájes lea diet lohku 	njiedjan 	. #lohku
seammás go Vest-Agderis ja Buskerudas leat eanemus 	njiedjan 	diet logut .
bargguhisvuohta lea 	njiedjan 	seamma áigodagas .
Olmmošlohku SED-guovllus lea 	njiedjan 	16 proseanttain maŋemus 20 jagis , dan bottu go olmmošlohku muđui guovllus davábealde Sáltoduoddara – go olggušta #lohku XT-Com
daid stuorámus gávpogiid – lea 	njiedjan 	8 proseanttain .
olmmošlohku njiedjan 16 proseanttain , dan bottu go muđui dain eará guovlluin lohku lea 	njiedjan 	8 proseanttain . #lohku XT-Com  #lohku XT-Com
ovdáneapmi obba SED-guovllus , gos olmmošlohku lea maŋos mannán duššo 5 proseanta , ja Davvi-Romssas lea maiddái lohku 	njiedjan 	unnit ( 13 proseanta ) go #lohku
Nuorta-Finnmárku ja Lulli- // Gaska-Romssas lea lohku 	njiedjan 	21 proseanttain , #lohku XT-Com
dan bottu go Davit Nordlánddas lea olmmošlohku 	njiedjan 	23 proseanttain ja #lohku XT-Com
Oarje-Finnmárkkus lea eanemusat 	njiedjan 	olmmošlohku , olles 34 proseanttain . #lohku XT-Com
Olles guovllus lea lohku 	njiedjan 	8 proseanta , ja vihtta guđa eaŋkilguovllus lea lohku njiedjan gaskal 5 ja 8 proseanta . #lohku XT-Acc
Olles guovllus lea lohku njiedjan 8 proseanta , ja vihtta guđa eaŋkilguovllus lea lohku 	njiedjan 	gaskal 5 ja 8 proseanta . #lohku XT-Acc
Romssas lea lohku 	njiedjan 	eanet , 10 proseanttain . #lohku XT-Com
Muosát SED olmmošlohku lea eanemusat 	njiedjan 	, olles 57 proseanttain , eanetgo beliin unnon duššo 20 jagis . #lohku XT-Com
Davvesiiddas , Hamarøyas ja Nordkáhpas 	njidjet 	logut sihke SED-guovllus ja muđui eará guovlluin .
Láhppái , gos olles suohkan lea SED-guovlu , čuohcá 	njiedjan 	garrasepmosit , go áigodagas njiedjá eanet go okta goalmmádas oassi .
Láhppái , gos olles suohkan lea SED-guovlu , čuohcá njiedjan garrasepmosit , go áigodagas 	njiedjá 	eanet go okta goalmmádas oassi .
bottu go muđui guovllus lea 	njiedjan 	26 proseantta .
Suohkaniin , main eai leat SED-guovllut , sierrana Sortlanda daningo doppe lea lohku lassánan 18 proseanttain , dan bottu go dain eará suohkaniin lea dávjjimusat 	njiedjan 	lohku , goasii liika ollu njiedjan go SED-guovlluin . #lohku
Eanaš suohkaniin lea 	njiedjan 	goitge unnit go SED-guovlluin . #0
Nuppe vuoru lea joavku 20-29 jagi goasii beliin unnon , lea unnon 7 100 rájes jagi 1900 gitta 3 900 rádjái dál , 	njiedjan 	45 proseanttain .
Olles riikas obbalaččat , lea oassi 20-39 ahkahaččat maiddái 	njiedjan 	seamma áigodagas , muhto duššo 30 proseanttas 27 prosentii .
	njiejai 	29 proseanttas 21,5 prosentii ) lea dasto ollu eanet njiedjan .
birrasiid 100 , de 	njiejai 	dát 40 rádjái jagi 2000 , ja das maŋŋel lea leamaš vuollebáza , maŋemus jagiid gaskal 40 ja 70 .
geain lea sámegiella fágabiires , joatká 	njiedjat 	.
Dát lohku lea dál 	njiedjan 	oktiibuot 709 ohppiin bárisjagi 2005/06/2005 rájes . #lohku XT-Com-Ani
Vuosttažettiin 	njiedjá 	lohku ohppiin geain lea davvisámegiella nubbingiellan . #lohku XT-Com-Ani
Lohku lea 	njiedjan 	39 % 2005 rájes . #lohku XT-Acc
lea baicca 	njiedjan 	56 , 940 rájes 2008/09/2008 gitta 883 rádjái 2009/10/2009 . #lohku XT-Acc
Skuvlajagi 2008/09/2008 rájes skuvlajagi 2009/10/2009 rádjái 	njiejai 	lohku #lohku
2005/06/2005 rájes lea lohku ohppiin geain lei davvisámegiella nubbingiellan 	njiedjan 	687 . #lohku XT-Acc
Čielgaseamos ja duođaleamos tendeansa sámegiela statistihkas mánáidgárddis ja skuvllas skuvlajagi 2010/11/2010 , lea 	njiedjan 	logus galle oahppi válljejit sámegiela nubbingiellan vuođđoskuvllas . #tendeansa
Dat lohku lea 	njiedjan 	dán ge skuvlajagi , nugo lea dahkan jahkásaččat maŋemus vihtta jagi . #lohku
Davvisámegiella nubbingiella fágas lea ohppiid lohku 	njiedjan 	olles 40 % 2006 rájes . #lohku XT-Acc
Rievssatbivdu lea 	njiedjan 	hirbmosit maŋemus jagiid , jáhku mielde danne go smávvafuođđonálit leat njiedjan ja go lea leamaš garra bivdodeaddu guhka máŋgga guovllus .
Rievssatbivdu lea njiedjan hirbmosit maŋemus jagiid , jáhku mielde danne go smávvafuođđonálit leat 	njiedjan 	ja go lea leamaš garra bivdodeaddu guhka máŋgga guovllus .
18 2 Duođalaš 	njiedjan 	fágas sámegiella nubbingiella
2 Duođalaš 	njiedjan 	fágas sámegiella nubbingiella
Čielgaseamos ja duođaleamos tendeansa statistihkas sámegiella mánáidgárddis ja skuvllas skuvlajagi 2010/2011/2010 lea ohppiidlogu 	njiedjan 	dain geat válljejit sámegiella nubbingiellan vuođđoskuvllas . #lohku
 Dát lohku joatká 	njiedjat 	dán skuvlajagi , nugo lea dahkan jahkásaččat maŋemus vihtta jagi . #lohku
Fágas davvisámegiella nubbingiellan lea ohppiid lohku 	njiedjan 	olles 40 % 2006 rájes . #lohku XT-Acc
Lohku mánáidgárddiin maid Sámediggi gohčoda sámi mánáidgárdin , gal lea 	njiedjan 	maŋemus vihtta jagi ollislaččat , muhto mánáidgárdefálaldagat gohčoduvvon sámegielat fálaldat dárogielat mánáid #lohku
Lohku mánáin geat válde vuostá sámegielat mánáidgárdefálaldaga 	njiejai 	66 mánáin jagis 2009 jahkái 2010 , dat lea seamma go 7,5 proseantta njiedjan . #lohku XT-Com-Ani
Lohku mánáin geat válde vuostá sámegielat mánáidgárdefálaldaga njiejai 66 mánáin jagis 2009 jahkái 2010 , dat lea seamma go 7,5 proseantta 	njiedjan 	. #lohku XT-Com-Ani
Jus bidjat vuolggasadjin 2006 , de lea 	njiedjan 	leamaš 158 mánáin , dat vástida 16 % . #lohku XT-Com-Ani
Mánáid lohku sámi mánáidgárdefálaldagain lea maŋemus vihtta jagi 	njiedjan 	relatiivalaš ollu , ja das leat muhtun sullásaš rievddadeamit go máid maŋŋelis oaidnit vuođđoskuvllas . #lohku
	Njiedjan 	mánáidgárddiin ii leat goitge nu ollu go njiedjan vuođđoskuvllas .
Njiedjan mánáidgárddiin ii leat goitge nu ollu go 	njiedjan 	vuođđoskuvllas .
Áigodagas 2006 gitta 2010 	njiejai 	olles Finnmárkkus golmma- , njeallje- ja viđajahkásaččaid lohku 16 % Romssas vuollelaš 6 % ja Nordlánddas #lohku
Go nu geahččá de livčče sáhttán mánáidgárdemánáid lohku sámi fálaldagain lassánit , vaikko ollislaš mánáidlohku 	njiedjá 	. #lohku
Tabealla 2.7 čájeha ahte 2009 lei buoremusjahki , muhto 	njiejai 	beliin jahkái 2010 . #lohku XT-Com
Ollislaš lohku ohppiin geain lei sámegiella fágabiires Norgga vuođđoskuvllain 	njiejai 	101 ohppiin skuvlajagis 2009/10/2009 skuvlajahkái 2010/11/2010 . #lohku XT-Com-Ani
Dat lea 4,3 % 	njiedjan 	jagis .
Tabealla 2.8 čájeha viidásit ahte ollislaš lohku ohppiin geain lea sámegiella dárogielat vuođđoskuvllas lea 	njiedjan 	juohke jagi dan rájes go skuvlareforbma Máhttolokten čađahuvvui 2006:s . #lohku
Oktiibuot lea lohku 	njiedjan 	810 ohppiin skuvlajagi 2005/2006/2005 rájes . #lohku XT-Com-Ani
Ohppiidlogu 	njiedjan 	lei #njiedjan-N
Jus juohká loguid sámegielaid mielde , de oaidnit ahte davvisámegielas ja lullisámegielas lea leamaš sullii ovttamađe proseanttalaš ohppiidlogu 	njiedjan 	maŋemus vihtta jagi .
Lohku ohppiin geain lea sámegiella vuosttašgiellan dárogielat vuođđoskuvllas 	njiejai 	39 ohppiin skuvlajagis 2009/10/2009 jahkái 2010/11/2010 .
Dat lea 4 % 	njiedjan 	. #njiedjan-N
Máhttoloktema rájes lea leamaš oktiibuot 3 % 	njiedjan 	. #njiedjan-N
3 % njiedjan viđa jagis 2005/06/2005 rájes 2010/11/2010 rádjai lea unnit go mánáidbessodagaid 	njiedjan 	Davvi-Norggas dan seamma viđa jagis .
Dat 	njiedjan 	lea badjel 7 % #njiedjan-N
Norgga vuođđoskuvllain lea sámegiella nubbingiellaohppiid lohku 	njiedjan 	62 ohppiin maŋemus jagi . #lohku XT-Com-Ani
Dát lea 5 % 	njiedjan 	. #0 XT-Acc
Máhttoloktema sisafievrrideami rájes lea nubbingiellaohppiid lohku 	njiedjan 	783 ohppiin , dat lea 38 % njiedjan viđa jagis . #lohku XT-Com-Ani  #lohku XT-Com-Acc
Máhttoloktema sisafievrrideami rájes lea nubbingiellaohppiid lohku njiedjan 783 ohppiin , dat lea 38 % 	njiedjan 	viđa jagis .  #lohku XT-Com   #lohku XT-Acc
Go geahččá erenoamážit davvisámegielat nubbingiela ohppiidlogu , de oaidná dan 	njiedjan 	40 % .  #lohku XT-Acc
Dat mearkkaša ahte 70 % olles njiedjamis 	njiejai 	dan guokte jagi . #Num
Lohku nubbingielohppiin vuođđoskuvllas Norggas lea maŋemus skuvlajagi 	njiedjan 	62:n . #lohku XT-Com
Dat lea 5 % 	njiedjan 	. #dat XT-Acc
Máhttoloktema sisafievrrideami rájes lea lohku nubbingielohppiin 	njiedjan 	oktiibuot 783:n , mii lea 38 % njiedjan viđa jagis .   #lohku XT-Com #lohku XT-Acc
Máhttoloktema sisafievrrideami rájes lea lohku nubbingielohppiin njiedjan oktiibuot 783:n , mii lea 38 % 	njiedjan 	viđa jagis .   #lohku XT-Com #lohku XT-Acc
Vejolaš ákkat stuora njiedjamii ja vejolaš ákkat dasa go olles 70 % 	njiejai 	jagiid 2006-2008 , digaštallojuvvo lagabui kapihttalis 2.4 vuollelis . #lohku XT-Acc
Ohppiidlohku fágas lullisámegiella nubbingiellan lea unnon 35 ohppiin maŋemus viđa jagis , ja lea 	njiedjan 	jahkásaččat daid jagiid . #lohku
Tabealla 2.11 čájeha ohppiid logu fágas Nubbingiella 3 	njiedjan 	eanet go Nubbingiella 2 . #D?
Nubbingiella 3 lea 	njiedjan 	leamaš 20 % jagi 2008 rájes . #D?
Fágas Nubbingiellan 2 lea 	njiedjan 	leamaš 5 % 2008 rájes , ja 2009/10/2009 rájes 2010/11/2010 rádjái oaidnit lassáneami 17 ohppiin ( 3 % fágas Nubbingiella 2 .
Kapihttalis 2.4 vuollelis , mas erenoamážit analyseret nubbingiela ohppiid loguid , váldit fas ovdan ahte ohppiid lohku Nubbingiella 3:s 	njiedjá 	eanet go fágas Nubbingiella 2:s . #lohku
Nu lea dán jagi maiddái , muhto Guovdageainnu vuosttašgiellaohppiid proseantaoassi lea mannan jagi 	njiedjan 	92 % rájes 80 % rádjai .
Sivas go lohku ohppiin geat ožžot vuosttašgiellaoahpahusa eará skuvllain , lea lassánan , de lea proseanttalašoassi sis geat ožžot oahpahusa Sis-Finnmárkkus 	njiedjan 	golbma maŋemus jagi . #lohku
Sámegiela duođaleamos dilálašvuohta Norgga skuvladoaimmahagas lea maŋemus vihtta jagi stuora 	njiedjan 	ohppiid logus geain lea sámegiella nubbingiellan .
Áiggun dás ságaškuššat vejolaš sivaid , nugo oppalaš urbaniseren servodagas , oppalaš 	njiedjan 	mánáidbessodagain Davvi Norggas maŋemus vihtta jagi , okta sámegiela fágaplánamolssaeavttu heaittiheapmi jagis 2006 , sámegielfága váttisvuođat fága- ja diibmojuhkosiin ja unnán heivvolaš oahpahusmodealla mii dál lea anus ohppiin geain lea sámegiella nubbingiellan .
Lunddolaš čilgehussan ohppiidlogu njiedjamii sámegiella nubbingielas , sáhttá leat dat go olmmošlohku oppalaččat 	njiedjá 	árbevirolaš sámi guovlluin #lohku
Go olmmošlohku 	njiedjá 	, de njiedjá maiddái ohppiidlohku skuvllas . #lohku  #lohku
Go olmmošlohku njiedjá , de 	njiedjá 	maiddái ohppiidlohku skuvllas . #lohku  #lohku
Jus dát jurddašuvvon eret fárren gáivuonabearaš vállje sámegiela fágan skuvllas Romssas maiddái , nugo dahke Gáivuonas , de ii 	njieja 	sámegiela ohppiidlohku olles riikkas . #lohku
Jus mánáid lohku vuođđoskuvlaagis lea 	njiedjan 	olles riikkas maŋemus vihtta jagi , de dáidá ohppiid lohku geain lea sámegiella fágabiires jáhku mielde maiddái njiedjan . #lohku #lohku
Jus mánáid lohku vuođđoskuvlaagis lea njiedjan olles riikkas maŋemus vihtta jagi , de dáidá ohppiid lohku geain lea sámegiella fágabiires jáhku mielde maiddái 	njiedjan 	. #lohku #lohku
Logut statistihkalaš guovddášdoaimmahagas čájehit vuođđoskuvlaagi mánáid logu Norggas 	njiedjan 	measta ovttain proseanttain jagi 2005 rájes 2010 #lohku XT-Com
Golmma davimus fylkkas 	njiejai 	ohppiidlohku vuođđoskuvllas 7,5 % dan áigodaga #lohku XT-Acc
Mii oaidnit Davvi-Norggas oppalaš mánáidbessodagaid 	njiedjan 	nu ollu ahte dat ferte váikkuhan maiddái sámegielfága ohppiid lohkui .
Muhto čieža proseanta oppalaš 	njiedjan 	Davvi-Norgga vuođđoskuvllaid ohppiidlogus , ii sáhte goitge leat olles čilgehus 38 % njiedjamii fágas sámegiella nubbingiella .
Finnmárkkus 	njiejai 	lohku 7,61 proseanttain , Romssas 7,19 % ja Nordlánddas 7,72 % .#lohku XT-Com
Muhto ii soaitte juste 	njiedjan 	váttisvuohta , njiedjama sáhttá liikka bures oaidnit symptoman muhtun váttisvuhtii .
Duohtavuohta ahte ohppiidlohku ii 	njieja 	nu ollu sámegielas vuosttašgiellan , doahttala dán hypotesa . #lohku
Rievssatbivdu lea 	njiedjan 	garrasit maŋemus jagiid , jáhku mielde danne go smávvafuođđonálli lea njiedjan ja lea leamaš garra
Rievssatbivdu lea njiedjan garrasit maŋemus jagiid , jáhku mielde danne go smávvafuođđonálli lea 	njiedjan 	ja lea leamaš garra #lohku
oažžu 	njiedjat 	lea danne ráddjejuvvon doaibmat , go boazoeaiggádiidda lea eanet gánnáhahttin stuora eallu . #0
2008-2009 lassánedje massimiid ohcamušat Finnmárkkus muhto riikkadásis 	njiejai 	ohcamuš lohku massiimiid ovddas áigodaga 2008-2010 .
Go buhtadusaid galge bidjat oktii , de čájehuvvui ahte lohku ohcamušain massimiid ovddas lei lassánan , ja lohku iskojuvvon ja duođaštuvvon ráppiin 	njiejai 	. #lohku
Dat oidno govvosis 3 mas lohku galle bohcco ovddas lea ohccojuvvon buhtadus lea lassánan seammás go lohku duođai buhtaduvvomiid ovddas lea bisson dássedin 2005 rájes earret 2006/2007/2006 goas lei veaháš 	njiedjan 	.
Romssas leat geatkevahágahttimat 	njiedjan 	, ja Davvi-Trøndelagas leat guovžafalleheamit lassánan maŋemus jagi .
Eanas jogain lea rievddadan áiggi mielde man ollu sálaš lea , muhtumiin luossasálaš 	njiedjá 	ja earáin lassána .
Bissojogas ja Stuorrajogas lea sálaš 	njiedjan 	áigodagas muhto lea lassánan Leavdnjajogas , Riehpovuonjogas ja Rávttošjogas .
Mearraluossabivdu 	njiedjá 	riikkadásis SGD loguid mielde .
luosa ja 131 759 tonna 2009-2010:s mii lea eanemus 	njiedjan 	eará guovlluid ektui riikkas .
Áigodagas 2009/2010/2009 	njiejai 	olles 21 % ovddit áigodaga ektui .
Bárisáigodaga 2005/2006/2005 rájes lea bivdon rievssahiid lohku 	njiedjan 	40 000 lottiin dušše Finnmárkkus . #lohku XT-Com-Ani
21 % 	njiedjan 	ovddit áigodaga rájes .
Doavttergrádabuvttadeapmi oppalaččat lea lassánan hirbmosit 20 jagi áigodagas máid guorahallat , ja UiT lea measta duppalastan nákkáhallamiid logu 2006 rájes 2009 rádjai , vaikko lei veaháš 	njiedjan 	2010:s
Luonddudiehtaga doavttergrádabarggut boazodoalu birra biologiija ja fysiologiija siskkobealde leat árbevirolaš kvantitatiiva fágasuorggit main lea leamaš dássedis buvttadeapmi sámi-guoski doavttergrádain olles áigodaga 1990 rájes 2010 rádjai , buvttadeamis lea lassáneapmi vaikko lohku lea veaháš 	njiedjan 	maŋemus oasis áigodagas . #lohku
SED-guovlluin lea olmmošlohku 	njiedjan 	16 proseanttain maŋemus 20 jagi . #lohku XT-Com
Olmmošlohku SED-guovllus lea 	njiedjan 	16 proseanttain maŋemus 20 jagi . #lohku XT-Com
Nissoniid oassi siidadoallin orru 	njiedjan 	veaháš maŋemus jagiid .
SED-guovllus lea oapmedáluid lohku 	njiedjan 	62 proseanta . #lohku XT-Acc
Gaskamearálašahki 	njiejai 	veaháš sihke dievdduin ja nissoniin badjelis namuhuvvon áigodagas – 51,6 rájes 49,7 rádjái dievdduin ja 54,3 rájes 48,6 rádjái nissoniin . #lohku
Lohku nissoniin geain lea guolásteapmi liigebargun lea unnon measta beliin seamma áigodaga , muhto maiddái lohku dievdduid geain lea guolásteapmi liigebargun lea 	njiedjan 	ollu seamma áigodaga . #lohku
Dievdduid ja nissoniid eallinagi erohus 	njiejai 	dan áigodaga bures 2,5 jagi . #erohus
Beaivválaš borgguheaddji nissoniid oassi lea maiddái 	njiedjan 	32 % rájes 1973:s gitta 22 % rádjai 2006:s .
Maŋemus jagi rievdan láktasa minstarii máid leat oaidnán guhkit áiggi , dássedis 	njiedjan 	beaivválašborgguheddjiin .
Dievdduid ja nissoniid borgguhandábit ledje goabbatláganat duhátjagimolsuma áigái , muhto leat dan rájes oktasaččat 	njiedjan 	.
Lohku sosiálaveahkeoažžuin lei bajimusas lagabui 165 000 vuostáiváldiin 1993:s , ja lea dan rájes 	njiedjan 	.
2007 rájes 2008 rádjai lea 	njiedjan 	bisánišgoahtán .
Ođđa bargonávccahisvuođaoaju vuostáváldit ahkejoavkkus 45 jagi ja nuorabut leat beliin 	njiedjan 	maŋemus gaskkadagas ( 2004-2008 ) buohtastahtton guvttiin ovddit vihttajagigaskkadagain .
Ahkejoavkkus 46-66 jagi lea maiddái 	njiedjan 	áigodagas , muhto ii nu čielgasit .
Sihke nissoniid ja dievdduid dáfus lea leamaš veahážiid mielde 	njiedjan 	oasis ođđa sosiálaveahki vuostáiváldit maŋemus golbma jahkegaskkadagain mat lea tabeallain .
Dan sáhttá várra jáhku mielde maiddái čilget muhtun muddui bargguhisvuođa 	njiedjan 	seamma áigodagas .
Dan rájes go 2006:s álggahuvvo nubbingiella 2 ja 3 , lea vuođđoskuvllas ohppiidlohku geain lea sámegiella fágabiires 	njiedjan 	2672 rájes 2245 rádjai skuvlajagi 2010/11/2010 .
Juolludeamit Romsii leat veaháš 	njiedjan 	, erenoamážit go geahččá dan ektui man mađe Sámedikki bušeahtta lea lassanan 2010 rádjai .
Norggas eai leat lassánan boraspire-vahátbuhtadusat dan mielde movt massimat dáhpáhuvvet , ja nu leage 	njiedjan 	dat man gohčoda “ buhtadus barggu ja ieškapitála ovddas ( vederlag for arbeid og egenkapital ) ” .
Norggas eai leat lassánan boraspire-vahátbuhtadusat dan mielde movt massimat dáhpáhuvvet , ja nu leage 	njiedjan 	dat man gohčoda “ buhtadus barggu ja ieškapitála ovddas ( vederlag for arbeid og egenkapital ) ” .
Nissonovddastus Sámedikkis lea 	njiedjan 	33 %:s 18 %:ii 1989 rájes 2001 rádjai .
Nubbi eará positiivvalaš dovdomearka eanadoalus sámi guovlluin lea dat , go dat doalut mat leat báhcán cevzet hui bures , ja go eanadoalliid gaskamearálaš ahki lea 	njiedjan 	.
Láhkaevttohusa duogážin lei ahte sámegiela geavaheapmi ovdal lei 	njiedjame 	, ja dat áittii oba sámekultuvrra eksisteanssa .
Doaluid lohku lea 	njiedjan 	546 doalus 444 dollui 2001 rájes 2003 rádjai .
Sávzadoaluid lohku lea eanemusat 	njiedjan 	, namalassii 25 proseanttain .
Jus mielkeearit 	njidjet 	ain eambbo , de dat sáhttá bilidit sámi eanadoalu .
Lohku lea 	njiedjan 	birrasiid 3 mill. ruvnnuin 1999 loguid ektui .
Nugo tabealla 11.1 čájeha , de lea ohppiidlohku geat ožžot davvisámegielas oahpu 	njiedjan 	skuvlajagis 2007/2008/2007 .
Eanemus lea 	njiedjan 	Finnmárkkus , gos ohppiid lohku geain lea sámegiella nubbigiellan lea njiedjan 1086 oahppis skuvlajagis 2006 959/2006 oahppái dán skuvlajagis .
Eanemus lea njiedjan Finnmárkkus , gos ohppiid lohku geain lea sámegiella nubbigiellan lea 	njiedjan 	1086 oahppis skuvlajagis 2006 959/2006 oahppái dán skuvlajagis .
Finnmárkku fylkamánne ii leat čáđahan iskkadeami čielggadit manne lohku lea 	njiedjan 	, muhto lea čilgen Máhttodepartementii ahte sivvan dasa sáhttá leat oahpu lágideapmi .
Finnmárkku fylkamánne hálida gávnnahit manne sámegiel ohppiid lohku lea 	njiedjan 	.
Ohppiid lohku oktiibuot , geat válljejit muhtun sámegiel oahpahusa , 	njiejai 	veaháš go eat váldán mielde fága sámegiella ja kultuvra , muhto ohppiid lohku geat válljejit sámegiela vuosttaš- dahje nubbigiellan lassánii veaháš skuvlajagis 2006/2007/2006 .
Boahtteáiggi hástalusaid ektui čujuhu skuvla ieš dasa ahte sámegielat ohppiid lohku dáidá 	njiedjat 	, muhto ahte skuvllas sáhttet leat 15 – 20 ollesáiggioahppi boahttevuođas , ja eaktun dasa lea ahte skuvla ain sáhttá doaimmahit giellalávgunoahpahusa .
Earret eará manne oasit Sámeálbmot foandda dietnasis dása , juoga mii veahkehii dasa ahte lohku čáppagirjjálašvuođa giehtačállosiin mat leat dohkkehuvvon almmuheapmái , lea 	njiedjan 	.
Jienasteaddjiidlohku lea 	njiedjan 	eanemusat lulimus válgabiirriin Lulli-Norggas , Åarjel-Saepmie veeljemegievlie ( Trøndelágafylkkain ) ja Viestarmera válggabijrra ( Lulli-Romssa , Davvi-Nordlándda ja Gaska-Nordlándda suohkaniin ) .
Nugo tabealla 11.1 čájeha , de lea ohppiidlohku geat ožžot davvisámegielas oahpu 	njiedjan 	skuvlajagis 2007/2008/2007 .
Eanemus lea 	njiedjan 	Finnmárkkus , gos ohppiid lohku geain lea sámegiella nubbigiellan lea njiedjan 1086 oahppis skuvlajagis 2006 959/2006 oahppái dán skuvlajagis .
Eanemus lea njiedjan Finnmárkkus , gos ohppiid lohku geain lea sámegiella nubbigiellan lea 	njiedjan 	1086 oahppis skuvlajagis 2006 959/2006 oahppái dán skuvlajagis .
Finnmárkku fylkamánne ii leat čáđahan iskkadeami čielggadit manne lohku lea 	njiedjan 	, muhto lea čilgen Máhttodepartementii ahte sivvan dasa sáhttá leat oahpu lágideapmi .
Finnmárkku fylkamánne hálida gávnnahit manne sámegiel ohppiid lohku lea 	njiedjan 	.
Ohppiid lohku oktiibuot , geat válljejit muhtun sámegiel oahpahusa , 	njiejai 	veaháš go eat váldán mielde fága sámegiella ja kultuvra , muhto ohppiid lohku geat válljejit sámegiela vuosttaš- dahje nubbigiellan lassánii veaháš skuvlajagis 2006/2007/2006 .
Nugo tabealla 11.1 čájeha , de lea ohppiidlohku geat ožžot davvisámegielas oahpu 	njiedjan 	skuvlajagis 2007/2008/2007 .
Eanemus lea 	njiedjan 	Finnmárkkus , gos ohppiid lohku geain lea sámegiella nubbigiellan lea njiedjan 1086 oahppis skuvlajagis 2006 959/2006 oahppái dán skuvlajagis .
Eanemus lea njiedjan Finnmárkkus , gos ohppiid lohku geain lea sámegiella nubbigiellan lea 	njiedjan 	1086 oahppis skuvlajagis 2006 959/2006 oahppái dán skuvlajagis .
Finnmárkku fylkamánne ii leat čáđahan iskkadeami čielggadit manne lohku lea 	njiedjan 	, muhto lea čilgen Máhttodepartementii ahte sivvan dasa sáhttá leat oahpu lágideapmi .
Finnmárkku fylkamánne hálida gávnnahit manne sámegiel ohppiid lohku lea 	njiedjan 	.
Ohppiid lohku oktiibuot , geat válljejit muhtun sámegiel oahpahusa , 	njiejai 	veaháš go eat váldán mielde fága sámegiella ja kultuvra , muhto ohppiid lohku geat válljejit sámegiela vuosttaš- dahje nubbigiellan lassánii veaháš skuvlajagis 2006/2007/2006 .
Boahtteáiggi hástalusaid ektui čujuhu skuvla ieš dasa ahte sámegielat ohppiid lohku dáidá 	njiedjat 	, muhto ahte skuvllas sáhttet leat 15 – 20 ollesáiggioahppi boahttevuođas , ja eaktun dasa lea ahte skuvla ain sáhttá doaimmahit giellalávgunoahpahusa .
Boahtteáiggi hástalusaid ektui čujuhu skuvla ieš dasa ahte sámegielat ohppiid lohku dáidá 	njiedjat 	, muhto ahte skuvllas sáhttet leat 15 – 20 ollesáiggioahppi boahttevuođas , ja eaktun dasa lea ahte skuvla ain sáhttá doaimmahit giellalávgunoahpahusa .
Earret eará manne oasit Sámeálbmot foandda dietnasis dása , juoga mii veahkehii dasa ahte lohku čáppagirjjálašvuođa giehtačállosiin mat leat dohkkehuvvon almmuheapmái , lea 	njiedjan 	.
Nugo tabealla 11.1 čájeha , de lea ohppiidlohku geat ožžot davvisámegielas oahpu 	njiedjan 	skuvlajagis 2007/2008/2007 .
Eanemus lea 	njiedjan 	Finnmárkkus , gos ohppiid lohku geain lea sámegiella nubbigiellan lea njiedjan 1086 oahppis skuvlajagis 2006 959/2006 oahppái dán skuvlajagis .
Eanemus lea njiedjan Finnmárkkus , gos ohppiid lohku geain lea sámegiella nubbigiellan lea 	njiedjan 	1086 oahppis skuvlajagis 2006 959/2006 oahppái dán skuvlajagis .
Finnmárkku fylkamánne ii leat čáđahan iskkadeami čielggadit manne lohku lea 	njiedjan 	, muhto lea čilgen Máhttodepartementii ahte sivvan dasa sáhttá leat oahpu lágideapmi .
Finnmárkku fylkamánne hálida gávnnahit manne sámegiel ohppiid lohku lea 	njiedjan 	.
Ohppiid lohku oktiibuot , geat válljejit muhtun sámegiel oahpahusa , 	njiejai 	veaháš go eat váldán mielde fága sámegiella ja kultuvra , muhto ohppiid lohku geat válljejit sámegiela vuosttaš- dahje nubbigiellan lassánii veaháš skuvlajagis 2006/2007/2006 .
Boahtteáiggi hástalusaid ektui čujuhu skuvla ieš dasa ahte sámegielat ohppiid lohku dáidá 	njiedjat 	, muhto ahte skuvllas sáhttet leat 15 – 20 ollesáiggioahppi boahttevuođas , ja eaktun dasa lea ahte skuvla ain sáhttá doaimmahit giellalávgunoahpahusa .
Nubbi eará positiivvalaš dovdomearka eanadoalus sámi guovlluin lea dat , go dat doalut mat leat báhcán cevzet hui bures , ja go eanadoalliid gaskamearálaš ahki lea 	njiedjan 	.
Jus mielkeearit 	njidjet 	ain eambbo , de dat sáhttá bilidit sámi eanadoalu .
Investeremat eanadoalus leat 	njiedjan 	jagi 2001 ektui .
Ovdáneapmi tabeallas vuolábealde čájeha ahte nissonoassi bargiid gaskkas stuorru , go fas jođiheddjiid gaskkas 	njiedjá 	nissonlohku .
Okta dain stuorámus hástalusain Sámedikkis lea nissonovddastusa 	njiedjan 	Sámedikkis .
Doaluid lohku lea 	njiedjan 	546 doalus 444 dollui 2001 rájes 2003 rádjai .
Sávzadoaluid lohku lea eanemusat 	njiedjan 	, namalassii 25 proseanttain .
Nissonovddastus Sámedikkis lea 	njiedjan 	33 %:s 18 %:ii 1989 rájes 2001 rádjai .
Okta dain stuorámus hástalusain Sámedikkis lea nissonovddastusa 	njiedjan 	Sámedikkis .
Jus mielkeearit 	njidjet 	ain eambbo , de dat sáhttá bilidit sámi eanadoalu .
Go nissonaoassi 1989 válggaid maŋŋil lei 33,3 proseantta , de lei dat 	njiedjan 	25,6 prosentii maŋŋil 1997 válggaid .
Juos nominašuvnnaid mielde galggaš dubmet , de sáhttá dát proseantaoassi 	njiedjat 	vel eanet boahtte válgaáigodagas .
Nugo tabealla 11.1 čájeha , de lea ohppiidlohku geat ožžot davvisámegielas oahpu 	njiedjan 	skuvlajagis 2007/2008/2007 .
Eanemus lea 	njiedjan 	Finnmárkkus , gos ohppiid lohku geain lea sámegiella nubbigiellan lea njiedjan 1086 oahppis skuvlajagis 2006 959/2006 oahppái dán skuvlajagis .
Eanemus lea njiedjan Finnmárkkus , gos ohppiid lohku geain lea sámegiella nubbigiellan lea 	njiedjan 	1086 oahppis skuvlajagis 2006 959/2006 oahppái dán skuvlajagis .
Finnmárkku fylkamánne ii leat čáđahan iskkadeami čielggadit manne lohku lea 	njiedjan 	, muhto lea čilgen Máhttodepartementii ahte sivvan dasa sáhttá leat oahpu lágideapmi .
Finnmárkku fylkamánne hálida gávnnahit manne sámegiel ohppiid lohku lea 	njiedjan 	.
Ohppiid lohku oktiibuot , geat válljejit muhtun sámegiel oahpahusa , 	njiejai 	veaháš go eat váldán mielde fága sámegiella ja kultuvra , muhto ohppiid lohku geat válljejit sámegiela vuosttaš- dahje nubbigiellan lassánii veaháš skuvlajagis 2006/2007/2006 .
Muhto 2006:s 2007:i 	njiejai 	sávzamassin geatkái .
Váikkuhus lea ee. ahte 	njiedjá 	njuovvan , go ii sáhte systemáhtalaččat válljet maid njuovvá ja optimaliseret sohkabealle- ja ahkečoakkádusa seammaláhkai go ovdal .
Earret eará manne oasit Sámeálbmot foandda dietnasis dása , juoga mii veahkehii dasa ahte lohku čáppagirjjálašvuođa giehtačállosiin mat leat dohkkehuvvon almmuheapmái , lea 	njiedjan 	.
Sámi mánáidgárddiid lohku mat gokčet Sámedikki juolludaneavttuid , lea 	njiedjan 	41 mánáidgárddis 2008:s , 37 mánáidgárdái 2009:s .
Sivva sámi mánáidgárddiid logu njiedjamii , ja dat mii muhtun muddui lea dagahan ahte mánáid lohku geat ožžot sámegieloahpahusa lea loktanan , lea ahte mánáidgárddiid lohku mat olahit eavttuid dohkkehuvvot sámi mánáidgárdin , lea 	njiedjan 	.
Ovdáneapmi tabeallas vuolábealde čájeha ahte nissonoassi bargiid gaskkas stuorru , go fas jođiheddjiid gaskkas 	njiedjá 	nissonlohku .
Lohku lea 	njiedjan 	birrasiid 3 mill. ruvnnuin 1999 loguid ektui .
Muhto 2006:s 2007:i 	njiejai 	sávzamassin geatkái .
Váikkuhus lea ee. ahte 	njiedjá 	njuovvan , go ii sáhte systemáhtalaččat válljet maid njuovvá ja optimaliseret sohkabealle- ja ahkečoakkádusa seammaláhkai go ovdal .
Muhto 2006:s 2007:i 	njiejai 	sávzamassin geatkái .
Váikkuhus lea ee. ahte 	njiedjá 	njuovvan , go ii sáhte systemáhtalaččat válljet maid njuovvá ja optimaliseret sohkabealle- ja ahkečoakkádusa seammaláhkai go ovdal .
Hálbbes riikkaid gilvaleami geažil , lea galmmihuvvon fileabuktagiid hattit 	njiedjan 	varasbuktagiid hattiid ektui .
Hálbbes riikkaid gilvaleami geažil , lea galmmihuvvon fileabuktagiid hattit 	njiedjan 	varasbuktagiid hattiid ektui .
Muhto 2006:s 2007:i 	njiejai 	sávzamassin geatkái .
Váikkuhus lea ee. ahte 	njiedjá 	njuovvan , go ii sáhte systemáhtalaččat válljet maid njuovvá ja optimaliseret sohkabealle- ja ahkečoakkádusa seammaláhkai go ovdal .
Hálbbes riikkaid gilvaleami geažil , lea galmmihuvvon fileabuktagiid hattit 	njiedjan 	varasbuktagiid hattiid ektui .
Nissonovddastus Sámedikkis lea 	njiedjan 	33 %:s 18 %:ii 1989 rájes 2001 rádjai .
Nubbi eará positiivvalaš dovdomearka eanadoalus sámi guovlluin lea dat , go dat doalut mat leat báhcán cevzet hui bures , ja go eanadoalliid gaskamearálaš ahki lea 	njiedjan 	.
Investeremat eanadoalus leat 	njiedjan 	jagi 2001 ektui .
Nubbi eará positiivvalaš dovdomearka eanadoalus sámi guovlluin lea dat , go dat doalut mat leat báhcán cevzet hui bures , ja go eanadoalliid gaskamearálaš ahki lea 	njiedjan 	.
Lohku lea 	njiedjan 	birrasiid 3 mill. ruvnnuin 1999 loguid ektui .
Maŋimuš jagiid lea ássiidlohku Moskkis 	njiedjan 	sullii 70 olbmos vuollel 40 olbmui .
Maŋimuš jagiid lea ássiidlohku Moskkis 	njiedjan 	sullii 70 olbmos vuollel 40 olbmui .
Jienasteaddjiidlohku lea 	njiedjan 	eanemusat lulimus válgabiirriin Lulli-Norggas , Åarjel-Saepmie veeljemegievlie ( Trøndelágafylkkain ) ja Viestarmera válggabijrra ( Lulli-Romssa , Davvi-Nordlándda ja Gaska-Nordlándda suohkaniin ) .
Bargiid lohku lea 	njiedjan 	vuođđoealáhusain boazodoalus , eanadoalus ja guolástusas sámi ássanguovlluin maŋimus logijagiid .
Áigodaga 2006 – 2009 	njiejai 	593 oahppiin daid vuođđoskuvlaoahppiid lohku geat ožžo oahpu Sámegielas nubbigiellan , dat mearkkaša ahte fága massii 29 pst oahppiin maŋimus golmma jagis .
Jahkedoaimmaid lohku lea 	njiedjan 	sámi boazodoalus , ja guolásteaddjiid lohku lea geahppánan ja šibitdáluid lohku eanaš gielddain main sámit orrot , lea unnon ( gč. Sámi logut muitalit II ) .
Bargiid lohku lea 	njiedjan 	vuođđoealáhusain boazodoalus , eanadoalus ja guolástusas sámi ássanguovlluin maŋimus logijagiid .
Áigodaga 2006 – 2009 	njiejai 	593 oahppiin daid vuođđoskuvlaoahppiid lohku geat ožžo oahpu Sámegielas nubbigiellan , dat mearkkaša ahte fága massii 29 pst oahppiin maŋimus golmma jagis .
Maŋimuš jagiid lea ássiidlohku Moskkis 	njiedjan 	sullii 70 olbmos vuollel 40 olbmui .
Nissonovddastus Sámedikkis lea 	njiedjan 	33 %:s 18 %:ii 1989 rájes 2001 rádjai .
Go nissonaoassi 1989 válggaid maŋŋil lei 33,3 proseantta , de lei dat 	njiedjan 	25,6 prosentii maŋŋil 1997 válggaid .
Juos nominašuvnnaid mielde galggaš dubmet , de sáhttá dát proseantaoassi 	njiedjat 	vel eanet boahtte válgaáigodagas .
Go nissonaoassi 1989 válggaid maŋŋil lei 33,3 proseantta , de lei dat 	njiedjan 	25,6 prosentii maŋŋil 1997 válggaid .
Juos nominašuvnnaid mielde galggaš dubmet , de sáhttá dát proseantaoassi 	njiedjat 	vel eanet boahtte válgaáigodagas .
Boahtteáiggi hástalusaid ektui čujuhu skuvla ieš dasa ahte sámegielat ohppiid lohku dáidá 	njiedjat 	, muhto ahte skuvllas sáhttet leat 15 – 20 ollesáiggioahppi boahttevuođas , ja eaktun dasa lea ahte skuvla ain sáhttá doaimmahit giellalávgunoahpahusa .
Hálbbes riikkaid gilvaleami geažil , lea galmmihuvvon fileabuktagiid hattit 	njiedjan 	varasbuktagiid hattiid ektui .
Jienasteaddjiidlohku lea 	njiedjan 	eanemusat lulimus válgabiirriin Lulli-Norggas , Åarjel-Saepmie veeljemegievlie ( Trøndelágafylkkain ) ja Viestarmera válggabijrra ( Lulli-Romssa , Davvi-Nordlándda ja Gaska-Nordlándda suohkaniin ) .
Jahkedoaimmaid lohku lea 	njiedjan 	sámi boazodoalus , ja guolásteaddjiid lohku lea geahppánan ja šibitdáluid lohku eanaš gielddain main sámit orrot , lea unnon ( gč. Sámi logut muitalit II ) .
Maŋimuš jagiid lea ássiidlohku Moskkis 	njiedjan 	sullii 70 olbmos vuollel 40 olbmui .
Sámi mánáidgárddiid lohku mat gokčet Sámedikki juolludaneavttuid , lea 	njiedjan 	41 mánáidgárddis 2008:s , 37 mánáidgárdái 2009:s .
Sivva sámi mánáidgárddiid logu njiedjamii , ja dat mii muhtun muddui lea dagahan ahte mánáid lohku geat ožžot sámegieloahpahusa lea loktanan , lea ahte mánáidgárddiid lohku mat olahit eavttuid dohkkehuvvot sámi mánáidgárdin , lea 	njiedjan 	.
Go buohtastahttá buohccinjávkama 2003:in , de lea dat gaskamearálaččat 	njiedjan 	1,4 proseanttain nissonolbmuid ektui ja 4,9 proseanttain almmáiolbmuid ektui .
Riikadásis lea buozalmasvuođa geažil jávkan 	njiedjan 	8,1 proseanttas 6,5 prosentii 3. kvartála 2003 rájes 3. kvartála rádjai 2004:s .
Almmáiolbmuid gaskkas 	njiejai 	buozalmasvuođa geažil jávkan 6,9 proseanttas 5,4 prosentii ja nissonolbmuid gaskkas 9,7 proseanttas 7,8 prosentii 3. kvartála 2003 rájes 3. kvartála rádjai 2004:s .
Doaluid lohku lea 	njiedjan 	546 doalus 444 dollui 2001 rájes 2003 rádjai .
Sávzadoaluid lohku lea eanemusat 	njiedjan 	, namalassii 25 proseanttain .
Kárášjogas ja Guovdageainnus lea sámegielagiid oassi 94 ja 96 % Unjárggas 75 % Deanus 53 % ja Porsáŋggus 35 % Guorahallama mielde lea veaháš badjelaš 20 % Finnmárkku veahkadagas sámegielat , muhto oassi 	njiedjá 	dađistaga go máddelii manná , muhto Gáivuona suohkanis Romssas leat 46 % sámegielagat .
Muhto 2006:s 2007:i 	njiejai 	sávzamassin geatkái .
Váikkuhus lea ee. ahte 	njiedjá 	njuovvan , go ii sáhte systemáhtalaččat válljet maid njuovvá ja optimaliseret sohkabealle- ja ahkečoakkádusa seammaláhkai go ovdal .
Investeremat eanadoalus leat 	njiedjan 	jagi 2001 ektui .
Okta dain stuorámus hástalusain Sámedikkis lea nissonovddastusa 	njiedjan 	Sámedikkis .
Hálbbes riikkaid gilvaleami geažil , lea galmmihuvvon fileabuktagiid hattit 	njiedjan 	varasbuktagiid hattiid ektui .
Sámi mánáidgárddiid lohku mat gokčet Sámedikki juolludaneavttuid , lea 	njiedjan 	41 mánáidgárddis 2008:s , 37 mánáidgárdái 2009:s .
Sivva sámi mánáidgárddiid logu njiedjamii , ja dat mii muhtun muddui lea dagahan ahte mánáid lohku geat ožžot sámegieloahpahusa lea loktanan , lea ahte mánáidgárddiid lohku mat olahit eavttuid dohkkehuvvot sámi mánáidgárdin , lea 	njiedjan 	.
Bargonávccahisvuođadoarjagiid ulbmil lea sihkkarastit daidda olbmuide birgendietnasa , geaid dinennávccat leat bistevaččat 	njiedjan 	buozalmasvuođa , vahága dahje vigi geažil .
Gilvojuvvon eatnamiid oassi lea sullii 8000 daa ja dat lea 	njiedjan 	sullii 30 % .
Dattetge lea sámegielat áviissaid deaddilanlohku 	njiedjan 	. #lohku
Eallinahki lea loktanan ja riegádahttinlogut leat 	njiedjan 	. #lohku
Dattetge lea sámegielat áviissaid deaddilanlohku 	njiedjan 	. #lohku
Dorskehivvodat lassánii 20 proseanttain jagi 2013 , ja árvu fas 	njiejai 	čieža proseanttain . #árvu
Luossahivvodat 	njiejai 	gis gávcciin proseanttain , ja árvu fas loktanii olles 37 proseanttain . #hivvodat XT-Com
Jos ESA dohkkeha min árvalusa , de dat mielddisbuktá ahte gielddaid lohku doaibmaguovllus 	njiedjá 	284 gielddas 281 gildii .
Barggahusdássi bargguhis olbmuide lea 	njiedjan 	sullii 1 250 sajiiguin 2011 plánaloguid ektui .
Barggahusdási 	njiedjan 	bargguhisolbmuide lea boahtán danin go bargomárkan lea buorránan .
Vaikko ollugat 2011 leat vuostáiváldán máškidis ealáhatruđa , de boarráset gearddi gaskkas ii leat fidnodoaibma 	njiedjan 	.
Suohkanat gos olmmošlohku lea 	njiedjan 	eanemusat maŋemuš jagis lea Muosát , Fálesnuorri , Gáŋgaviika ja Bearalváhki .
Olmmošlohku lea 	njiedjan 	dan geažil go lea ollu eretfárren ja unnán mánát riegádan go buohtastahttá dainna man gallis leat jápmán .
Dát dahká 1114 olbmo ja lea 	njiedjan 	100 olbmuin jagi 2009 seammá áigodaga ektui .
Buohcanjávkan 2010:s lei 6,1 proseantta , mii lea sakka 	njiedjan 	2006–2009 gaskameari jávkama ektui .
Mátkkálaččaid lohku ain 	njiedjá 	, sihke bussiin ja fatnasiin .
Váldoáigumuš lea eastadit fuollarihkkumiid , ja oažžut 	njiedjat 	proseantalogu pasieanttain geat eai boađe šihttojuvvon diimmuide .
Dát lea 	njiedjan 	7,4 proseantta ektui jagi 2009 .
Buohcanjávkan lea 	njiedjan 	buot ahke- ja virgejoavkkuin .
Vaikko vel loatnavealgi lea lassánan 305 miljovnnain ruvnnuin 2008:s 2010 rádjái , mii vástida 40,7 proseantta lassáneami , de reantoolggosgolut leat 	njiedjan 	8 miljovnnain ruvnnuin seamma áigodagas .
Ovdamearkan govttolaš ordnemiin lea 	njiejahaga 	huksen jorrestuoluin johtti bargi várás .
Dát lea mealgat 	njiedjan 	.
Suohkanis lea ollislaš buohcanjávkan hui veaháš 	njiedjame 	.
lea guovddáš eiseválddiid bealis ásahuvvon vai oažžu buohcanjávkama riikadásis 	njiedjat 	.
2002:is 2003 leat vealggit 	njiedjan 	kr. 0,6 mill. , geahpádus mii lea 6,9 % .
Vealggit leat 	njiedjan 	buot vearrosurgiin , earret ovdageassovearuin .
Jus ii váldde fárrui premiijaspiehkastusa , de livčče oanehisáigge gáibádusat 	njiedjan 	kr 1 738':in .
Dán haga livččii guhkesáigge vealgi 	njiedjan 	kr. 1 239 ' .
tabealla 2 , 9 , 9 miljon ruvnno , mii lea 28,3 miljon ruvnno 	njiedjan 	2005 rájes .
1990-logus mii vásiheimmet garra guovddušteami , mas fylkka eanaš suohkaniin ja guovlluin 	njiejai 	olmmošlohku .
Doaluid lohku lea garrasit 	njiedjan 	Romssas , muhto doaimmaid ja buvttadeami viidodagat bissot ja vel sturrotge muhtun buktagiid dáfus .
Romssas lea sin lohku 	njiedjan 	, geaid váldoealáhus lea guolásteapmi , ja nu lea dahkan eambbo go riikkas muđui .
Ođđa olbmuidge lohku lea 	njiedjan 	, guđet álget ealáhussii , ja guolásteddjiid gaskamearálaš ahki goargŋu .
Áigodagas leat vásihan garra guovddušteami , ja eanaš suohkaniin ja guovlluin fylkkas 	njiejai 	olmmošlohku .
Seammás lea stuorebuš guovddážiin nugo Bearddus ja Háršttás lassánan olmmošlohku daid maŋimuš vihtta jagi , muđui lea eará stuorebuš guovddážiin 	njiedjan 	olmmošlohku .
Dán árvvoštallama mielde eanaš guovlluin ain 	njiedjá 	olmmošlohku .
Bargguhisvuohta lea 	njiedjan 	daid maŋimuš jagiid , ja lea historjjálaččat vuolledásis .
Vátnivuohta boahtá bistit álbmoga ahkestruktuvrra geažil mii čájeha ahte dat oassi álbmogis mii lea bargoagis 	njiedjá 	.
	Njiedjan 	vuođđoealáhusas ja industriijasuorggis váikkuha erenoamážit boaittobealguovlluide , seammásgo Romssa suohkanis ja stuorámus gávpogiin lea leamaš lassáneapmi eará ealáhusain , erenoamážit almmolaš suorggis ja KIFT
Muđui fylkka eará guovlluin lea seamma áigodagas 	njiedjan 	bargguiduhttin oktiibuot 1000 olbmuin .
dásis lea bargguiduhttin 	njiedjan 	1,9 % ( -313 ) Lulli-Romssas , 1,8 % ( -117 ) Davvi-Romssas ja 4.3 % ( -599 ) Gaska-Romssas .
Báhccavuonas ja Gálssas 	njiejai 	oktiibuot 4,0 % ( -135 ) áigodagas .
Dasto lea registrerejuvvon ahte riegádusrate 	njiejai 	dán jahkelogeža álgogeahčen , muhto riegádusrate lassánii áigodagas 2003-2006 ja lea fylkkadásis stuorámus lassáneapmi riikkas .
Doaluid lohku lea garrasit 	njiedjan 	Romssas , muhto doaimmaid ja buvttadeami viidodagat bissot .
Buđetbuvttadeapmi lassána , muhto sávzzaid ja spiinniid lohku 	njiedjá 	garrasit .
Eanandolliid lohku lea 	njiedjan 	ja dat váikkuha dasa ahte lea uhcit jearru bagadallibálvalusaide jnv. .
Romssas lea sin lohku 	njiedjan 	, geaid váldoealáhus lea guolásteapmi , ja nu lea dahkan eambbo go riikkas muđui .
Ođđa olbmuidge lohku lea 	njiedjan 	, guđet álget ealáhussii , ja guolásteddjiid gaskamearálaš ahki goargŋu .
Romssa suohkaniin 	njiejai 	netto doaibmaboađus 2004:s 2005:i 1,8 proseanttas 1,6 prosentii , ja riikkas oppalaččat fas lassánii 1,8 proseanttas 3,9 prosentii .
Eará suohkaniin fas olmmošlohku 	njiejai 	dahje bisui seamma dásis .
Go suohkaniin 	njiedjá 	olmmošlohku ollu , de ožžot suohkanat váttisvuođaid heivehit bálvalusbuvttadandási dinestusnjiedjamii ja danne ožžot doaibmanvuolláibáhcaga .
Unna suohkaniin gos olmmošlohku leat 	njiedjan 	šaddá dát stuorra ekonomalaš hástalussan .
Oahppiidlohku Romssa fylkka doaresbeliin lea 	njiedjan 	garrasit 80-logu gaskamuttu rájes .
Dorski njuolggohaddi maid 	njiejai 	mealgat jagi 2009 mielde .
NAČ 1999:9 čalmmusteami oktavuođas lea daddjon ahte vádjolusluossanálli lea issorasat 	njiedjan 	maŋimuš 10 jagis , ja maiddái árvalusas daddjo , maŋimuš teakstaoasis 2. siiddus , ahte luossanálli lea dađistaga uhccon .
NAČ 1999:9 čalmmusteami oktavuođas lea daddjon ahte vádjolusluossanálli lea issorasat 	njiedjan 	maŋimuš 10 jagis , ja maiddái árvalusas daddjo , maŋimuš teakstaoasis 2. siiddus , ahte luossanálli lea dađistaga uhccon .
Norggas lei dábálaččat beroštupmi lassánan kommersialiseret meahci dan mielde ahte árbevirolaš eana- ja vuovdedoalu boađut leat 	njiedjan 	maŋimus jagiid . #boađut
Dát lohku lea sakka 	njiedjan 	2008:s
danne go rievssatlohku lea 	njiedjan 	garr
Ohppiidlohku geain lea davvisámegiella 1. giellan ges lea 	njiedjan 	36 ohppiin , 986 oahppis 950 oahppái .
Ohppiidlohku geain lea davvisámegiella 1. giellan ges lea 	njiedjan 	36 ohppiin , 986 oahppis 950 oahppái .
Olmmošlohku ollislaččat riikkas lea lassánan 10 % jagi 1997 rájes ja sámi guovlluin gal lea baicce 	njiedjan 	badjel 10 % .
Áidna vejolašvuohta álggahit ođđa doaibmabijuid lea geavahit dan haddegoargŋuma mii lei galgat geavahuvvot dálá áigumušaide Sámedikki bušeahtas , mii fas mielddisbuktá ahte dáidda áigumušaide 	njiedjá 	duohta juolludeapmi Sámedikkis .
Áidna vejolašvuohta álggahit ođđa doaibmabijuid lea geavahit dan haddegoargŋuma mii lei galgat geavahuvvot dálá áigumušaide Sámedikki bušeahtas , mii fas mielddisbuktá ahte dáidda áigumušaide 	njiedjá 	duohta juolludeapmi Sámedikkis .
Joatkit ovttasbargoprošeavtta Innovašuvdna Norggain ja Finnmárkku fylkkamánni eanadoalloossodagain eanadoalu ovddidemiin dain guovlluin gos doallolohku lea 	njiedjamin 	.
Joatkit ovttasbargoprošeavtta Innovašuvdna Norggain ja Finnmárkku fylkkamánni eanadoalloossodagain eanadoalu ovddidemiin dain guovlluin gos doallolohku lea 	njiedjamin 	.
Luossareivesearvi čilgii gieskat čađahuvvon iskkadeami birra mii čájeha ahte giddes doaluid lohku Deatnogáttis lea 	njiedjan 	go buohtastahttá dili mii lei 1984:s , dalle go ovddit iskkadeapmi dahkkojuvvui .
Seammás oaidnit ahte olmmošlogu 	njiedjan 	sámi guovlluin eaktuda doaibmabijuid jos galggaš jorgalahttit dan ovdáneami .
Sámediggi lea fuolastuvvan go dáid mánáid lohku , geat ožžot sámegieloahpahusa vuođđoskuvllas , lea 	njiedjan 	nu garrasit ja duođalaččat ja go sámi mánáidgárdemánáid lohku lea njiedjan .
Sámediggi lea fuolastuvvan go dáid mánáid lohku , geat ožžot sámegieloahpahusa vuođđoskuvllas , lea njiedjan nu garrasit ja duođalaččat ja go sámi mánáidgárdemánáid lohku lea 	njiedjan 	.
Telemarksforskninga raporta čájeha ahte dan ektui go olmmošlohku olles riikkas lea lassánan 1997 rájes 2010 rádjai , de dat lea 	njiedjan 	sámi guovlluin seamma áigodagas .
Veahkadatlogu 	njiedjan 	sámi guovlluin lea maid leamaš stuorát go buot golmma davimus fylkkain 1997 rájes .
Válljejuvvon sámi gielddain lea veahkadatlohku 	njiedjan 	55 442:s jagis 1985 44 684:ii jagis 2009 .
Dát lea measta 20 % 	njiedjan 	25 jagis .
Gáŋgaviikkas ja Láhpis lea 	njiedjan 	leamaš badjel 20 % .
2009:s dat lei 	njiedjan 	46 prosentii .
Priváhta ealáhusaid bargosadjelohku lea dattetge 	njiedjan 	veaháš badjel 400 bargosajiiguin .
Almmolaš suorggis 	njiejai 	bargosadjelohku erenoamážit jagiid 2001 ja 2002 , das maŋŋá dat lea leamaš oalle dássit .
Industriijas lea leamaš stuorámus 	njiedjan 	, badjel 20 proseantta .
Seamma áigodagas lei 	njiedjan 	sihke vuođđoealáhusain ja industriijas .
Sámi guovlluin lea vuođđudemiid lohku leamaš uhcit go dat logut maiguin mii sáhttit buohtastahttit ja áigodagas 2002-2009 lea netto goargŋun rievddadan ja 	njiedjan 	maŋimus jagiid , muhto guovlu suorgestruktuvra sáhttá dan čilget .
Boahttevaš ealáhusovddidanbarggus mearkkaša ollu manne muhtun regiovnnain dahje gielddain lea lassáneapmi ja earáin 	njiedjan 	sihke olmmošlogu ja ealáhuseallima dáfus .
Stuorra rievdadusat ealáhusstruktuvrras Sámi guovlluin lea barggolašvuohta 	njiedjan 	sakka dakkár ealáhusain go vuođđoealáhusain ja industriijas , mat fas leat vuođđun eará ealáhusaide .
Nappo 	njiedjá 	ge olmmošlohku garrasit ollu gielddain vaikke vel dain lea ge gaskamearálaš dahje buorre ealáhusovdáneapmi .
Telemarksforskninga raporta čájeha ahte dan ektui go olmmošlohku olles riikkas lea lassánan 1997 rájes 2010 rádjai , de dat lea 	njiedjan 	sámi guovlluin seamma áigodagas .
Veahkadatlogu 	njiedjan 	sámi guovlluin lea maid leamaš stuorát go buot golmma davimus fylkkain 1997 rájes .
Válljejuvvon sámi gielddain lea veahkadatlohku 	njiedjan 	55 442:s jagis 1985 44 684:ii jagis 2009 .
Dát lea measta 20 % 	njiedjan 	25 jagis .
Gáŋgaviikkas ja Láhpis lea 	njiedjan 	leamaš badjel 20 % .
2009:s dat lei 	njiedjan 	46 prosentii .
Priváhta ealáhusaid bargosadjelohku lea dattetge 	njiedjan 	veaháš badjel 400 bargosajiiguin .
Almmolaš suorggis 	njiejai 	bargosadjelohku erenoamážit jagiid 2001 ja 2002 , das maŋŋá dat lea leamaš oalle dássit .
Industriijas lea leamaš stuorámus 	njiedjan 	, badjel 20 proseantta .
Seamma áigodagas lei 	njiedjan 	sihke vuođđoealáhusain ja industriijas .
Sámi guovlluin lea vuođđudemiid lohku leamaš uhcit go dat logut maiguin mii sáhttit buohtastahttit ja áigodagas 2002-2009 lea netto goargŋun rievddadan ja 	njiedjan 	maŋimus jagiid , muhto guovlu suorgestruktuvra sáhttá dan čilget .
Boahttevaš ealáhusovddidanbarggus mearkkaša ollu manne muhtun regiovnnain dahje gielddain lea lassáneapmi ja earáin 	njiedjan 	sihke olmmošlogu ja ealáhuseallima dáfus .
Stuorra rievdadusat ealáhusstruktuvrras Sámi guovlluin lea barggolašvuohta 	njiedjan 	sakka dakkár ealáhusain go vuođđoealáhusain ja industriijas , mat fas leat vuođđun eará ealáhusaide .
Nappo 	njiedjá 	ge olmmošlohku garrasit ollu gielddain vaikke vel dain lea ge gaskamearálaš dahje buorre ealáhusovdáneapmi .
Statistihkka čájeha ahte olmmošlohku sámi guovlluin lea 	njiedjan 	16 proseanttain maŋimuš 20 jagis .
Vuođđoskuvllas lea dáid ohppiidlohku 	njiedjan 	oktiibuot badjelaš 23 % jagi 2005 rájes .
Barggolašvuođa oassi vuođđoealáhusain lea 	njiedjan 	, ja dan seammás leat ođđa ásaheamit ealáhusovddidandoarjaga doaibmaguovllus vátnon .
Sámi guovlluin lea olmmošlohku 	njiedjan 	hui ollu , ja Sámediggi vásiha ahte olu ođđa suohkanat dál háliidit searvat dán ortnegii .
Statistihkka čájeha ahte olmmošlohku sámi guovlluin lea 	njiedjan 	16 proseanttain maŋimuš 20 jagis .
Vuođđoskuvllas lea dáid ohppiidlohku 	njiedjan 	oktiibuot badjelaš 23 % jagi 2005 rájes .
Barggolašvuođa oassi vuođđoealáhusain lea 	njiedjan 	, ja dan seammás leat ođđa ásaheamit ealáhusovddidandoarjaga doaibmaguovllus vátnon .
Finnmárkku fylkkas lea doaluid lohku čielgasit 	njiedjan 	2004 rájes 2010 rádjai , 427 doalus 360 dollui .
Dat lea badjel 15 % 	njiedjan 	.
Romssa fylkka lea ain stuorát 	njiedjan 	, 1405 doalus 1119 dollui jagis 2010 , mii lea 20 % njiedjan .
Romssa fylkka lea ain stuorát njiedjan , 1405 doalus 1119 dollui jagis 2010 , mii lea 20 % 	njiedjan 	.
Gaskamearri olles riikii lea 13 % 	njiedjan 	.
Máŋgga gielddas lea eanadoallu nu 	njiedjan 	ahte leat dušše moadde buvttadeaddji vel báhcán .
Finnmárkku fylkkas lea doaluid lohku čielgasit 	njiedjan 	2004 rájes 2010 rádjai , 427 doalus 360 dollui .
Dat lea badjel 15 % 	njiedjan 	.
Romssa fylkka lea ain stuorát 	njiedjan 	, 1405 doalus 1119 dollui jagis 2010 , mii lea 20 % njiedjan .
Romssa fylkka lea ain stuorát njiedjan , 1405 doalus 1119 dollui jagis 2010 , mii lea 20 % 	njiedjan 	.
Gaskamearri olles riikii lea 13 % 	njiedjan 	.
Máŋgga gielddas lea eanadoallu nu 	njiedjan 	ahte leat dušše moadde buvttadeaddji vel báhcán .
Doarjagat eai muddejuvvo haddegoargŋuma ektui , ja danne leat doarjagat duohtavuođas 	njiedjan 	dán áigodagas .
Seammás diehtit mii ahte mearraluossabivdiid rekrutteren lea 	njiedjan 	.
Sámi statistihkka čájeha ahte ohppiid lohku geat válde oahpahusa sámegielas vuođđoskuvllain , lea 	njiedjan 	.
Ráđđi oaidná váivviin ahte nissonolbmo searvan ealáhusas lea 	njiedjan 	, ja eavttut nissonolbmuide beassat searvat ealáhusas váilot .
Ii leat buorre jus dát mielddisbuktá ahte kilohaddi 	njiedjá 	ollu .
Telemarksforskning 2011 Oppalaččat Norggas lassánii olmmošlohku 1987 rájes 2010 rádjái , muhto sámi suohkaniin ( STNguovllus ) 	njiejai 	olmmošlohku hui garrasit seamma áigodagas .
Sámi guovllus lea olmmošlohku 	njiedjan 	miha eanet go buot golmma davimus fylkkas .
Romssas lea olmmošlohku lassánan 1997 rájes , ja Nordlánddas ja Finnmárkkus lea maŋemus jagiid 	njiedjan 	rievdan lassáneapmin .
Sámi guovllus gal olmmošlohku ain 	njiedjá 	.
Lassin dasa go olmmošlohku sámi guovlluin 	njiedjá 	, boahtá vel dat ahte dohko báhcet eanet vuorrasit olbmot .
Muhto dat mii lea sámi guovlluid dovdomearka , lea ahte vuollel 30-jahkásaččaid lohku álbmogis 	njiedjá 	miha johtileappot go riikkas muđui .
Vuođđoskuvlaohppiid lohku geain lea sámegiella fágasuorggis , lea 	njiedjan 	juohke jagi dan rájes Máhttolokten – sámi váldojuvvui atnui 2006:s .
Oktiibuot lea ohppiidlohku 	njiedjan 	810 ohppiin buoremus jagi rájes mii lei 2005/06/2005 .
Davvesámegiel ja lullisámegiel ohppiidlohku lea 	njiedjan 	sullii seamma ollu proseanttaid mielde maŋemus viđa jagis , ja julevsámegiel ohppiidlohku lea lassánan .
19 Sámegiella vuosttašgiellan lea 	njiedjan 	golmmain proseanttain 2005/06/2005 rájes 2010/11/2010 rádjái .
3 proseantta njiedjan viđa jagis lea unnit go dan ahkásaš ohppiidlogu njiedjan mii lei Davvi-Norggas seamma áigodagas , dat 	njiedjan 	lei badjel 7 proseantta .
Vaikko vuosttašgiela ohppiidlohku lea ge leamaš oalle dásset oalle guhkes áiggi , de lea maŋemus guovtti jagis dovdogoahtán čielga 	njiedjan 	, oktiibuot 72 oahppi unnit .
Seammás oaidnit ahte ohppiid lohku geain lea sámegiella nubbingiellan vuođđoskuvllas 	njiedjá 	.
Telemarksforskning 2010 Dan ektui go olmmošlohku olles rikkas lea lassánan 1997 rájes 2010 rádjai , de dat lea 	njiedjan 	dan 22 gielddas seamma áigodagas .
Sámi guovlluin ain 	njiedjá 	.
Eanaš gielddain lea olmmošlohku 	njiedjan 	10-jahkeáiggis .
Statistisk sentralbyrå ` logut čájehit ahte veahkadatlohku sámi gielddain leat 	njiedjan 	20 %:in daid maŋimuš 25 jagiin 55 442 rájes 1985:s ja 44 684 rádjai 2009:s .
Riikkas oppalaččat 	njiedjá 	vuollel 30 jahkásaš veahkadaga oassi .
2009:s dat lei 	njiedjan 	46 %:i .
Dan ektui go Norggas oppalaččat lei sakka 	njiedjan 	stuorrunfitnodagaid dáfus , de lei sámi guovlluin lassáneapmi 2008:s ja vástideaddji njiedjan 2009:s .
Dan ektui go Norggas oppalaččat lei sakka njiedjan stuorrunfitnodagaid dáfus , de lei sámi guovlluin lassáneapmi 2008:s ja vástideaddji 	njiedjan 	2009:s .
Stuorra rievdadusat ealáhusstruktuvrras Sámi guovlluin lea barggolašvuohta 	njiedjan 	sakka dakkár ealáhusain go vuođđoealáhusain ja industriijas , mat fas leat vuođđun eará ealáhusaide .
Nappo 	njiedjá 	ge olmmošlohku garrasit máŋgga gielddas vaikke vel dain lea ge gaskamearálaš dahje buorre ealáhusovddideapmi .
Ođđa čálihuvvon fitnodagat leat 	njiedjan 	2008 ja 2009 jagiin , nu go lea riikkas muđui ge .
Go lassin áicat ahte doaimmaid nettolasáhus 	njiedjá 	, de hásttuha dát sakka sámi guovlluid ealáhusaid .
Telemarksforskning 2010 Dan ektui go olmmošlohku olles rikkas lea lassánan 1997 rájes 2010 rádjai , de dat lea 	njiedjan 	dan 22 gielddas seamma áigodagas .
Sámi guovlluin ain 	njiedjá 	.
Eanaš gielddain lea olmmošlohku 	njiedjan 	10-jahkeáiggis .
Statistisk sentralbyrå ` logut čájehit ahte veahkadatlohku sámi gielddain leat 	njiedjan 	20 %:in daid maŋimuš 25 jagiin 55 442 rájes 1985:s ja 44 684 rádjai 2009:s .
Riikkas oppalaččat 	njiedjá 	vuollel 30 jahkásaš veahkadaga oassi .
2009:s dat lei 	njiedjan 	46 %:i .
Dan ektui go Norggas oppalaččat lei sakka 	njiedjan 	stuorrunfitnodagaid dáfus , de lei sámi guovlluin lassáneapmi 2008:s ja vástideaddji njiedjan 2009:s .
Dan ektui go Norggas oppalaččat lei sakka njiedjan stuorrunfitnodagaid dáfus , de lei sámi guovlluin lassáneapmi 2008:s ja vástideaddji 	njiedjan 	2009:s .
Stuorra rievdadusat ealáhusstruktuvrras Sámi guovlluin lea barggolašvuohta 	njiedjan 	sakka dakkár ealáhusain go vuođđoealáhusain ja industriijas , mat fas leat vuođđun eará ealáhusaide .
Nappo 	njiedjá 	ge olmmošlohku garrasit máŋgga gielddas vaikke vel dain lea ge gaskamearálaš dahje buorre ealáhusovddideapmi .
Ođđa čálihuvvon fitnodagat leat 	njiedjan 	2008 ja 2009 jagiin , nu go lea riikkas muđui ge .
Go lassin áicat ahte doaimmaid nettolasáhus 	njiedjá 	, de hásttuha dát sakka sámi guovlluid ealáhusaid .
Dán proseassa boađusin čuozai dat maiddái boazodoalloguovlluide olggobealde Finnmárkku dainna lágiin ahte bohccobiergohaddi 	njiejai 	.
Beroškeahttá boazodoalu stuorra hástalusain – eahpedássidis boazolohku , eahpečielga areálaresurssat ja siidaráját , mannanjagáš stuorra bohccobiergorájut , mii dagaha ahte bohccobierggu kilohaddi 	njiedjá 	, stuorra boraspirevahágat ja sisabahkkemat boazodoalloeatnamiidda – Stuorradiggi vállje uhcidit boazošiehtadusa rámma ja uhcidit njuolgga doarjagiid oasi boazoeaiggádiidda .
Boazodoalu ollislaš rehketdoallu 2009/2010/2009 čájeha ahte dienas bohcco nammii gaskamearálaččat lea 	njiedjan 	mealgat maŋimus jagi .
Váldosivvan dasa lea bohccobierggu kilohatti 	njiedjan 	ja stuorra boraspirevahágat .
Haddegahččan boazodoalus mii oktiibuot dagahii ahte boazodoalu sisaboađut 	njidje 	, ferte
Dán proseassa boađusin čuozai dat maiddái boazodoalloguovlluide olggobealde Finnmárkku dainna lágiin ahte bohccobiergohaddi 	njiejai 	.
Sámediggi oaivvilda ahte ekonomalaš rámma ferte lasihuvvot , čuovvovaš ákkaid vuođul : Haddegahččan boazodoalus mii oktiibuot dagahii ahte boazodoalu sisaboađut 	njidje 	, ferte
Beroškeahttá boazodoalu stuorra hástalusain – eahpedássidis boazolohku , eahpečielga areálaresurssat ja siidaráját , mannanjagáš stuorra bohccobiergorájut , mii dagaha ahte bohccobierggu kilohaddi 	njiedjá 	, stuorra boraspirevahágat ja sisabahkkemat boazodoalloeatnamiidda – Stuorradiggi vállje uhcidit boazošiehtadusa rámma ja uhcidit njuolgga doarjagiid oasi boazoeaiggádiidda .
Boazodoalu ollislaš rehketdoallu 2009/2010/2009 čájeha ahte dienas bohcco nammii gaskamearálaččat lea 	njiedjan 	mealgat maŋimus jagi .
Váldosivvan dasa lea bohccobierggu kilohatti 	njiedjan 	ja stuorra boraspirevahágat .
Gánnáheapmi vuođđoealáhusain lassána SED guovllus Eanet ásaheamit lasseealáhusain boazodoalus Eanet buolvamolsubmat ja/dahje/ja ođđaásaheami vuođđoealáhusain SED guovllus Eanet nissonolbmot ealáhusdoallin eanadoalus ja boazodoalus SED guovllus Vahátlohku 	njiedjá 	sávza- ja boazodoalus SED guovllus
Stáhta mielkeearit dállodoaluid ođđaásaheami dahje badjelasas váldima oktavuođas Nissonolbmot ealáhusdoaimmaheaddjin Joatkit ovttasbargoprošeavtta Innovašuvdna Norggain ja Finnmárkku fylkkamánni eanadoalloossodagain eanadoalu ovddidemiin dain guovlluin gos doallolohku lea 	njiedjamin 	Ortnega doarjjaoažžut ja olahusjoavku : Ealáhusdoaimmaheaddjit ja álggaheaddjit ealáhussii – Ohcanvuđot doarjagat Bušeahtta : 4 800 000 ru Galgá váikkuhit : Buoret gánnáheapmi eanadoalus Buorre rekrutteren Buoret sohkabealedássedeaddu Muđui gustojit ohcanvuđot doarjagiid njuolggadusat 18. kapihttalis .
Gánnáheapmi vuođđoealáhusain lassána SED guovllus Eanet ásaheamit lasseealáhusain boazodoalus Eanet buolvamolsubmat ja/dahje/ja ođđaásaheami vuođđoealáhusain SED guovllus Eanet nissonolbmot ealáhusdoallin eanadoalus ja boazodoalus SED guovllus Vahátlohku 	njiedjá 	sávza- ja boazodoalus SED guovllus
Stáhta mielkeearit dállodoaluid ođđaásaheami dahje badjelasas váldima oktavuođas Nissonolbmot ealáhusdoaimmaheaddjin Joatkit ovttasbargoprošeavtta Innovašuvdna Norggain ja Finnmárkku fylkkamánni eanadoalloossodagain eanadoalu ovddidemiin dain guovlluin gos doallolohku lea 	njiedjamin 	Ortnega doarjjaoažžut ja olahusjoavku : Ealáhusdoaimmaheaddjit ja álggaheaddjit ealáhussii – Ohcanvuđot doarjagat Bušeahtta : 4 800 000 ru Galgá váikkuhit : Buoret gánnáheapmi eanadoalus Buorre rekrutteren Buoret sohkabealedássedeaddu Muđui gustojit ohcanvuđot doarjagiid njuolggadusat 18. kapihttalis .
Raporttas oidno ahte jagi 2006 rájes leat oahppit geain sámegiella lea nubbingiellan vátnon 38 % golmma sámegiela ektui oktiibuot , davvisámegiella nubbingiellan okto lea 	njiedjan 	40 % .
Raporttas oidno ahte jagi 2006 rájes leat oahppit geain sámegiella lea nubbingiellan vátnon 38 % golmma sámegiela ektui oktiibuot , davvisámegiella nubbingiellan okto lea 	njiedjan 	40 % .
Doaibmaboađus lea duođai 	njiedjan 	108 581 ruvnnus 83 684 ruvdnui dien áigodagas .
Sámediggi vuorjašuvvá dainna go ohppiidlohku geain lea sámegiella nubbingiellan ain 	njiedjá 	.
Olmmošlohku sámi guovlluin 	njiedjá 	ain .
Barggolašvuođa oassi vuođđoealáhusain lea 	njiedjan 	, seammás leat unnit ođđa ásaheamit ealáhusovddidandoaibmaguovllus .
Doaibmaboađus lea duođai 	njiedjan 	108 581 ruvnnus 83 684 ruvdnui dien áigodagas .
Sámediggi vuorjašuvvá dainna go ohppiidlohku geain lea sámegiella nubbingiellan ain 	njiedjá 	.
Olmmošlohku sámi guovlluin 	njiedjá 	ain .
Barggolašvuođa oassi vuođđoealáhusain lea 	njiedjan 	, seammás leat unnit ođđa ásaheamit ealáhusovddidandoaibmaguovllus .
Lea vuorjjahahtti ahte davvisámegielas ja lullisámegielas eai gávdno oahpponeavvut vuolimus cehkiide sámegiella 2 ja sámegiella 3 fágain , ja dat lea ášši maid ferte vuoruhit go jurddaha daid hástalusaid mat leat go ohppiidlohku lea sakka 	njiedjan 	sámegiella 2 ja sámegiella 3 fágain vihtta maŋemus jagi .
Dat suorggahahtti 	njiedjan 	ohppiid logus geain lea sámegiella fágasuorggis vuođđoskuvllas lea olles 810 unnit oahppi maŋemus 5 jagis , dat lea guovddaš váldohástalus Sámediggái .
Gažaldat fága- ja diibmojuohkinlogu ektui orru leame guovddáš váttisvuohta , danne go oahppit geain lea sámegiela fágasuorggis 	njidjet 	ja danne berre meannuduvvot bajitdásis systemas .
Go vásihit oahppit lohku geat vallejit sámegiela lea 	njiedjan 	26,5% dan maŋemus 5 jagis , de lea áibbas dehálaš ahte garrasit ja duođalaččat ferte bargat dainna áššin vái sámi oahppin bissu sámegiella fágan vuođđooahpahusas .
Dán oktavuođas lea Steinfjell čállán reivve departementii ahte son vásihii , go ovddastii joavkku , ahte go čujuhii bures duođaštuvvon áššečuolmma mas ohppiidlohku geain lea sámegiella nubbingiellan vuođđoskuvllas , lea 	njiedjan 	, ja dáhtui ahte dát váldojuvvo áššin našunála referánsajoavkkus , de čujuhii dalá stádačálli Rugtvedt , Máhttodepartemeanttas , Sámediggái , mii lea dat ásahus mii galgá čoavdit dán ášši .
Telemarksforskning 2011 Oppalaččat Norggas lassánii olmmošlohku 1987 rájes 2010 rádjái , muhto sámi suohkaniin ( STNguovllus ) 	njiejai 	olmmošlohku hui garrasit seamma áigodagas .
Sámi guovllus lea olmmošlohku 	njiedjan 	miha eanet go buot golmma davimus fylkkas .
Romssas lea olmmošlohku lassánan 1997 rájes , ja Nordlánddas ja Finnmárkkus lea maŋemus jagiid 	njiedjan 	rievdan lassáneapmin .
Sámi guovllus gal olmmošlohku ain 	njiedjá 	.
Lassin dasa go olmmošlohku sámi guovlluin 	njiedjá 	, boahtá vel dat ahte dohko báhcet eanet vuorrasit olbmot .
Muhto dat mii lea sámi guovlluid dovdomearka , lea ahte vuollel 30-jahkásaččaid lohku álbmogis 	njiedjá 	miha johtileappot go riikkas muđui .
Vuođđoskuvlaohppiid lohku geain lea sámegiella fágasuorggis , lea 	njiedjan 	juohke jagi dan rájes Máhttolokten – sámi váldojuvvui atnui 2006:s .
Oktiibuot lea ohppiidlohku 	njiedjan 	810 ohppiin buoremus jagi rájes mii lei 2005/06/2005 .
Davvesámegiel ja lullisámegiel ohppiidlohku lea 	njiedjan 	sullii seamma ollu proseanttaid mielde maŋemus viđa jagis , ja julevsámegiel ohppiidlohku lea lassánan .
19 Sámegiella vuosttašgiellan lea 	njiedjan 	golmmain proseanttain 2005/06/2005 rájes 2010/11/2010 rádjái .
3 proseantta njiedjan viđa jagis lea unnit go dan ahkásaš ohppiidlogu njiedjan mii lei Davvi-Norggas seamma áigodagas , dat 	njiedjan 	lei badjel 7 proseantta .
Vaikko vuosttašgiela ohppiidlohku lea ge leamaš oalle dásset oalle guhkes áiggi , de lea maŋemus guovtti jagis dovdogoahtán čielga 	njiedjan 	, oktiibuot 72 oahppi unnit .
Seammás oaidnit ahte ohppiid lohku geain lea sámegiella nubbingiellan vuođđoskuvllas 	njiedjá 	.
Finnmárkku fylkkas lea doaluid lohku 	njiedjan 	čielgasit jagi 2004 rájes 2011 rádjai , 438 eanadoallofitnodagas leat báhcán 352 .
	Njiedjan 	lea badjel 20 % .
Romssas leat vel eanet geahppánan doalut 2004:s ledje 1462 doalu ja 2010:s vel 1083 doalu , 	njiedjan 	26 % .
Dát čájeha ahte barggolašvuohta guolásteamis ja eanadoalus lea 	njiedjan 	200:n jagiin 2009 ja 2010 .
Doallologu 	njiedjan 	lea liige eanet balddihahtti dan sivas go eanadoallobirrasat sámi guovlluin leat juo unnit go buohtastahttá eanadoaluin riikadásis .
Jagi 2000 rájes jahkái 2010 	njidje 	ealihanspiinnit 870 rájes 578 rádjai fylkkas – njiedjan lei 33 % .
Finnmárkku fylkkas lea doaluid lohku 	njiedjan 	čielgasit jagi 2004 rájes 2011 rádjai , 438 eanadoallofitnodagas leat báhcán 352 .
	Njiedjan 	lea badjel 20 % .
Romssas leat vel eanet geahppánan doalut 2004:s ledje 1462 doalu ja 2010:s vel 1083 doalu , 	njiedjan 	26 % .
Finnmárkku fylkkas lea doaluid lohku 	njiedjan 	čielgasit jagi 2004 rájes 2011 rádjai , 438 eanadoallofitnodagas leat báhcán 352 .
	Njiedjan 	lea badjel 20 % .
Romssas leat vel eanet geahppánan doalut 2004:s ledje 1462 doalu ja 2010:s vel 1083 doalu , 	njiedjan 	26 % .
Dát čájeha ahte barggolašvuohta guolásteamis ja eanadoalus lea 	njiedjan 	200:n jagiin 2009 ja 2010 .
Jagi 2000 rájes jahkái 2010 	njidje 	ealihanspiinnit 870 rájes 578 rádjai fylkkas – njiedjan lei 33 % .
Dát ge lea 	njiedjan 	0,9 % jagi 2011 ektui .
Go olbmuid lohku 	njiedjá 	sámi vuođđoealáhusain , de das leat váikkuhusat sámegiela ovdáneapmái boahtteáiggis .
Go olbmuid lohku 	njiedjá 	sámi vuođđoealáhusain , de das leat váikkuhusat sámegiela ovdáneapmái boahtteáiggis .
Ohcamiid lohku lea 	njiedjan 	jagi 2011 ektui 6,25 % .
Analiisajoavku čájeha Sámi logut muitalit 4-girjjis ahte daid mánáid lohku mat válde vuostái sámi mánáidgárdefálaldaga , 	njiejai 	7,5 proseanttain 2009 rájes 2010 rádjai .
Daid mánáid logu njiedjan , mat ožžot mánáidgárdefálaldaga , lea maŋimus viđa jagis leamaš oallu stuoris , muhto go dan geahččá njiedjama ektui mii lea vuođđoskuvllas , de ii leat 	njiedjan 	mánáidgárddiin dattetge nu stuoris .
Sámediggi registrere viidáseappot ahte sámi mánáidgárddiid lohku lea 	njiedjan 	ollu 2006 rájes 2010 rádjai .
Sivvan dasa sáhttá leat ahte mánáidgárddit leat heaittihuvvon dahje ođđasis organiserejuvvon nu ahte daid lohku lea 	njiedjan 	.
24 Analiisajoavku čájeha Sámi logut muitalit 4-girjjis ahte daid mánáid lohku mat válde vuostái sámi mánáidgárdefálaldaga , 	njiejai 	7,5 proseanttain 2009 rájes 2010 rádjai .
njiedjama ektui mii lea vuođđoskuvllas , de ii leat 	njiedjan 	mánáidgárddiin dattetge nu stuoris .
Sámediggi registrere viidáseappot ahte sámi mánáidgárddiid lohku lea 	njiedjan 	ollu 2006 rájes 2010 rádjai .
Sivvan dasa sáhttá leat ahte mánáidgárddit leat heaittihuvvon dahje ođđasis organiserejuvvon nu ahte daid lohku lea 	njiedjan 	.
Maŋimus 20 jagis lea veahkadatlohku Sámedikki ealáhusovddideami doarjjaortnegiid doaibmaguovllus ( SDE-guovllus ) 	njiedjan 	16 proseanttain .
Áigodagas 2000 rájes 2011 rádjai 	njiejai 	0-9 jahkásaš mánáid lohku lagabui 1 500 ( SSB .
Bargosajiid lohku vuođđoealáhusain ja industriijas lea maid 	njiedjan 	garrasit .
Stuorámus hástalussan sámi servodahkii lea várra dat ahte daid mánáid lohku , mat leat gaskal ja 9 jagi , 	njiedjá 	beallái 2000 rájes 2020 rádjai árbevirolaš sámi ássanguovlluin .
Maŋimus 20 jagis lea veahkadatlohku Sámedikki ealáhusovddideami doarjjaortnegiid doaibmaguovllus ( SDE-guovllus ) 	njiedjan 	16 proseanttain .
Áigodagas 2000 rájes 2011 rádjai 	njiejai 	0-9 jahkásaš mánáid lohku lagabui 1 500 ( SSB .
Bargosajiid lohku vuođđoealáhusain ja industriijas lea maid 	njiedjan 	garrasit .
Stuorámus hástalussan sámi servodahkii lea várra dat ahte daid mánáid lohku , mat leat gaskal ja 9 jagi , 	njiedjá 	beallái 2000 rájes 2020 rádjai árbevirolaš sámi ássanguovlluin .
Gáibádus gánnáhahttivuođa ektui lea buvttihan stuorát doaluid ja seammás lea doaluid lohku 	njiedjan 	miehtá riikka .
Gáibádus gánnáhahttivuođa ektui lea buvttihan stuorát doaluid ja seammás lea doaluid lohku 	njiedjan 	miehtá riikka .
Dát sáhttá dagahit ahte doallolohku 	njiedjá 	, muhto dát ii dárbbaš mearkkašit ahte ealáhusa olmmošlohku unnu , baicca šaddá dássedeaddu dievdduid , nissoniid ja nuoraid gaskka ealáhusas .
Lohku lea 	njiedjan 	birrasiid 3 mill. ruvnnuin 1999 loguid ektui .
Lohku lea 	njiedjan 	birrasiid 3 mill. ruvnnuin 1999 loguid ektui .
Bohtosat čájehit ahte olmmošlohku lea 	njiedjan 	oalle radikálat Máze gilis , maŋimuš 15-20 jagiin .
Hálddašanrámma fas lea 	njiedjan 	maŋimuš jagiid vaikko doaibmaguovlu lea viiddiduvvon ja eanet kultur- ja ealáhussuorggit leat boahtán doarjjaortnegiid vuollái .
Sámediggi galgá bargat ovddidit nannoset ja máŋggabealat ealáhuseallima báikegottiin go barggaheapmi vuođđoealáhusain ja almmolašsuorggis lea 	njiedjan 	, ja maiddái veahkehit hukset dárbbašlaš servodatlaš bálvalusaid sámi báikegottiin .
Hálddašanrámma fas lea 	njiedjan 	maŋimuš jagiid vaikko doaibmaguovlu lea viiddiduvvon ja eanet kultur- ja ealáhussuorggit leat boahtán doarjjaortnegiid vuollái .
Sámediggi galgá bargat ovddidit nannoset ja máŋggabealat ealáhuseallima báikegottiin go barggaheapmi vuođđoealáhusain ja almmolašsuorggis lea 	njiedjan 	, ja maiddái veahkehit hukset dárbbašlaš servodatlaš bálvalusaid sámi báikegottiin .
Árbevirolaš eana- ja gilvvagárdedoalu doarjagiid ja investerenloanaid proseantalohku lea 	njiedjan 	mearkkašahtti 2001 rájes 2002 rádjai .
Doarjagat ja investerenloanat árbevirolaš eana- ja gilvvagárdedoaluide leat proseantaloguid mielde sakka 	njiedjan 	2001 rájes 2002 rádjai .
Doarjagat ja investerenloanat árbevirolaš eana- ja gilvvagárdedoaluide leat proseantaloguid mielde sakka 	njiedjan 	2001 rájes 2002 rádjai .
Dan váivvádusa maid bággonjuovvan mielddisbuktá , lea ahte buvttaduvvon bierggu gilohaddi 	njiedjá 	sakka ja ahte buvttadeaddjit dat šaddet vuoittáhallin .
Eastadandihtii ahte sin bálká 	njiedjá 	, geat ožžot bálkká proseantta vuođul , de bajiduvvo várrepresideantta bálká 513 000 ruvnnos 540 000 ruvdnui jahkái .
Áiggis goas barggolašvuođa lohku 	njiedjá 	ja bargit vuođđoealáhusain geahppánit , olbmot fárrejit eret ja boarrásiid lohku lassána giliin , lea guolástusaid sihkkarastimis ja ovddideames deaŧalaš mearkkašupmi ássamii distrivttain .
Áiggis goas barggolašvuođa lohku 	njiedjá 	ja bargit vuođđoealáhusain geahppánit , olbmot fárrejit eret ja boarrásiid lohku lassána giliin , lea guolástusaid sihkkarastimis ja ovddideames deaŧalaš mearkkašupmi ássamii distrivttain .
ájeha ahte manná dan guvlui ahte proseantaoassi 	njiedjá 	.
ájeha ahte manná dan guvlui ahte proseantaoassi 	njiedjá 	.
NA 1999:9 „ almmusteami oktavuoÜas lea daddjon ahte vádjolusluossanálli lea issorasat 	njiedjan 	ma¹imuš 10 jagis , ja maiddái árvalusas daddjo , ma¹imuš teakstaoasis 2. siiddus , ahte luossanálli lea daÜistaga uhccon .
NA 1999:9 „ almmusteami oktavuoÜas lea daddjon ahte vádjolusluossanálli lea issorasat 	njiedjan 	ma¹imuš 10 jagis , ja maiddái árvalusas daddjo , ma¹imuš teakstaoasis 2. siiddus , ahte luossanálli lea daÜistaga uhccon .
Gaskamearálaš bálkádienas maid dinejit lassin dasa maid duddjomiin dinejit , lea 	njiedjan 	2006 rájes , geahča tabealla dás vuoábealde .
Nubbin stuorámus oassi oktasaš doarjagiin manná Kárášjohkii , 29 % jagis 2009 , muhto dát oassi lea dađistaga 	njiedjan 	42 % rájes 2006:s .
Haddegahččan boazodoalus mii oktiibuot dagahii ahte boazodoalu sisaboađut 	njidje 	, ferte
Finnmárkku fylkkas lea doaluid lohku 	njiedjan 	čielgasit jagi 2004 rájes 2011 rádjai , 438 eanadoallofitnodagas leat báhcán 352 .
	Njiedjan 	lea badjel 20 % .
Romssas leat vel eanet geahppánan doalut 2004:s ledje 1462 doalu ja 2010:s vel 1083 doalu , 	njiedjan 	26 % .
Dálá stuoramus sámifylkkas , Finnmárkkus dagahedje 1500- logu loahpa heajos guollehattit ahte dáčča ássiidlohku čađat 	njiejai 	gitta 1800-logu álggu rádjái .
Guollebivdiid lohku lea hirbmadit 	njiedjan 	ja sin gaskamearálaš ahki lea lassánan .
Vuollel 10 mehtera guhkkosaš fatnasiid sálašhivvodat orru dattege 	njiedjame 	, sihke sámi guovlluin ja eará guovlluin . #hivvodat
Luossavuovdin lassánii dássedit 1999 rádjái , ja de 	njiejai 	veahá 2001:s .
Nissonovddastus Sámedikkis lea 	njiedjan 	33%:s 18%:ii 1989 rájes 2001 rádjai .
Nubbi eará positiivvalaš dovdomearka eanadoalus sámi guovlluin lea dat , go dat doalut mat leat báhcán cevzet hui bures , ja go eanadoalliid gaskamearálaš ahki lea 	njiedjan 	.
Go geahččá olles sámi ássanguovllu veahkadatovdáneami , de oaidná ahte olmmošlohku lea 	njiedjamin 	.
Olmmošlogu 	njiedjan 	guovlobáikkiin Norggas boahtá erenoamáš čielgasit ovdan go dan buohtastahttá veahkadatovdánemiin olles Norggas .
Áigodagas 1990-2007 lei Kárášjoga gielddas 8,3 proseantta lassáneapmi ja Guovdageainnu suohkanis fas 0,4 proseantta lassáneapmi , muhto ollislaččat lei Sis-Finnmárkkus dássidis veahkadatovdáneapmi dán áigodagas , dušše smávva 	njiedjan 	áigodaga loahpas .
Gaska // MáttaRomssas ja Davit Nordlánddas lea olmmošlohku 	njiedjan 	dássedit , muhto Riddo-Finnmárkkus ja Davvi-Romssas lea njiedjan leamaš mealgat stuorát .
Gaska // MáttaRomssas ja Davit Nordlánddas lea olmmošlohku njiedjan dássedit , muhto Riddo-Finnmárkkus ja Davvi-Romssas lea 	njiedjan 	leamaš mealgat stuorát .
Dat lea uhccon sámi guovlluin , ja dát šibitlogu 	njiedjan 	meahcis dagaha ahte meahcci rohtuluvvá ja dahká álbmogii veadjemeahttumin johtalit meahcis .
Daid váraleamos dearvvašvuođa vaháguhtti ávdnasiid luoitimat ( mat sáhttet addit borasdávdda dahje čuohcat sahkaneapmái ) leat 	njiedjan 	Norggas jagi 2002 rájes , muhto allergiijadagaheaddji ávdnasat leat bisson hui seamma dásis .
Logut čájehit ahte lohku mánáin geat ožžot sámegiel fálaldaga mánáidgárddis lea 	njiedjan 	925 rájes 823 rádjái .
Mii diehtit ahte vuođđoskuvlaohppiid lohku geain lea sámegiella vuosttašgiellan lea oalle dásset , muhto ohppiidlohku geain lea sámegiella nubbegiellan 	njiedjá 	.
Earret eará manne oasit Sámeálbmot foandda dietnasis dása , juoga mii veahkehii dasa ahte lohku čáppagirjjálašvuođa giehtačállosiin mat leat dohkkehuvvon almmuheapmái , lea 	njiedjan 	.
Sámi mánáidgárddiid lohku mat gokčet Sámedikki juolludaneavttuid , lea 	njiedjan 	41 mánáidgárddis 2008:s , 37 mánáidgárdái 2009:s .
Sivva sámi mánáidgárddiid logu njiedjamii , ja dat mii muhtun muddui lea dagahan ahte mánáid lohku geat ožžot sámegieloahpahusa lea loktanan , lea ahte mánáidgárddiid lohku mat olahit eavttuid dohkkehuvvot sámi mánáidgárdin , lea 	njiedjan 	.
Ovdáneapmi tabeallas vuolábealde čájeha ahte nissonoassi bargiid gaskkas stuorru , go fas jođiheddjiid gaskkas 	njiedjá 	nissonlohku .
Gielda lea guovttegielat gitta dassái go lohku lea 	njiedján 	guđa prosentii .
Oahpahus 2. gielas lea maiddái lassánan , seammás go ohppiidlohku sámegiel 1. gielas lea 	njiedjan 	davvisámegiela guovllus .
Julevsámegiella lea lassánan 1 ohppiin mii lea 3 % lassáneapmi , ja davvisámegiella lea 	njiedjan 	3,6 % oktibuot 36:in ohppiin .
Sámegiella ja kultuvra – fálaldat lassána oarjelsámegielas 17 % ja davvisámegielas 12 % oktibuot 104 ohppiin , ja julevsámegiel guovlluin fas lea 	njiedjan 	47 % oktibuot 11 ohppiin .
Oppalaččat giellaiskkadeami ektui mii lei 2004:is , go 69 ásahusa vástidedje dán jearaldahkii , de lea ásahusaid lohku mat bálvalit sámi álbmoga hui veahaš 	njiedjan 	.
Jus buohtastahtta 2004 – iskkademiin lea ohppiid lohku 	njiedjan 	2834:is gitta 2538 rádjái 2008:is .
Doaluid lohku sámi ássanguovlluin lea 	njiedjan 	sakka .
Sávzadoaluid lohku lea eanemusat 	njiedjan 	ja nu leage riddo- ja vuotnaguovlluin leamaš negatiivvalaš ovdáneapmi , erenoamážit Finnmárkkus .
Árvvoštallojuvvon áigodagas leat eanadoalloohcamušat lassánan eanemusat , seammás go ohcamušat mat gullet almmolaš , priváhta ja sosiála bálvalusaide leat garrasit 	njiedjan 	.
Sámi ovddidanfoanda guovllupolitihkalaš váikkuheaddjin Sámi ovddidanfoandda doaibmaguvlui gullet dakkár báikkit gos lea olu heajos ovdáneapmi , nugo olmmošlogu 	njiedjan 	( eretfárren ja unnán mánát šaddet ) , unnit doaibma vuođđoealáhusain nugo eanadoalus , guolásteamis ja boazodoalus , fitnodagat heaittihuvvojit , unnán nissonolbmot bissot guovllus ja guvlui báhcá álbmot mas oppalohkái lea vuollegis oahppodássi .
Dát lea maid dehálaš danin go otná SOF – guovlu lea dakkár guovlu gos leat unnán ealáhusat , gos olmmošlohku 	njiedjá 	ja gos rahčet eretfárremiin .
Eanadoallu rámmat 	njidje 	3.2 millijuvnnas guokte vuosttaš jagi , muhto maŋemus guokte jagi leat jámma fas lassánan .
Eará ealáhusdoaimmain lei smávva 	njiedjan 	4.4 millijuvnnas 2002:s ja de fas lea lassánan jámma gitta 6 millijuvdnii 2006:s .
2002:s 2003 rádjái lei áššehivvodat veaháš 	njiedjan 	, muhto dan maŋŋá lea áššehivvodat veahážiid mielde jámma lassánan , 280 áššis jagis 2003 gitta 307 áššái jagis 2005. 2006:s #hivvodat
2002 ja 2005 , maŋemus jagi lea veaháš 	njiedjan 	.
Lohku lea dađistaga 	njiedjan 	jagis jahkái , várra danin go eanet ohcamušat registrerejuvvojit fitnodagaid vuollái .
Maŋemus jagi lassáneapmái lea várra seamma sivva go dat ahte nissonolbmuid lohku lea 	njiedjan 	, namalassii ahte ohcamušat mat gullet duodjái leat sirrejuvvon eret .
Almmatge lea Sis-Finnmárkku ohcamušaid lohku 	njiedjan 	52 proseanttas 2002:s gitta 39 prosentii 2006:s .
Finnmárkkus muđui lea ohcamušaid lohku dušše veaháš rievddadallan , muhto lea 	njiedjan 	gaskal 2005 ja 2006 , 23 proseanttas gitta 17 prosentii .
Nordlánddas leat logut lassánan ja 	njiedjan 	jagis jahkái , muhto dat dahket gaskamearálaččat 6 proseantta áššiin .
Mátta-Norgga oassi ohcamušain lea 	njiedjan 	beliin maŋemus guovtti jagis , sullii 4 proseanttas 2 prosentii .
ohcamušain lea 	njiedjan 	, ja Tromssa oassi fas lassánan .
( NIBR // SSB ) lea dát 	njiedjan 	joatkkašuvvan , ja fitnodagaid // doaimmaid lohku eanadoalus lea njiedjan logiin proseanttain gaskal 2002-2007 .
( NIBR // SSB ) lea dát njiedjan joatkkašuvvan , ja fitnodagaid // doaimmaid lohku eanadoalus lea 	njiedjan 	logiin proseanttain gaskal 2002-2007 .
Liikká oaidnit oalle čielga gova ; guolásteddjiid lohku , geat guolásteami leat registreren váldoámmahin ja lassibargun , lea 	njiedjan 	foandda doaibmaguovllus , seammás go registrerejuvvon fatnasiid lohku maid lea njiedjan .
Liikká oaidnit oalle čielga gova ; guolásteddjiid lohku , geat guolásteami leat registreren váldoámmahin ja lassibargun , lea njiedjan foandda doaibmaguovllus , seammás go registrerejuvvon fatnasiid lohku maid lea 	njiedjan 	.
Guolástusfitnodagaid // doaimmaid lohku lea maid 	njiedjan 	35 proseanttain dán áigodagas maid mii árvvoštallat ( NIBR // SSB ) .
SOF guovllu registrerejuvvon fitnodagaid // doaimmaid lohku lea veaháš 	njiedjan 	
2002 rájes 2007 rádjái , muhto go geahččá ovdalis namuhuvvon heajos ovdáneami ektui , de ii leat 3 proseantta 	njiedjan 	nu beare ollu .
Fitnodagaid lohku 	njiedjá 	eanadoalus , guolástanealáhusas , industriijas ja gálvogávppašeamis .
Lea leamaš stuora olmmošlogu 	njiedjan 	earenoamážit eanadoallosuohkaniin , ja de earenoamážit Davvi-Tromssas .
Goittotge dát váikkuhivččii dasa ahte ohcamušaid lohku 	njiedjá 	, ja dat geahpedivččii hálddahusa áššemeannudeami .
” Sámedikki eanadoallodieđáhus ( 2007 ) čájeha ahte doaluid vistehuksemiid doarjjalohku lassána , ja doarjjalohku mašiinnaid oastimiidda 	njiedjá 	.
Sámediggeráđđi lea fuolastuvvon plánaid geažil heaittihit Skániid joatkkaskuvlla ja ballá ahte heaittiheapmi dagaha ahte daid oahppiid lohku , geat válljejit sámi fágaid , 	njiedjá 	.
Dat lea dagahan ahte válgaoassálastin Oslos lea 	njiedjan 	dramáhtalaččat .
1989 sámediggeválgga oassálastin lei 78 proseantta ja 2001 válggas dat lei 	njiedjan 	56 proseanta .
Daid skuvlaoahppiid lohku , geat ohppet sámegiela vuosttašgiellan , lea 	njiedjamin 	ja buohkanassii leat uhcit ja uhcit oahppit geain lea sámegieloahpahus vuođđoskuvllas .
· Maŋimuš logijagiin lea barggolašvuohta vuođđoealáhusain boazodoallu , eanadoallu ja guolástus sámi ássanguovlluin 	njiedjan 	.
· Golmma jagis 2006 rájes 2009 rádjai 	njiejai 	vuođđoskuvlaohppiid lohku sámegielas nubbingiellan 593 ohppiin .
Oppalaš mánnálohku geain lea sámegielat mánáidgárdefálaldat , 	njiejai 	maid veaháš , muhto vuođđoskuvlaohppiid lohku geain sámegiella lea vuosttašgiellan lea bisson viehka seamma dásis dán áigodagas .
Sámedikki bealis leat mii oaidnán ahte guollevuostáiváldinrusttegiid lohku lea garrasit 	njiedjan 	.
Porsáŋggu , Guovdageainnu ja Kárášjoga gielddain lea mielkegusaid lohku 	njiedjan 	23 %:in jagi 2003 rájes jagi 2009 rádjai , go fas Finnmárkkus ja muđui riikkas lea dát lohku njiedjan 7-8 % .
Porsáŋggu , Guovdageainnu ja Kárášjoga gielddain lea mielkegusaid lohku njiedjan 23 %:in jagi 2003 rájes jagi 2009 rádjai , go fas Finnmárkkus ja muđui riikkas lea dát lohku 	njiedjan 	7-8 % .
Eanemusat lea 	njiedjan 	Kárášjogas 34 %:in .
Sávzadoaluid lohku fas lea 	njiedjan 	42 %:in , ja muđui Finnmárkkus lea njiedjan leamaš 9 % .
Sávzadoaluid lohku fas lea njiedjan 42 %:in , ja muđui Finnmárkkus lea 	njiedjan 	leamaš 9 % .
Finnmárkkus ja Romssas lea mielkedoaluid lohku 	njiedjan 	25 % jagi 2003 rájes jagi 2009 rádjai , ja sávzadoalut leat geahppánan 35% goappašiin fylkkain .
Stuorámus 	njiedjan 	SDE-guovllus lea leamaš Finnmárkku riddoguovlluin .
Lassin dasa ahte ekonomiija 	njiedjá 	boraspirevahágiid geažil , de dagahit dát vahágat olmmošlaš nođiid ealáhusdolliide geat gávdnet goddojuvvon ja gaikkoduvvon elliid .
Ovdamearkan Kanadas , go njurjonáhki gávpi lea EU:a gildosa dihte geahppánan , meahcásteaddjiid boađut leat 	njiedjan 	ja máŋgasat leat gártan heaitit ealáhusa .
Ovdamearkan Kanadas , go njurjonáhki gávpi lea EU:a gildosa dihte geahppánan , meahcásteaddjiid boađut leat 	njiedjan 	ja máŋgasat leat gártan heaitit ealáhusa .
	Aššu –
Biergohaddi lea issorasat 	njiedjan 	maŋemus logi jagis .
Mu doalus lea biergojohtu 	njiedjan 	12 proseanttain .
Ullohattit Maiddái ullohattit leat 	njiedjan 	maŋemus jagiid .
- Moatti jagis lea ullogilu haddi 	njiedjan 	birrasit 5-7 ruvnno gilu nala .
Dan rájes lea lohku 	njiedjan 	oalle jámma , ja diibmá ledje 896 čuoigi mielde .
Ja gos dat 	njiedjá 	?
Finnmárkulaččat gávdnet bargguid Eanebut ja eanebut bargagohtet Finnmárkkus , ja bargguhisvuohta 	njiedjá 	.
Riika dásis lea Finnmárkku fylkkas buot stuorámus bargguhisvuohta , muhto njukčamánus cuoŋománnui 	njiejai 	bargguhisvuohta 0,4% .
Diimmá cuoŋománu ektui - de lea bargguhisvuohta 	njiedjan 	323 olbmuin .
- Jus stáhta unnida juolludemiid , gahččá deaddu bohccobierggu ala ja dat mearkkaša ahte ealáhusolbmuid lohku 	njiedjá 	, čilge áššejođiheaddji Jarle Jonassen .
- Nu movt dál lea šiehtadallon , de galgá boazolohku 	njiedjat 	600 bohccui juohke doalus .
Seammas go eanaš eará sámi kulttorásahusat , ii leat Sámi Dáiddárráđđi ožžon lassi ruhtajuolludemiid vaikko hattit ja bargobálkkát gorgŋot seammás go ruhtaárvu 	njiedjá 	. #árvu
Seammas go eanaš eará sámi kulttorásahusat , ii leat Sámi Dáiddárráđđi ožžon lassi ruhtajuolludemiid vaikko hattit ja bargobálkkát gorgŋot seammás go ruhtaárvu 	njiedjá 	. #árvu
Du eallima eahkedisbeaivváš dál 	njiejai 	du váibmu lea jaskkodan , ráfái leat beassan
Gusat eai leat šat nu skihpasat , ja dáid jagiid lea dálkkasgeavaheapmi 	njiedjan 	23%ain .
- Ovdal ožžo gusát hui ollu várálaš dálkasiid , muhto dál lea dálkkasgeavaheapmi 	njiedjan 	.
Ja dain oaidná ahte ruoksesiedjun ja ketosedávddat leat 	njiedjan 	1995a rájes .
Ruoksesiedjun lea 	njiedjan 	17% ja ketosedávda fas 18% .
Maŋŋel go NSR 	njiejai 	1997 čavčča sámedikkeválggas , orrot njunuš luohttámušolbmot álgán beroštit davvi-sámi guovlluid dilálašvuođa birra .
NSR 	njiejai 	buot davvi-sámi válgabiriin - ja eai ožžon áirasiid Deanus ja Porsáŋggus .
Go Suopma lea searvan EO:ai , de bohccobierggu haddi 	njiedjá 	vel várra ovddežisge , iige boazodoallu leat šat dat stáđis ja sihkkaris áigáiboahtogáldu , masa sámitge ledje hárjánan buoret áiggiid oktavuođas .
Maŋimuš 10-jagi siste lea bohccobierggu nettohaddi 	njiedjan 	ja buot golut lassánan , mii lea sakka čuohcan badjeolbmuid birgenláhkái .
Gáivuona spábbačiekčan joavku lei moadde jagi dás ovdal okta buorre joavku mii čievččai 3. divišuvnnas , muhto dál sii leat 	njiedjan 	5. divišuvdnii .
Gonagas suovai Gievrras Biera viežžat gohpu , ja Gievrras Biera 	njiejai 	roggái .
Gáivuotna lea 	njiedjan 	tabeallas ja jus eai álgge buorebut čiekčat , lea váttis beassat 4. divisuvdnii , mii lea dán jagi mihttomearri .
Máze 	njiedjá 	tabeallas :
Dál lea njealját jahki go turitalohku lea 	njiedjan 	, muitala Juhls .
Gii beassá goarpmastit 2. divišuvdnii ja gii 	njiedjá 	4. divišuvdnii , mearriduvvo easkka maŋemus čiekčamiin .
Dat mii ii leat sihkar , lea galle joavkku 	njidjet 	4. divišuvdnii .
Vuolemusas tabeallas lea Leavdnja , ja Leavnnja joavku gal 	njiedjá 	njealjadii .
Su mielas orru bivdulohku 	njiedjame 	.
Mielkehaddi lea 	njiedjan 	guovtti jagis .
Gáržžes bušeahtta lea dárbbašlaš nu ahte reantu 	njiedjá 	.
Guovdageainnu sátnejođiheaddji ballá ahte jus boazobiergomárkanat sirdojuvvojit Ruŧŧii , de gal sáhttet boazobiergohattit 	njiedjat 	.
– Importeren ferte heivehuvvot nu , ahte hattit maid boazosápmelaččat ožžot njuovvanbohccuideaset ovddas , eai 	njieja 	importerema dihte , oaivvilda Meløy .
Vaikko maŋemus logi jagis lea lohku ahpehis nissoniin geat borgguhit 	njiedjan 	40 proseanttas 20 prosentii , lea ain lohku ilá stuoris , oaivvilda ST. .
Dát ortnet heive dakkár orohahkii gos boazobargu ii doaimma albmaládje ja boazolohku 	njiedjá 	nulla guvlui .
– Mii fertet unnidit barggu go guollebuktin 	njiedjá 	.
Muhto dáinna gal sáhttá bures birget jus lea ovttaoaivilis ahte lea dárbu ruhtadanpolitihkas čorget nu ahte reantu 	njiedjá 	.
Bb-ráđđehusa áiggis ii leat dat rievdaduvvon ja dan dihte lea ge 1994 rájes duohtavuođas 	njiedjan 	haddegoargŋuma dihte .
Son maid doaivu ahte olggosgolut ressursabearráigehččui nugo guođohanáigeiskamiidda , vihkken- ja lohkanbargguide 	njidjet 	.
– Dainna lágiin sávvet eiseválddit ahte boazolohku 	njiedjá 	, lasiheastá vel Issát Máhtte .
Subjevatta niedjan lea aitto das ipmirdeames , ahte dat 	njiedjá 	iežas oaidnimin .
Stuorra boazoealut eai lean vel 	njiedjan 	alážiin vuvddiide .
De 	njiedjá 	bensiidnahaddi dasttá distrivttain .
Jagiin 1987-97 lea bohccobierggu duođalaš haddi 	njiedjan 	ja lassánan doaibmagolut leat dagahan ahte duođalaš sisaboađut leat luoitán mealgadit .
Andreas oinnii , ahte ráidalas manai vulos ; dan dihte vulggii roahkka vulos 	njiedjat 	.
Andreas 	njiejai 	vuosttaš ráidalaša mielde ja bođii stuora sálii , gos ii lean eará go gintal buollime beavddi alde .
Son oinnii , ahte ráidalas manai ain vulos ; dan dihte vulggii son dan mielde vulos ain 	njiedjat 	.
Dan dihte álggii fas 	njiedjat 	ja bođii muhtun stuora sálii sisa ; das son gávnnai čáhppes gistu , ja gintal bulii beavddi alde .
Oanehaččat sáhttá dadjat , ahte Libra ulbmil lea oahpahit olbmuide rievttes borranvieruid , mat dagahit ahte sin deaddu 	njiedjá 	.
Olbmui šaddá buoret mokta , dearvvašvuohta ja iešdovdu go dovdagoahtá , ahte deaddu 	njiedjá 	, lohká Bente Monica Hætta Guovdageainnus .
Dát muitala ahte rievssafálli lohku lea 130-140 jagis 	njiedjan 	78 %:ain .
GJSa miellahttulohku lea 	njiedjan 	mannan jagi .
Ná vuođđudallá searvi evttohusastis : “ Mii vuohttit ahte spábbačiekčansearvelohku Finnmárkkus 	njiedjá 	.
Ja okta ulbmil ortnegiin leige ahte boazolohku galgá 	njiedjat 	, earenoamážit Oarje-Finnmárkkus .
Giđa rájes 	njidjet 	girdi-billeahtta hattit oalle bures , goit Tromssas , Evenáššis ja Budejjus Gardermoenii .
Dál leat bensiidnahattit Ráissas ja Navuonas 	njiedjan 	20 evrriin .
Vaikko diehttit čurvot ahte dál leat heajos áiggit ja ahte Norggas ii leat nu sihkkaris ekonomiija , de goitge čájehit logut ahte bargguhisvuohta Finnmárkkus lea veaháš 	njiedjan 	.
– Viesut leat veaháš divron renttu dihte , nu ahte olbmot eai soaitte duostata oastit ovdal go reantu fas 	njiedjá 	, lohká Roy Sætermo DnB Eiendom fitnodagas .
– Mun doaivvun ahte reantu 	njiedjá 	seamma dássái go muđuige Eurohpas , muhto eaktun leat muttolaš ( moderat ) bálkášiehtadallamat , lohká Restad .
Son ii hálit einnostit goas reantu 	njiedjá 	vel eanet .
Maiddái stádaministar Kjell Magne Bondevik lea duhtavaš ja deattuha ahte čavges ja nanu stádabušeahtta lea okta oassi máŋgga oasis , mii lea dagahan ahte reantu lea 	njiedjan 	.
Olmmošlohku 	njiedjá 	suohkanis , ja danin fertege suohkan ásahit bargosajiid vai suohkana nuoratgeardi ii guođe suohkana .
Boazolohku lea 	njiedjan 	ja seammás lea biergobuvttadeapmi unnon .
Sámi suohkaniin lea dán jagi vearrosisaboahtu 	njiedjan 	3 proseanttain dán rádjái .
Son doaivu maid , ahte Sállan // Glimt ja Čorgaš 	njiedjaba 	4. divišuvdnii .
Lahtut lassánit , ruhtadoarjja 	njiedjá 	
Doaibmadoarjja SNF:ai lea 	njiedjan 	jagis jahkái , ja unnon beliin guovtti jagis .
Hárjeheaddji : Bernt Lyngstad ja Lars Pedersen Veahki : Roald Pedersen Jođiheaddji : Karin Karlsen Moallafávttat : Bjørn Christian Pedersen ja Håvard Hårstad Suodjalusčiekčit : Bernt Lyngstad , Robin Martinsen , Vidar Martinsen , Jim Pedersen , Marius Johansen , Jan Ole Pedersen , Hugo Kristoffersen , Per S. Johansen , Roger Nilsen Guovddáš // njunuš- čiekčit : Stein G. Pedersen , Sten O. Olsen , Knut Grønnvoll , Magne Pedersen , Morten Hansen , Tommy Nilsen , Reidar Hansen , Lars Pedersen , Sigmund Dalvik , Roar Henriksen , Øystein Oldervoll ja Dag Runar Voldvik Roald Pedersen “ tippe ” , ahte Gáivuotna dehe Ráneš vuoitá 5. divišuvnna , ja ahte Vuošvággi 	njiedjá 	6. divišuvdnii .
Norggas muđui maid 	njiedjan 	logut
Son doaivu ahte olbmot leat čeahpibut šaddan johtolagas , ja dat dagaha ahte logut 	njidjet 	, muhto lohká ahte njiedjamii leat ággan ahte lei nu buolaš dálvet .
	Avvir –
– Dáid fállat go gielddas leat hástalusat doalahit olmmošlogu mii lea 	njiedjan 	maŋimuš jagiid , čilge Juuso .
Nuba muhtun su ohcejohkalaš bartaránnjáin leat jo vuovdán eret barttaideaset , ovdal go haddi dain 	njiedjá 	.
Našunála doaimma – Vaikko mii diehtit ahte rievssatlohku Finnmárkkus lea 	njiedjan 	, de eat sáhtte dušše bissehit rievssatbivddu .
Diet guovlu lea maid erenoamáš dehálaš mearralottiid ektui go doppe leat bovttášlottit olu , ja mearraloddelohku lea 	njiedjamin 	dál , čilge Haltbrekken .
Johansen lasiha vel ahte dát logut 	njidjet 	ja lassánit jagis jahkái .
Lea guhkit áigge gullon ahte njuovahagain Finnmárkkus lea ain biergu vuorkkáin , ja dát čuohcá dán jagáš njuovvanáigodahkii earret eará dan láhkái ahte kilohattit 	njidjet 	.
– Lea menddo árrat lohkat dál mo šaddá , muhto hattit gal 	njidjet 	, lohká son .
Son maid muitala , nu go Pedersen , ahte biergohaddi 	njiedjá 	.
– Dan viđa maŋimus jagis lea « davvisámegiella 2 » ohppiid lohku 	njiedjan 	vuođđoskuvllas 39 proseanttain .
Vaikko leat muhtumat geat oaivvildit ahte go olmmošlogu 	njiedjan 	sámi guovlluin váikkuha sámegiela lohkama skuvllain ja sámemánáidgárddiin , de oaivvildii Valle ahte dasa sáhttet eará sivat .
– Buhtadusat berrejit maid proseanttaid mielde rievdaduvvot dahje 	njiedjat 	presideantta bálkábuhtadusaid ektui , juoga mii dagahivččii maid dáid vuolleliidda , lohká son .
Tromsa ja Finnmárku Biebmobearráigeahču doaibmi hoavda Herdis Gaup Aamodt muitala Biebmobearráigeahčču lea geahčadeamen dál manin njuovvandeattut leat 	njiedjan 	muhtin orohagain ja lohká sii fertejit báikkálaččat oažžut dáid dieđuid .
Dát doaibma gártá nu maid eastadeaddji doaibman , ja sávvatge dáinna ahte jugešvuohta vuolleahkásaččaid gaskkas maid 	njiedjá 	, lohká Myrnes Balto .
Haddi mii mákso badjeolbmuide bohcco ovddas , lea sákka 	njiedjan 	maŋimuš jagiid .
– Dan dihte go áhpehisnissoniid lohku lea sakka 	njiedjan 	maŋimuš jagiid , de ii leat mis ráđđi doalahit eambbo go ovtta jortamovrra , lohká Nikolaisen Ávvirii .
– Mii eat gal leat vuođđun bidjan dušše daid roasuid mat ledje mannan skápma , muhto dan mii lea duohta diehtu , nu go ahte gorutdeattut leat 	njiedjan 	seammás go boazolohku lea lassánan , ja dat mii lea boahtán ovdan go leat gozihan boazoealáhusa juo guhkit áigge .
Muhto mii oažžut heajut hatti go min lábbát eai leat sturron doarvái borgemánu loahpas , easkka čakčamánu loahpas ja dalle lea haddi 	njiedjan 	, čilge Jon Nicolaisen .
Badjelaš bealli lea Sámedikki jienastuslogus , ja jus gávnnahuvvo ahte leat eanet go dát guovttos boasttu vuođul jienastuslogus , de ain 	njiedjá 	lohku .
Su gáldot Troandimis dieđihit ahte politiijaduolbmun afrihkkálaččaid ektui lea 	njiedjan 	, ja dat orru leamaš váttisvuohta .
Son čilge ahte ágga manne eai nákce lágidit festivála dán jagi lea go Guovdageainnu Musihkkariid Searvvi miellahttolohku lea 	njiedjan 	hirbmosit , ja nu eai gártta doarvái eaktodáhtolaš bargit .
Eai leat leamaš čeahpit Buljo lohká searvvi váldit siva go miellahttolohku lea 	njiedjan 	bearehaga .
Gean ovddasvástádus lea go min bohccuin 	njidjet 	njuovvandeattut , bidjá Sara gažaldaga .
Lea olu mii sáhttá rievdat logi jagis , ruhtaárvu sáhttá 	njiedjat 	ovdamearkka dihte . #árvu
Bargguhisvuohta Finnmárkkus 	njiedjá 	veaháš .
– Lohku 	njiedjá 	dábálaččat veaháš čakčat .
Čáhcesullos , Guovdageainnus , Kárášjogas ja Mátta-Várjjagis lea bargguhisvuohta eanemusat 	njiedjan 	.
Nanus duodjefágalaččat Teigen lohká alddis dan olis go lea Sámiid Duodji searvvi ráđđečoahkkinlahttu dál álgán luohttámuša DI direktevrii 	njiedjat 	.
Ruhtadilli ferte buorránit Historihkka čájeha ahte go Hætta heittii váldohárjeheaddjin Álttá joavkkus 15 jagi dassái , de 	njiejai 	joavku jagi maŋŋel vuohon nuppi divišuvdnii .
Erenoamážit ahkemearri lea 	njiedjan 	roavvasit filmmain , go hárve boahtá daid áiggiid filbma mas lea 18-jahkásaš ahkemearri .
Rievdadusaiguin háliidit movttiidahttit boazodoalu njuovvat eambbo vai boazolohku 	njiedjá 	Finnmárkku orohagain .
Maŋimuš jagiid leage oahpaheddjiid ohppiid lohku 	njiedjan 	mealgadit Sámi allaskuvllas Guovdageainnus ja Rektor Steinar Pedersen lea balus mo Sámi skuvllat boahtteáiggis galget birget sámegielat oahpaheddjiid váilevašvuhtii .
Alimus boazolohku 	njiedjá 	– Muhtun Guovdageainnu orohagain leat beare olu bohccot orohaga alimus boazologu ektui .
avvir.no : Finnmárkkus 	njiedjá 	aviisaprentehus
Finnmárkkus 	njiedjá 	aviisaprentehus Carl on 17 February , 2009 06:25:00
Sihke MBL ja LLA dieđihit ahte riikadásis obbalaččat lea prentehus 	njiejan 	, muhto báikkálaš aviissain lea lassánan .
Finnmárkkus ja Romssas leat sihke báikkálaš ja gávpotaviissat 	njiedjan 	.
Sis ledje 2008:s 9.858 prentehusa , ja ledjet dalle 	njiedjan 	719 prentehusain .
Ii vuorjašuvvat MBL dieđiha ahte leat 15 aviissa main lea 	njiedjan 	prentehus badjelaš viđain proseanttain , dán 15 searvvis lea VG ja Dagbladet .
Ovddastusbellodat ( FRP ) lea miehtebiekkas ja lea ovdánan 8 proseantta čuoggáin juovlamánu jienastaniskkadeami rájes Oktiibuot oaččui FRP 11,7 proseantta jienain , AP oaččui 32,0 , ja 	njiejai 	7,4 proseanttain ja NSR fas 23,5 proseantta , dat maid njiejai 1,4 proseanttain .
Ovddastusbellodat ( FRP ) lea miehtebiekkas ja lea ovdánan 8 proseantta čuoggáin juovlamánu jienastaniskkadeami rájes Oktiibuot oaččui FRP 11,7 proseantta jienain , AP oaččui 32,0 , ja njiejai 7,4 proseanttain ja NSR fas 23,5 proseantta , dat maid 	njiejai 	1,4 proseanttain .
Buozalmasjávkan lea 	njiedjan 	12 proseanttas 9,4 prosentii , muitala Deanu gieldda prošeaktajođiheaddji Vigdis Blien .
Olmmošlohku lea 	njiedjan 	ja dál lea veadjemeahttun oažžut mánnábearrašiid ásaiduvvot Moskái go dihtet skuvla lea heaittihuvvon , joatká Klæboe .
– Mii diehtit olusiid geat čohkkájit miehtá máilmmi iežaset dihtoriid ovddabealde , ja čuvvot mielde mii dáhpáhuvvá Nilut Cupas , lohká jođiheaddji gii ii bala ahte cupa guosselohku 	njiedjá 	vaikko cupa čájehuvvo neahtas .
Kárášjogas , Guovdageainnus ja Porsáŋggus leat oktiibuot 	njiedjan 	mielkegusaidlohku 23 proseanttain guđa jagis 2003 rájes .
avvir.no : Sámi aviissaid lohkkiidlohku ii 	njieja 	
Sámi aviissaid lohkkiidlohku ii 	njieja 	Karen Anne Sara Utsi karen@avvir.no on 17 February , 2010 02:57:00
Olles Norggas 	njiedjá 	báberaviissaid lohkkiid lohku .
– Eat vuoiŋŋastišgoađe Ávvira váldodoaimmaheaddji Sara Beate Eira lea maid duhtavaš go Ávvira lohkkiidlohku ii 	njieja 	.
– Jus geahččá movt aviisalogut 	njidjet 	miehtá Norgga , de gal dieđusge lean duhtavaš dainna ahte mii eat mana ruovttoluotta , muhto ii dieđus leat jur miela mielde go eat ovdán , lohká Eira .
Dat lohku lea 	njiedjan 	50 ohcciin 2007 ektui .
Maiddái kultuvrralaš stáhtus lea dehálaš , mii láktasa gielalaš váldái , Giela stáhtus badjána ja 	njiedjá 	dađi mielde , man jábálaččat leat dán giela hállit .
– Mii leat duollet dálle oaidnán ahte haddi 	njiedjá 	muhtun evrriin , ovdal go fas gorgŋe .
Danin 	njidje 	Molleha vuordámušat gehččiid ektui .
Dárkkisteapmi lea mielddisbuktán ahte 2006 ledje sullii 850 báikkálaš guolásteaddji , ja dárkkisteami maŋŋá lea lohku 	njiedjan 	vuollel 700 .
Biergodietnasat vurdojuvvojit unnut dan geažil go njuovvanhivvodat 	njiedjá 	. #hivvodat
Váldosivvan dasa lea njuovvanhivvodaga 	njiedjan 	, ja unnideapmi areálabahkkemiid buhtadusain .
– namalassii viežžat Kristusa vuolás – 7 dahje : Gii 	njiedjá 	čiekŋalassii ?
Gonagas suovai Gievrras Biera viežžat gohpu , ja Gievrras Biera 	njiejai 	roggái .
Lea vuosttaš jáhkki 2005 rájes ahte ohcciidlogut Norggas eai leat 	njiedjan 	, nu ahte leat oallugat geat háliidit oahpu gazzat .
Ossosiid árvu miehtá máilmmi 	njiedjá 	ja njiedjá . #árvu
Ossosiid árvu miehtá máilmmi njiedjá ja 	njiedjá 	. #árvu
Dat dieđusge eaktuda ahte báŋkkut muđui čuovvolit vuolideami , muhto dan gal jáhkkit , go reantu muđui máilmmis lea aivve 	njiedjan 	.
Reantu lea loktanan ja fas 	njiedjan 	, nu lea maid bensiidnahaddi dahkan .
Ii dan dihte gal ahte ohppiidlohku 	njiedjá 	, muhto go suohkaniin ii leat ekonomalaš dilli nákcet dan .
Finnmárkkus lea 	njiedjan 	jođánepmosiid borgguheddjiid lohku , muhto leat ain eanemus borgguheaddjit oktii Romssain , Nordlánddain , Østfoldain ja Telemárkkuin .
Suohkan- ja dearvvašvuođasuorggis leat mii dain maŋemus 10-12 jagiis oaidnán ahte gaskamearálaš penšunerenahki lea 	njiedjan 	.
Gaskamearálaš bohtosat čájehit ahte vuoddji reakšuvdna 	njiejai 	35 proseanttain , juoga mii lea arvat heajut go vudje mátketelefovnna haga .
– Dáid fállat go gielddas leat hástalusat doalahit olmmošlogu mii lea 	njiedjan 	maŋimuš jagiid , čilge Juuso .
Finánsaroassu ii čuoza Finnmárkku bargomárkanii , gos bargguhisvuohta lea 	njiedjan 	čakčamánu rájes .
Lohku lea 	njiedjan 	0,4 proseantačuoggáin čakčamánu rájes .
Oljohaddi 	njiedjá 	fas
Dat dagaha ahte oljohaddi lea 	njiedjan 	3,40 dollariin beaivit ikte .
Dat fas lea mielddisbuktán ahte Oslo Bursa lea 	njiedjan 	2 proseanttain , ja Statoil-Hydro fas 4 proseanttain , máŋga eará offshore-fitnodaga leat maid njiedjan árvvus , nugo DNO mii njiejai 4,8 proseanttain .
Dat fas lea mielddisbuktán ahte Oslo Bursa lea njiedjan 2 proseanttain , ja Statoil-Hydro fas 4 proseanttain , máŋga eará offshore-fitnodaga leat maid 	njiedjan 	árvvus , nugo DNO mii njiejai 4,8 proseanttain .
Dat fas lea mielddisbuktán ahte Oslo Bursa lea njiedjan 2 proseanttain , ja Statoil-Hydro fas 4 proseanttain , máŋga eará offshore-fitnodaga leat maid njiedjan árvvus , nugo DNO mii 	njiejai 	4,8 proseanttain .
Jus bakteriija árvu 	njiedjá 	de ii dárbbaš álbmot šat vuoššat čázi . #árvu
Raporta čájeha ahte 1990 rájes lea olmmošlohku 	njiedjan 	14,2% sámi riddo- ja vuotnaguovlluin siskkobealde sámi ovdánahttinfoandda doaibmaguovllu ( SUF- guovlu ) .
Norggas lassána olmmošlohku , Finnmárkkus ges 	njiedjá 	olmmošlohku .
Vaikko maŋemus kvartála 	njiejai 	lohku , de lea dassážii dán jagi Finnmárkku olmmošlohku lassánan .
Su mielas galggašii baicce lasihit gildii dáinnalágiin almmolaš bargosajiid dál go olmmošlohku lea 	njiedjamin 	, dadjá Breivik .
Seammás go boarrásat geardi lassána , de lohku nuorat olbmuin 	njiedjá 	ja sin gaskkas han galggašedje ge rekrutteret divššáriid ja eará fágaolbmuid .
Historihkka čájeha ahte go Hætta heittii váldohárjeheaddjin Álttá joavkkus 15 jagi dassái , de 	njiejai 	joavku jagi maŋŋel vuohon nuppi divišuvdnii .
Dat ii galgga 	njiedjat 	iige lassánit , lohká Finnmárkku fylkamánni boraspirekonsuleanta Paul Nilsen .
Bargguhisvuohta Finnmárkkus 	njiedjá 	veaháš .
– Lohku 	njiedjá 	dábálaččat veaháš čakčat .
Čáhcesullos , Guovdageainnus , Kárášjogas ja Mátta-Várjjagis lea bargguhisvuohta eanemusat 	njiedjan 	.
– 2002/2003/2002 vuvddiimet 17% divatkeahtes skohtera , moadde jagi maŋŋá lei lohku 	njiedjan 	5 prosentii , čilge Kårud .
Gokčá haddegoargŋuma , muhto 	njiedjá 	veahá .
Nuorta-Finnmárkkus leat ges bággovuovdimat 	njiedjan 	maŋemus jagi .
– Ođđaáigásaš bivdovuogit , dálkkádatrievdamat ja nuoskkideamit sáhttet leat sivvan dasa go maiddái Deanu čázadagas lea hivvodat 	njiedjan 	, čállá searvvi jođiheaddji Ingrid Nordal preassadieđáhusas . #hivvodat
Gaskamearálaš njuovvandeaddu 	njiejai 	
Sihke sarvá- ja miessenjuovvandeaddu 	njiejai 	diibmá .
Dás vuhtto gaskamearálaš njuovvandeaddu olles Norggas lea 	njiedjan 	0,6 kiloin .
Nuorta-Finnmárkkus 	njiejai 	njuovvandeaddu kiloin ( 23 - 22 kilo ) jagi 2006 diimmá rádjái .
– Mun doarjjun eanas moaitámušaid maid Aline Mikkelsen ovddida Duodjeinstituhta ( DI ) vuostá , ja ferten lohkat ahte mu luohttámuš direktevrii 	njiedjá 	iige leat šat nu fávdnát , lohká Sámiid Duodji jođiheaddji Karl Fredrik Teigen .
Teigen lohká alddis dan olis go lea Sámiid Duodji searvvi ráđđečoahkkinlahttu dál álgán luohttámuša DI direktevrii 	njiedjat 	.
Lea olu mii sáhttá rievdat logi jagis , ruhtaárvu sáhttá 	njiedjat 	ovdamearkka dihte . #árvu
– Dat maid mii leat maŋemus jagiid vuohttán lea ahte sin lohku geat gasku skuvlajagi heitet lea 	njiedjan 	, ja sii geat dávjjimusat heitet leat olggobealde Guovdageainnu oahppit , muitala Steinfjell .
Maŋimuš beivviid áigge haddi lea veháš 	njiedjan 	.
Maŋimuš beivviid bensiinna haddi lea 	njiedjan 	maiddái Lappi guovllus .
Dán jagi goalmmát kvartála lea lohku 	njiedjan 	4.9 prosentii .
Muhto go seamma fitnodagat bohket oljju eará máilmmiosiin , de fáhkkestaga 	njidjet 	gáibádusat .
– Ávžžuhuvvon bensiidnahaddi boahtá 	njiedjat 	12,13 ruvdnui , ja dieselhaddi njiedjá 12,20 ruvdnui mánnodaga , muhto lea dehálaš muitit ahte pumpehaddi ja ávžžuhuvvon haddi eai dárbbaš leat seamma , das go lea báikkálaš gilvu mii dan mearrida , cealká diehtojuohkinhoavda Knut Hilmar Hansen , Statoil Norge .
– Ávžžuhuvvon bensiidnahaddi boahtá njiedjat 12,13 ruvdnui , ja dieselhaddi 	njiedjá 	12,20 ruvdnui mánnodaga , muhto lea dehálaš muitit ahte pumpehaddi ja ávžžuhuvvon haddi eai dárbbaš leat seamma , das go lea báikkálaš gilvu mii dan mearrida , cealká diehtojuohkinhoavda Knut Hilmar Hansen , Statoil Norge .
– Leat olusat geat nuvsejit skuvllas , muhto mii vuohtit ahte lohku lea 	njiedjan 	, lohká rektor Ruth Larsen .
– Ovdalis áigge gal vázzui dohko ja lassin vel máŋggat diimmut meahcásteamis , nuba leai buorre beassat čákŋat buvrái das láhkosis , iige nođiin dárbbaš gitta ruoktot 	njiedjat 	.
Duogážin dasa lea go Statistihkalaš guovddášdoaimmahaga logut čájehit ahte diibmá buktojuvvoje unnit boarrásit biillat šláddjedeapmái , iige boares biillaid lohku Norgga luottaid alde 	njieja 	.
Dán bohtosa leat son gávnnahan go lea dutkan vuorrasut nissonolbmuid geain lea migrene oaivebávččas ja fuomášan ahte dát váralaš dilli 	njiedjá 	30% eará nissonolbmuid ektui geain ii leat migrene .
Dán rájes lea lohku 	njiedjan 	jagis jahkái .
Dássážii 2008:s ( ođđajagimánus-suoidnemánnui ) leamaš guosselohku 	njiedjan 	2,2 % Nordlánddas , badjánan 2,6 % Romssas , ja njiedjan 1,2 % Finnmárkkus .
Dássážii 2008:s ( ođđajagimánus-suoidnemánnui ) leamaš guosselohku njiedjan 2,2 % Nordlánddas , badjánan 2,6 % Romssas , ja 	njiedjan 	1,2 % Finnmárkkus .
Oba Norggas lea lohku 	njiedjan 	0,2 proseanttain .
Miessemánu rájes lea dat 	njiedjan 	badjel bealgoalmmát ruvnno .
Maŋŋel go oljohaddi 	njiejai 	de lea maid bensiidnahaddi ollegoahtán 11 ruvnno rádjái .
Oaidnit dán guovtti maŋemus jagis ahte ohppiid lohku sámi nubbingiellaoahpahusas lea 	njiedjan 	olles 26% .
– Seammás go guhkit áiggiid lea leamašan positiivvalaš ja illudahtti ovdáneapmi ohppiid logu ektui geain lea sámegiella fágasuorggis , lea mearkkašahtti ahte dán guovtti jagis lea ohppiid lohku geain lea sámegiella nubbingiellan nu ollu 	njiedjan 	, lohka Sámediggeráđi lahttu Jørn Are Gaski .
Norggas 	njidje 	obbalohkai idjadeamit suoidnemánu 4,5 proseanttain .
Olgoriikkalaččaid lohku geat idjadalle hoteallain dan rádjái dán jagis 	njiejai 	14,3 proseanttain Nordlánddas , Romssas 4,3 % ja Finnmárkkus 12,4 proseanttain .
Finnmárkkus manai dat lohku vulos , idjadeamit 	njidje 	1,8 proseanttain .
Suoma YLE Radio loguid mielde turisttaid lohku 	njiedjá 	várra 30.000 olbmuin .
Raporta čájeha ahte 1990 rájes lea olmmošlohku 	njiedjan 	18,5% sámi riddo- ja vuotnaguovlluin siskkobealde sámi ovdánahttinfoandda doaibmaguovllu ( SUF- guovlu ) .
Astrid lohká iežas borastit veaháš ovdalgo lášmmohallagoahtá , amas ii varrasohkar 	njieja 	menddo olu .
Giela stáhtus badjána ja 	njiedjá 	dađe mielde , man jábálaččat ieš guđet guovlluin leat dán giela hállit .
Muhto guolásteddjiid lohku lea 	njiedjan 	ja viesuin čuovggat jáddan .
Sámedikki bealis leat mii oaidnán ahte guollevuostáiváldinrusttegiid lohku lea garrasit 	njiedjan 	.
Olu sajiin 	njiedjá 	sámegielhálliid lohku jagis jahkái ja giella soaitá oalát jávkat .
Ovdamearkka dihte Álttás 2008:s 	njiejai 	lohku ohppiin geat sámegiela lohket skuvllain čuđiin .
Girdinmátkkošteddjiid lohku lea 	njiedjan 	olles Suomas earretgo davimus Suomas .
Álgojagis 	njiejai 	Suomas
2007:s borgguhii 21% álbmogis beaivválaččat , muhto diibmá lei lohku 	njiedjan 	ovttain proseanttain .
– Skuvlaohppiid lohku , geat ohppet sámegiela vuosttašgiellan , lea 	njiedjamin 	ja buohkanassii leat uhcit ja uhcit oahppit geain lea sámegieloahpahus vuođđoskuvllas .
Ikte ilbme aviissaid lohkkiidlogut miehtá Norgga ja dát čájehit ahte lohkkiidlogut 	njidjet 	miehtá riikka .
Oppalaččat Finnmárkkus 	njiedjá 	lohkkiidlohku 2.1 proseanttain ja olles riikkas lea lohkkiidnjiedjan 2.8 proseantta .
Almmolašlogut čájehit maiddái ahte leat smávva aviissat main leat vuollel 5000 lohkki mat eai 	njieja 	lohkkiidloguid ektui .
Ráđđehusa bivnnutvuohta 	njiedjá 	go reantu goargŋu .
Dás boahtá čielgasit ovdan ahte oahppodássi Norgga ohppiin 	njiedjá 	máŋgga guovddáš surggiin .
Fágaid maid sáhtte namuhit gos dássi 	njiedjá 	lea matematihkas , lohkamis ja luonddufágain .
Dađistaga leat vuohttigoahtán ahte maid sihke skuvlla ja oahpaheddjiid stahtus lea 	njiedjan 	ja maid dát iskkadeapmi dál duođai dan duođašta .
Lea maid daddjon ahte ohppiid lohku 	njiedjá 	.
Buot lágan málbme- ja geađgedoaimmain lea haddi issorasat 	njiedjan 	.
Dál leat buot dát plánat fas eahpesihkkaris dilis go haddi fas 	njiedjá 	.
Sámi bivnnutvuohta 	njiedjamin 	
Sámi statistihka analysajoavkku jođiheaddji ja Sámi allaskuvlla professor Jon Todal diehtá muitalit ahte Sámegielaohppiid lohku 	njiedjá 	dramáhtalaččat olles Norggas .
Professor Jon Todal fas oaivvilda ahte dát ođđa máhtoloktenprográmma ferte váldit oasi sivas go ohppiidlohku lea 	njiedjan 	.
Mii oaidnit ahte Kárášjogas ja Guovdageainnus 	njiedjá 	jienastuslohku , muhto gávpogiin fas lassána .
Ovddádusbellodat fas 	njiedjá 	1,9 proseanttain 23,1 prosentii .
Olgeš maid 	njiedjá 	, 1,8 proseanttain 14,6 prosentii .
Sihke Kristtalaš Álbmotbellodat ja Gurut 	njidjet 	0,5 proseanttain , čállá Nordlys .
Seammás go borramušgálvohattit 	njidjet 	viđain proseanttain , de divru alkohola viđain proseanttain .
Lohku lea lihkus 	njiedjan 	1980-logu rájes .
Dán rádjai leamašan eahpedábálaš liekkas , muhto dán vahku áigge liekkas 	njiedjá 	gaskamearálaš dássái .
Dán guovllus čájehit dárkilis mearkkat mo čáhci lea 	njiedjan 	maŋŋil maŋemus jiekŋaáiggi , sullii 10 000 jagi dassái .
Sámeálbmotalla skuvlla lei doaimmas 1949 gitta 1985 go giddejedje skuvlla go ohppiid lohku 	njiejai 	.
Dán jagi lei provišuvdna 	njiedjan 	6-7 ruvnno kilos , govvida Jåma gean mielas lea dát jahki leamašan earánoamáš heittot .
Máilmmi temperatuvra ii dušše badján , muhtun báikkiin 	njiedjá 	, muitala Anders Oskal , gii lea okta dain máŋggain jođiheddjiin Ealát dutkanprošeavttas . #temperatuvra
Jođiheaddji Anders Oskal vuohttá ahte máilmmi media navdá ahte máilbmi lieggana , muhto máilmmis gávdnojit báikkit maid gos temperatuvra 	njiedjá 	. #temperatuvra
– Oarjjabealde Ruoššas gávdno báiki gos duođaštuvvo ahte temperatuvra 	njiedjá 	, čilge Oskal . #temperatuvra
Hálbbimus stohpoloanat sáhttet dasto 	njiedjat 	2,5 prosentii muitala dinepenger.no redaktevra Günther Backe .
• Maŋimuš logijagiin lea barggolašvuohta vuođđoealáhusain boazodoallu , eanadoallu ja guolástus sámi ássanguovlluin 	njiedjan 	.
• Golmma jagis 2006 rájes 2009 rádjai 	njiejai 	vuođđoskuvlaohppiid lohku sámegielas nubbingiellan 593 ohppiin .
Oppalaš mánnálohku geain lea sámegielat mánáidgárdefálaldat , 	njiejai 	maid veaháš , muhto vuođđoskuvlaohppiid lohku geain sámegiella lea vuosttašgiellan lea bisson viehka seamma dásis dán áigodagas .
Son čujuha ge bohtosii mat muitalit ahte ohppiidlohku sin gaskkas geat váldet sámegiela nubbin giellan , lea 	njiedjan 	meastta 600 ohppiin dušše golmma jagis .
Dál álgá nubbi dutkanjahki SALSEA prošeavttas , gos áigot gávnnahit manne luossalohku 	njiedjá 	mearas .
Oalgebálgát 	njidjet 	vulos deatnogátti mátkeealáhusfitnodagaide , mat de besset ávkkástallat gussiiguin .
Dan rájes go njálla ráfáidahttojuvvui Norggas 1930-logus , lea njálla lohku dađistaga 	njiedjan 	.
Kontali einnosta riikkaidgaskasaš luossamárkan 	njiedjá 	golmmain proseanttain , muhto Norgga márkanposišuvdna nannejuvvo Chile váttisvuođaid geažil .
Deanus čájehuvvo ain stuorát 	njiedjan 	sállašis daid maŋimuš jagiid , go eará čázádagain .
Bargguhisvuohta 	njiedjá 	ain Finnmárkkus
Mannan vahkku ledje doavtterkantuvrrain miehtá Norgga dieđihan 5,1 proseantta njoammuma , ja dán vahkku ektui mas lei 	njiedjan 	3,5 prosentii .
Anára Sámemusea Siidda galledeaddjilohku lea 	njiedjan 	.
Siidda čájáhusat ja dáhpáhusat geasuhedje diibmá vádjit 50 000 olbmo , ja galledeaddjilohku 	njiejai 	ovddit jagis measta 12 proseanttain .
Suopmelaččaid mátkkoštanmokta 	njiedjá 	, muhto tuiskalaččaid lohku lassána , árvala Sámemusea márkanastinčálli Unni Länsman .
Su rumaštemperatuvra lei 	njiedjan 	13,7 lieggaceahkkái . #temperatuvra DE-Ill
Nu olu ahte sin dienas ferte 	njiedjat 	máŋga ceahki .
Guohtunguovllut bohtet 	njiedjat 	80 proseanttain 40 prosentii jus huksemat Barents-rittus jotket seammá leahtuin go dassážii leat dahkan .
Golbma maŋemus mánuid 2008:s 	njidje 	viessohattit miehtá Norggas .
Norges Boligbyggelag ( NBBL ) loguid mielde 	njidje 	diibmá hatti adnon viesuin 6,4 proseanttain , goalmmát áigodagas njealját áigodahkii .
Sihke MBL ja LLA dieđihit ahte riikadásis obbalaččat lea prentehus 	njiedjan 	, muhto báikkálaš aviissain lea mannan lassánan .
Finnmárkkus ja Romssas leat sihke báikkálaš ja gávpotaviissat 	njiedjan 	.
Logut čájehit ahte aviisavuovdin lea 	njiedjan 	Finnmárkkus ja Romssas .
Sihke MBL ja LLA dieđihit ahte riikadásis obbalaččat lea prentehus 	njiejan 	, muhto báikkálaš aviissain lea lassánan .
Finnmárkkus ja Romssas leat sihke báikkálaš ja gávpotaviissat 	njiedjan 	.
Sis ledje 2008:s 9.858 prentehusa , ja ledjet dalle 	njiedjan 	719 prentehusain .
MBL dieđiha ahte leat 15 aviissa main lea 	njiedjan 	prentehus badjelaš viđain proseanttain , dán 15 searvvis lea VG ja Dagbladet .
Jándorkoarta vuovdin lea 	njiedjan 	vehá maŋŋá 2002 , heajos bivddu dihtii , 2008:s vuvdo 33 000 jándorkoartta Suomas .
Deanu sálaš 	njiedjamin 	garrasit
Man olu luossa goddo Deanu čázádagas eará Norgga čázádagaid ektui lea 	njiedjamin 	.
Olmmošlohku lea 	njiedjan 	ja dál lea veadjemeahttun oažžut mánnábearrašiid ásaiduvvot Moskái go dihtet skuvla lea heaittihuvvon , joatká Klæboe .
Hartvig Birkely ja Olav Verstad eaba dieđe siva manin leat nu unnán čuoiganberoštupmi SVL-lahtuid gaskas ja ahte lohku lea 	njiedjan 	. #lohku
Ovddastusbellodat ( FRP ) lea miehtebiekkas ja lea ovdánan 8 proseantta čuoggáin juovlamánu jienastaniskkadeami rájes Oktiibuot oaččui FRP 11,7 proseantta jienain , AP oaččui 32,0 , ja 	njiejai 	7,4 proseanttain ja NSR fas 23,5 proseantta , dat maid njiejai 1,4 proseanttain .
Ovddastusbellodat ( FRP ) lea miehtebiekkas ja lea ovdánan 8 proseantta čuoggáin juovlamánu jienastaniskkadeami rájes Oktiibuot oaččui FRP 11,7 proseantta jienain , AP oaččui 32,0 , ja njiejai 7,4 proseanttain ja NSR fas 23,5 proseantta , dat maid 	njiejai 	1,4 proseanttain .
– Buot vearrámus borasnávdeváttisvuođas lea go nuorra boazodolliid mokta 	njiedjá 	.
Direktoráhtas lohket loguid gelddolažžan , go leat vuordán loguid 	njiedjat 	daid doaimmaid geažil maid leat bidjan johtui hehttet boraspiriid goddimis sávzzaid .
Váikkuhus das lea ahte Dagbladet fálaldat boahtá 	njiedjat 	.
Ođasmahttojuvvon jietnaváiddon rámiduvvo stuorrát ja návdo ahte rusttet ii 	njieja 	luođa leahtu , iige rievdat luođđageainnu , muhto baicca lea skuhttáreabbo .
– Mun balan hatti 	njiedjat 	ollu boahtte jahkái , dadjá Varanger Vilt njuovahaga jođiheaddji .
– Mun lean ieš leamaš iskame mannan vahkku dain rámbuvrriin gosa mii vuovdit bierggu ja lean oaidnán ahte biergu lea rámbuvrriin , muhto olbmot eai oastte dan go lea divrras , muitala son ja danin jáhkká ge ahte bohccobierggu haddi 	njiedjá 	boahtte jahkái .
– Haddi sáhttá 	njiedjat 	, dadjá son , muhto vásiha juste dál ahte jođiha veháš bierggu .
Njuovahagat einnostit ahte bohccobierggu haddi 	njiedjá 	boahtte jahkái .
Alimus boazolohku 	njiedjá 	
2009 ođđajagi 	njiejai 	olmmošlohku Kárášjogas 80 olbmuin .
Kárášjogas 	njiejai 	80 olbmuin ja dál lea 2.786 ássi gielddas .
Maŋimuš guovtti jagis lea olmmošlohku 	njiedjan 	160-170 olbmuin .
Maŋimuš jagiid leage oahpaheddjiid ohppiid lohku 	njiedjan 	mealgadit Sámi allaskuvllas Guovdageainnus ja Rektor Steinar Pedersen lea balus mo Sámi skuvllat boahtteáiggis galget birget sámegielat oahpaheddjiid váilevašvuhtii .
Ealáhusa ruhtadilli 	njiedjá 	
– Mun lean vuorjašuvvan go boraspiret goddet nu olu bohccuid ahte ealáhusa ruhtadilli 	njiedjá 	.
Dain leat máŋga hámi , ja eatnašat dagahit njealji lágan effeavttaid : jiena , čuovgga , suova ja dávviriid mat 	njidjet 	, nu mo « konfetti » .
Gieldda visttiin lea energiijageavaheapmi dán áigodagas 	njiedjan 	28% ja mihttomearri lei 15% .
Dan botta go virggálašbivdiid lohku lea 	njiedjan 	100 000 bivdis 1950-logus dušše 10-12 000 bivdi vel otne .
Davvi-Sámi jávrriid čáhceoaivvit leat 	njiedjan 	galbma dálkkiid geažil .
Dutkan čájeha ahte guliid šaddu lea unnon beliin 20-30 jagiin , ja obbalaš lohku lea 	njiedjan 	60 proseanttain .
Temperatuvra lei 	njiedjan 	gitta - 1 buolašceahkkái .  #temperatuvra DE-Ill
Dollára árvu 	njiedjá 	 #árvu
Dan vurdet vel 	njiedjat 	Norgga ruvnno ektui .
Dál 	njiedjá 	sámegielhálliid lohku , iige lassán , lohká sámediggeáirras , Ann Mari Thomassen sámekonferánssas Loabágis , gieldda giellalávgunguovddáža ásaheami oktavuođas .
Go Ávvir jearrá doaivu go sátnejođiheaddji ahte Norgga Stáda juolluda lassi ruhtadoarjaga Sámedikki giellahálddašanbušehttii , vai eará giellahálddašansuohkaniid doarjjaárvu ii 	njieja 	, de vástida Hausberg ahte dáruiduhttináigodat čuozai garrasit Romssa gávpogii ja dál lea Stádas vejolašvuohta njulget ja addit sápmelaččaide ruovttoluotta dan maid leat massán , earenoamážit sámegiela . #árvu
Son muitala Deanus oahppagohtet mánát njoarostit mánáidgárdde rájis ja joatkit vuođđoskuvllas , muhto njoarosteddjiid lohku 	njiedjá 	.
Buozalmasjávkan lea 	njiedjan 	12 proseanttas 9,4 prosentii , muitala Deanu gieldda prošeaktajođiheaddji Vigdis Blien .
Troandimis leat doarrumat 	njiedjan 	30 proseanttain , maŋŋel go gávpot lea oanidan alkoholavuovdináigemeari ovttain diimmuin .
Olmmošlohku 	njiedjá 	Lappis
Suoma bealde Lappi leana olmmošlohku 	njiedjá 	ain .
Iskkadeamit čájehit ahte máhttu lea 	njiedjan 	guovddáš osiin .
Hedmárkku regiovdna viđežis lea geatkelohku eanemusat 	njiedjan 	( Golmmain geatkečearddain ) .
Nordlys spábbačiekčan joavku ii birgen 3. divišuvnnas mannan jagi ja 	njiejai 	4. divišuvdnii .
Go mánáid lohku lea 	njiedjan 	jagis jahkái ja ballagođiimet ahte oalát doarvái beroštupmi dása . #lohku
Kalheim lohká maŋemus jagiid viessobuollimiid lohku várrogasat 	njiedjan 	, muhto son ballá dán positiiva ovdáneami jorgalit , jus eanet viesut ožžot ođđa el-rávdnjelohkkiid ja ožžot el-rávdnjegeavaheami rehkenastojuvvon differensierejuvvon el-rávdnjehattiid mielde .
Jagi 2003 rájes rievssatsálaš lea 	njiedjan 	dutkamuša mielde buot guovlluin ja buot bivdojoavkkuin oktiibuot 71 proseantta .
Ruoŧa ruvdno árvu 	njiejai 	80 evrii , Norgga ruvnno ektui . #árvu
Valuhta analytihkar Ole Håkon Eek-Nilsen čilge ahte sivvan manne Ruoŧa ruvnno árvu lea 	njiedjan 	olles guđain evrriin dán maŋemus áiggis , lea go Ruoŧa báŋkku Swedbank finánsadirektevra dieđihii ahte Latvia lea gearggus devalueret . #árvu
Dat 	njiedjá 	de amasgiela dássái .
Studieloana govdureantu lea 	njiedjan 	2,9 prosentii , ja dat lea vuordimis ahte reantu njiedjá ođđa 0,4 proseanttain ođđajagemánus , gitta 2,5 prosentii mii mearkkaša ahte reantu lea historjjálaš dásis .
Studieloana govdureantu lea njiedjan 2,9 prosentii , ja dat lea vuordimis ahte reantu 	njiedjá 	ođđa 0,4 proseanttain ođđajagemánus , gitta 2,5 prosentii mii mearkkaša ahte reantu lea historjjálaš dásis .
Rievdadusaiguin háliidit movttiidahttit boazodoalu njuovvat eambbo vai boazolohku 	njiedjá 	Finnmárkku orohagain .
Muhto maŋit áigge gal lea beroštupmi veaháš 	njiedjan 	, čilge son . #beroštupmi
Erenoamážit ahkemearri lea 	njiedjan 	roavvasit filmmain , go hárve boahtá daid áiggiid filbma mas lea 18-jahkásaš ahkemearri .
– Mii diehtit olusiid geat čohkkájit miehtá máilmmi iežaset dihtoriid ovddabealde , ja čuvvot mielde mii dáhpáhuvvá Nilut Cupas , lohká jođiheaddji gii ii bala ahte cupa guosselohku 	njiedjá 	vaikko cupa čájehuvvo neahtas .
Guorahallamat muitalit ahte givssideapmi lea 	njiedjan 	daid maŋimuš jagiid , muhto ahte dat ii leat áibbas bissehuvvon Kárášjoga nuoraidskuvllas .
Jagiin 1987-1997 lea bohccobierggu duođalaš haddi 	njiejai 	ja lassánan doaibmagolut leat dagahan ahte duođalaš sisaboađut leat luoitán mealgadit .
– Ássilogut 	njidjet 	garrasit sihke Evenášis ja Skániin .
Rievdadusaiguin háliidit movttiidahttit boazodoalu njuovvat eambbo vai boazolohku 	njiedjá 	Finnmárkku orohagain .
Bargguhisvuođa oassi 	njiejai 	olles 176 olbmuin miessemánu rájes gitta geassemánnui Finnmárkku fylkkas .
Sámi Studeanttaid Searvi Romssas stivra leat háleštan dan birra ahte mo beroštupmi searvái lea 	njiedjamin 	. #beroštupmi
– Dán rádjái , ođđajagimánus golggotmánu rádjái lea idjadeapmi hoteallain Davvi-Norggas 	njiedjan 	veháš , muhto ii lahka ge nu ollu go olles riikkas dán seamma áigodagas .
Árvu lea 	njiedjamin 	ja Norggas leat hui unnán ruđat jođus dan ektui go buohtastahttá USA ja eará eurohpalaš riikkaiguin . #árvu
Guovtti jagis lea goddeeallu Oarje-Jotunheimenis 	njiedjan 	eanet go beliin , dál lea dušše 170 heakka vel báhcán .
Guovtti maŋemus jagis , 2006/2007/2006 lea eallu 	njiedjan 	beliin , 370 heakkas 170 heggii vaikko ii leat leamaš lohpi bivdit gottiid .
Katsaros ballá jus dál vel eambbo 	njidjet 	hattit de gal šaddá roassu .
Earenoamážit viesu oastimis ja vuovdimis , vaikko vel reantu leage 	njiedjan 	, ja galggat oastit ođđa viesu , de fertet dárkilit iskat šiehtadusaid ja kontrávttaid ovdal go vuollái čálát daid .
Fáhkkestaga vásihat iešdovddu 	njiedjan 	ja itge loavtte iežainat .
Israelmišuvnna skeaŋkkaid lohku 	njiejai 	3,5 miljovnna jagis 2007 ja diibmá ožžo sii 2 miljovnna .
Álbmotgirjerádjosiin gal lea lohku 	njiedjan 	veahá ; 54 proseanttas 51 prosentii .
Juohke dáiddár hábme dáiddalaččat iežas oasi ráidalasdoarjagis masa olmmoš dorjjasta goarkŋudettiin dahje 	njiejadettiin 	.
Maŋemus jagiid leat báberaviisalohkkiid gaskal 9-79 jagi 	njiedjan 	oktiibuot 16 proseanttain 1997 rájes , dalle lohke 84 proseanta báberaviissaid beaivválaččat .
Sin oassi geat geahččet TV dábálášbeaivvi lea 	njiedjan 	daid maŋemus jagiid .
Diŋgojuvvon sáhtut leat 	njiedjan 	báikkohagaid 20 proseanttain .
Luomehaddi lea maid 	njiedjan 	álggahanhattis , mii lei 11 euro kilos .
NAV dieđuid mielde lea Finnmárkkus bargonávccahisvuođa logut eanemus 	njiedjan 	Norggas .
1. jahkebeale 2009:s ledje logut 	njiedjan 	52:in olbmuin , mii dahká 21,6 proseantta unnit diimmáš loguid ektui seamma áigge .
Jagi 2000 rájes 2005 rádjái lea nuoraidskuvlla ohppiid lohku geat borgguhit 	njiedjan 	logi proseanttas viđa prosentii .
– Maŋimuš logijagiin lea barggolašvuohta vuođđoealáhusain boazodoallu , eanadoallu ja guolástus sámi ássanguovlluin 	njiedjan 	.
– Golmma jagis 2006 rájes 2009 rádjai 	njiejai 	vuođđoskuvlaohppiid lohku sámegielas nubbingiellan 593 ohppiin .
Oppalaš mánnálohku geain lea sámegielat mánáidgárdefálaldat , 	njiejai 	maid veaháš , muhto vuođđoskuvlaohppiid lohku geain sámegiella lea vuosttašgiellan lea bisson viehka seamma dásis dán áigodagas .
Dieđut maid Dearvvašvuođadirektoráhta lea addán , čájehit ahte spiidnegolgodávdanjoammun ain 	njiedjá 	.
Suoidnemánus čakčamánnui viessohattit 	njidje 	Lappi leanas golbma proseantta diimmá jagi seamma áigodaga ektui .
Jus it leat ožžon juovlaskeaŋkan dakkár diŋgga maid eanemus sávvet oažžut , de ii goitge du árvu 	njieja 	dan dihte . #árvu
Islándda juovlastállu 	njiedjá 	vulkánaváriin vulos .
Go joavku vuos beasai beakkán biekkusis duoddara badjel , Juovlavuonas Strommavutnii , de ránes ráššaváris 	njiejai 	biilamátki mearragáddái .
Liekkasmihttár lei 	njiedjan 	20 galbmagrádii go Blackfire čuojahii , muhto olbmuin ii lean gal mihkkige heđiid .
Nu movt mii leat doaimmahan suohkana lea leamaš buorre , muhto olmmošlohku 	njiedjá 	vaikko lea buorre dilli suohkanis .
Stáhtačálli Raimo Valle ovddidii gažaldaga mii lea sivvan go lohku geat váldet sámegiela vuođđoskuvllain ja sámi mánáidgárdelogut 	njidjet 	.
Dát riiddut leat dagahan ahte heargegilvvuin Norggas lea árvu duođaid 	njiedjan 	. #árvu
Lassi miessedoarjja galggašii oažžut boazodolliid njuovvat eambbo , vuoi boazolohku 	njiejašii 	.
Amma hal dál lea áigi ahte juohke boazoeaiggát álgá jurddašit dan lea go juoga maid son sáhttá dahkat vuoi lohku 	njiejašii 	, go ii dárbbaš eahpidit ahte boazolohku lea beare badjin .
Árja 	njiedjá 	ge eanemusat iskosis , 3,6 proseanttain .
Danne áigot dál bidjat garrasit gáibádusaid bierggu kvalitehtii ja leat maid gullon ahte gilohaddi galgá 	njiedjat 	.
Maŋimuš jagiid lea rievssatlohku garrasit 	njiedjan 	Finnmárkkus , ja maŋŋel dán jagáš rievssatlohkama ja árvvoštallamiid , lea Finnmárkkuopmodat mearridan ahte dán jagi galget bivdiin leat beaiveearit bivddus .
Gilohattit dán čavčča galget leat 	njiedjan 	10 proseanttain , jus fal njuovahagat leat bargan nu movt geasset lohpidedje .
riikkas lea dát lohku 	njiedjan 	
• Eanemusat lea 	njiedjan 	
Gaskamearálaččat 	njiejai 	girdijohtolat 23 proseanttain , girdifitnodagat tinejedje 140 miljovnna ruvnno unnit go diibmá .
Lulli-Norggas ja Trøndelagas leat baicca dáhkádusat 	njiedjan 	.
Jagi 2000 heaittihuvvui skuvla go ohppiid lohku 	njiejai 	.
Kárášjogas , Guovdageainnus ja Porsáŋggus leat oktiibuot 	njiedjan 	mielkegusaidlohku 23 proseanttain guđa jagis 2003 rájes .
– Turistalohku 	njiedjan 	čuohcan buohkaide
Magne Svineng gal muittuha vel ahte maŋimuš golmma jagis lea turista lohku 	njiedjan 	mealgat ja dát maid lea váikkuhan báikkálaš fitnodagaide .
Bearjadaga mávssii okta euro 7.87 ruvnnu ja euro lea 	njiedjan 	vuolimus dássái dán rádjái dollára ektui maid , ja dán geasi njiedjá vel eanet .
Bearjadaga mávssii okta euro 7.87 ruvnnu ja euro lea njiedjan vuolimus dássái dán rádjái dollára ektui maid , ja dán geasi 	njiedjá 	vel eanet .
– Gonagasreabbámáddodat ferte 	njiedjat 	, go dat billistit mearrabotni ja dan dihte ii dohkket Ovddádusbellodat go Norgga ráđđehus háliida viiddidit gonagasreappáid kommersiealla bivdoguovlluid , lohká stuoradiggeáirras Harald Tom Nesvik .
Iskan čájehii maiddái ahte Finnmárkku ealáhusat geavahedje logi proseantta eanet bargiid geat bohtet EU-riikkain ovddit jagi ektui , muhto olles Norggas lea dát lohku 	njiedjan 	.
Gikcunustibat geat ledje ain heakkas , fertejedje 	njiedjat 	vulos fas dáid jápmán ustibiiguin báttis gitta .
Suoma bealde lea bivnnuheamos álbmotmehciin eanemus gallededdjiid lohku 	njiedjan 	mealgat , ovdamearkka dihtii lea Urho Kekkonena álbmotmeahccis geahppánan lohku 23 proseanttain .
– Dan viđa maŋimus jagis lea « davvisámegiella 2 » ohppiid lohku 	njiedjan 	vuođđoskuvllas 39 proseanttain .
– Buot eará jogat Finnmárkkus leat ovdánan , dušše min guovllus 	njiedjá 	.
Johansen lasiha vel ahte dát logut 	njidjet 	ja lassánit jagis jahkái .
Vaikko ohcciid logut olles riikkas 	njidje 	, de Romssa universitehtas lassánedje ohccit 0,16 proseanttain .
Rievssatšálaš 	njiedjá 	dađistaga
Diibmá godde eambbo rievssahiid Finnmárkkus , vaikko šálaš 	njiejai 	21 proseanttain .
Rievssatlohku lea 	njiedjan 	ja badjánan jagiid mielde Finnmárkkus , ja maŋimuš jagiid lea Finnmárkkuopmodat ( FeFo ) ferten bidjat beaivemeriid rievssatbivdiide .
Finnmárkkus lea bargguhisvuohta 	njiedjan 	čakčamánu rájes , jus buohtastahttá borgemánuin ja diimmážiin .
Riikadásis lea 	njiedjan 	, 3600 buollimis 2008:s , 3400 buollimii 2009:s .
Ohppiidlohku 	njiedjá 	Finnmárkkus
Máŋga mánu lea girdijohtolat 	njiedjan 	, muhto juovlamánus lassánii johtolat Hárštá // Narvika girdišiljus Evenášis .
2009:s ollislaččat lei olles Norggas unnit johtolat girdisajiin , maiddái Hárštá // Narvika girdišilju Evenášis , muhto Evenášši lei buoret go riikkas muđuid , gos johtolat 	njiejai 	4,2 proseanttain , Evenášis fas njiejai 1,3 proseanttain .


    Davvisámi teavsttat Julevsámi teavsttat Lullisámi teavsttat Anársámi teavsttat Nuortalaš teavsttat Fler 

0
 

    Davvisámi|Norsk|Suomeksi|English

Čujuhit Korpii
10 válljejuvvon čoakkáldaga (buot) — 21,11M/21,11M sáni

    Oktageardán ohcan
    Viiddiduvvon ohcan
    CQP ohcan
    Buohtastahttin

Dálá oktageardánis ohcan CQP:n:

[word = "" %c]

Dálá viiddiduvvon ohcan CQP:n:

[]

Dievaslaš CQP-ohcan:
Viečča CQP-čilgehusaid
KWIC:

    KWIC
    Statistihkka

Boađus: 1 481
								
Ovddit
1
2Čuovvovaš
Cealkkačájeheapmi
	Avvir –
2009:s ollislaččat lei olles Norggas unnit johtolat girdisajiin , maiddái Hárštá // Narvika girdišilju Evenášis , muhto Evenášši lei buoret go riikkas muđuid , gos johtolat njiejai 4,2 proseanttain , Evenášis fas 	njiejai 	1,3 proseanttain .
Avinor girdihámmaniin lea ollislaččat 	njiedjan 	johtolat 4,2 proseanttain 2008 ektui , muhto juovlamánu logut čájehit ahte johtolat lassánii Norgga girdihámmaniin 3,8 proseantta juovlamánu 2008 ektui .
Haddegoargŋun lea dal sullii 2 proseantta ja doaivumis 	njiedjá 	geassái .
– Dađi mielde go doaibmadássi lassána ja ruvdnonannema váikkuhus 	njiedjá 	, vuordit mii haddelassáneami , lohká Gjedrem .
Diet guovlu lea maid erenoamáš dehálaš mearralottiid ektui go doppe leat bovttášlottit olu , ja mearraloddelohku lea 	njiedjamin 	dál , čilge Haltbrekken .
Lea guhkit áigge gullon ahte njuovahagain Finnmárkkus lea ain biergu vuorkkáin , ja dát čuohcá dán jagáš njuovvanáigodahkii earret eará dan láhkái ahte kilohattit 	njidjet 	.
– Lea menddo árrat lohkat dál mo šaddá , muhto hattit gal 	njidjet 	, lohká son .
Son maid muitala , nu go Pedersen , ahte biergohaddi 	njiedjá 	.
– Bohccos han oaidná lea go orohagain menddo olu , go deaddu 	njiedjá 	.
– Vaikko mii diehtit ahte rievssatlohku Finnmárkkus lea 	njiedjan 	, de eat sáhtte dušše bissehit rievssatbivddu .
– Eai suodjalanplánat sivvan go 	njiedjat 	
Stuorámus 	njiedjan 	SDE-guovllus lea leamaš Finnmárkku riddoguovlluin .
Logut čájehit ahte bargit geat jávket barggus buohcama geažil lea 	njiedjan 	Romssas dán jagi vuosttaš áigodagas .
Oktiibuot 25 gielddas leat 15 gielddas 	njiedjan 	jávkan buohcama geažil .
– Jus mii eat daga earenoamážiid , de in gal mun jáhke ahte jápminlogut johtolagas 	njidjet 	, dadjá Elvik Bergens Tidendii .
Gielddus ihkku vuodjit biillain guovtti jagi geahččalanáiggis lea geahččaluvvon USA:s , ja lihkohisvuođalogut leat 	njiedjan 	10 proseanttain dan áigodagas .
Stáhtačálli Raimo Valle ovddidii gažaldaga mii lea sivvan go lohku geat váldet sámegiela vuođđoskuvllain ja sámi mánáidgárdelogut 	njidjet 	.
Vaikko leat muhtumat geat oaivvildit ahte go olmmošlogu 	njiedjan 	sámi guovlluin váikkuha sámegiela lohkama skuvllain ja sámemánáidgárddiin , de oaivvildii Valle ahte dasa sáhttet eará sivat .
Sámi aviissat Ávvir ja Ságat leat duhtavaččat go lohku ii leat 	njiedjan 	namuhan veara .
Olles Norggas 	njiedjá 	báberaviissaid lohkkiid lohku .
Ávvira váldodoaimmaheaddji Sara Beate Eira lea maid duhtavaš go Ávvira lohkkiidlohku ii 	njieja 	.
– Jus geahččá movt aviisalogut 	njidjet 	miehtá Norgga , de gal dieđusge lean duhtavaš dainna ahte mii eat mana ruovttoluotta , muhto ii dieđus leat jur miela mielde go eat ovdán , lohká Eira .
Mis leat oainnat vuorkkát dievva , muhto dál soaitá nu ahte beassat njuovvat eanet , čilge Triumf , gii muitala ahte kilohaddi soaitá 	njiedjat 	diimmáža ektui , muhto ii duostta vel dadjat eanet dan birra .
Son čilge ahte leat ollu sivat dasa go lohkkiidlohku lea 	njiedjan 	dien mutto .
– Sáhttá maid dat leat okta sivva go álbmotlohku lea 	njiedjan 	suohkaniin , ja gos lea lassánan doppe eat leat nagodan lohkkiid olahit iežamet aviissain , čilge Palm .
Eliassena vearrologut leat 	njiedjan 	diimmá loguid ektui , go dalle lei sus 1 959 882 ruvdnosaš opmodat .
Jus dien logu buohtastahttá 2003 loguin , de livčče lohku 	njiedjan 	sullii 25 proseantta .
Suoma čuoiganguovddážiid searvvi mielde čierastalliid mearri geahppánii logádasain ja hissibileahtaid vuovdin 	njiejai 	13 proseanttain juovlabasiid ja loahppážiid gaskasaš áigge .
Go Ávvir deaivá su , de lea son jođus jo vulos váris maŋimužžan , go earát leat jo áigá 	njiedjan 	.
Norggabeale olbmot boahtigohte eambbo go Suoma márkki árvu 	njiejai 	40 proseanttain . #árvu
Nuba muhtun su ohcejohkalaš bartaránnjáin leat jo vuovdán eret barttaideaset , ovdal go haddi dain 	njiedjá 	.
Son muitá maid ahte su áŋgiruššanmokta 	njiejai 	go Norgga Sámiid Riikkasearvi jorahii sámi servviid deattu politihkalaš bellodahkan loahpageahčen 1980–logu .
Akšuvdna viessobuollin leamaš vihtta jagi ja viessobuollinlohku go olbmot duššet , lea beliin 	njiedjan 	ja eará buollimat leat njiedjan 30 proseanttain .
Akšuvdna viessobuollin leamaš vihtta jagi ja viessobuollinlohku go olbmot duššet , lea beliin njiedjan ja eará buollimat leat 	njiedjan 	30 proseanttain .
Ohcejogas suoidnemánu galbmasamos idja lei 25. beaivvi go liekkas 	njiejai 	3,5 gráđđii .
Bearjadaga mávssii okta euro 7,87 ruvnno , ja geassit galgá euro 	njiedjat 	ain eambo .
EU-doarjuid lohku 	njiedjá 	garrasit
EU-olbmuid lohku dađistaga 	njiedjá 	Norggas .
EU-doarjuid bealli 	njiedjá 	seammás go váttisvuođat EU:s lassánit .
Dát lohku lei 	njiedjan 	guvttiin diimmáža ektui , nu ahte ollislaš lohku diimmá golggotmánu lei logi .
Go sii bosso politiija alkomihttárii , de ii lean sin varra 	njiedjan 	vuolábeale gárrenvuoddjinrájá , nu mo sii navde .
Bargguhisvuohta 	njiedjá 	Finnmárkkus , čájehit NAV Finnmárkku logut .
Čáhci 	njiedjá 	ain eanet Lokka ja Porttipahta buođđojávrriin ja Anárjávrris , go čáhcefápmorusttegat dárbbašit ollu čáhcefámu aiddo dál .
Doaktára bokte dieđihuvvon buozalmasvuohta lea 	njiedjan 	Finnmárkkus , 8 proseanttas nuppi njealjádasjagis diibmá 7,2 prosentii seamma áigodaga dán jagi .
Riikkadásis lea doaktára bokte dieđihuvvon buozalmasvuohta seamma áigodagain 	njiedjan 	6,3 proseanttas 2009:s 5,5 , prosentii 2010:s .
Doaktára dieđihuvvon buozalmasvuohta lea 	njiedjan 	eanaš ealáhusain .
Stuorámus njiedjan lea goittot industriija- , elfápmo- , čáhce- ja buoridan- dahje ruskačorgenealáhussurggiin , muhto maid oahpahusas oidno mearkkašahtti 	njiedjan 	, lohká Gjerde .
Dál čájehuvvo duhpáhastiid lohku sihke nuoraid ja ollesolbmuid gaskkas lea 	njiedjan 	dássedit , muhto diimmáš logut čájehit njiedjan lea orustan .
Dál čájehuvvo duhpáhastiid lohku sihke nuoraid ja ollesolbmuid gaskkas lea njiedjan dássedit , muhto diimmáš logut čájehit 	njiedjan 	lea orustan .
Dán rádjái lea lohku 	njiedjan 	8 proseanttain diimmážis , go unnitlohku olbmuin roasmmohuvvet johtolagas .
Ruoŧŧelaččat gávppašit Suomas dál eanet go jagi álggus go euro árvu lea 	njiedjan 	. #árvu
Ovddit jagiid ektui lea luossadihkiid lohku 	njiedjan 	ja cuoŋománu logut čájehit ahte dál leat viehka lahka dassážii go jokset dihkkejávkadan ulbmiliid .
Čeavetjávrri skuvlla ohppiid mearri 	njiejai 	ovtta gaskka nu sakka , ahte juoba Avvila skuvladoaibma vuordigođii dán heaittiheami .
Das rájes geahppánedje lihkohisvuođat 11 proseanttain ja olbmuid jápminlohku 	njiejai 	35 proseanttain vuosttaš vihtta mánus 2010 .
Dan botta go visumohcciid lohku 	njiedjá 	Moskova ja St. Petersburg gávpogiin , de lea lassánan visumohcciid lohku Norgga General Konsuláhtas Murmánska gávpogis 8 proseanttain jagi 2009 jagi 2007 ektui .
	Religion texts –
Jesus 	njiejai 	váris , ja stuora olmmošjoavku čuovui su .
	Njiejadettiin 	váris Jesus celkkii sidjiide : Allet muital geasage dán oainnáhusa birra ovdal go Olbmobárdni lea bajásčuoččáldahttojuvvon jábmiid luhtte .
– dalle fertejit sii geat leat Judeas , báhtarit váriide ; dat gii lea dáhki alde , ii galgga 	njiedjat 	viežžat maidege viesustis , ii ge dat gii lea bealddus galgga máhccat ruoktot viežžat biktasis .
	Njidjos 	dal ruossas , de mii oskut sutnje .
Fáhkka šattai garra eatnandoarggástus , dasgo Hearrá eŋgel 	njiejai 	almmis , manai hávddi lusa ja fierahii geađggi eret ja čohkánii dan ala .
	Njiejadettiin 	váris Jesus gilddii sin muitaleames geasage maid sii ledje oaidnán , ovdal go Olbmobárdni lei bajásčuožžilan jábmiid luhtte .
– dalle fertejit sii geat leat Judeas , báhtarit váriide ; dat gii lea dáhki alde , ii galgga 	njiedjat 	viežžat maidege viesustis , ii ge dat gii lea bealddus galgga máhccat ruoktot viežžat biktasis .
Messias , Israela gonagas , 	njidjos 	dal ruossas , vai mii beassat oaidnit ja oskut !
Dasto son 	njiejai 	váris singuin ja bisánii muhtun jalgadassii .
Nuppi beaivvi , go sii 	njidje 	váris , de bođii stuora olmmošjoavku su ovddal .
Jos muhtun dan beaivvi lea čohkkámin dáhki alde ja sus leat biergasat viesus , de ii galgga 	njiedjat 	viežžat daid , ja dat gii lea bealddus , ii galgga máhccat ruoktot .
In mun dovdan su , muhto son guhte vuolggahii mu gásttašit čáziin , celkkii munnje : Son gean ala don oainnát Vuoiŋŋa 	njiedjamin 	ja bisáneamen , son lea dat guhte gásttaša Bassi Vuoiŋŋain .
» Son jotkkii : « Duođaid , duođaid , mun cealkkán didjiide : Dii oažžubehtet oaidnit almmi rabasin ja Ipmila eŋgeliid badjáneamen ja 	njiedjamin 	Olbmobártni badjel .
Ii oktage leat mannan bajás albmái , earet go son gii 	njiejai 	almmis ; dat lea Olbmobárdni guhte lea almmis .
Dasgo Hearrá eŋgel 	njiejai 	duollet dálle láddui ja lihkahahtii čázi .
» De son gohčui orustahttit vovnna , ja guktot 	njiejaiga 	čáhcái , sihke Filip ja gonagasbálvaleaddji , ja Filip gásttašii su .
Go celkojuvvo ahte son manai bajás , ii go dat mearkkaš ahte son vuos 	njiejai 	gitta eatnama vuolimus čiekŋalasa rádjái ?
Ja son gii 	njiejai 	, lea dat seammá guhte manai guhkás bajás buot almmiid bajábeallái vai son deavddášii buot .
Dasgo go gohččun čuodjá , ja váldoeŋgela jietna gullo ja Ipmila báson skádjá , dalle Hearrá ieš 	njiedjá 	almmis ja vuosttažin bajásčuožžilit sii geat leat jápmán Kristusis .
Sutnje mun čálán Ipmilan nama ja Ipmilan gávpoga nama , ođđa Jerusalema , mii 	njiedjá 	almmis Ipmilan luhtte , ja mun čálán maiddái iežan ođđa nama sutnje .
Dasto mun oidnen fas eará fámolaš eŋgela 	njiedjamin 	almmis .
Dasto mun oidnen vuot ovtta eŋgela 	njiedjamin 	almmis stuora fámuin , ja su hearvásvuohta čuvgii oppa eatnama .
De mun oidnen eŋgela 	njiedjamin 	almmis čiekŋalasa čoavdda ja stuora láhkkit gieđas .
Ja mun oidnen bassi gávpoga , ođđa Jerusalema , 	njiedjamin 	almmis , Ipmila luhtte , válmmaštuvvon ja čiŋahuvvon dego moarsi irggis várás .
» Vuoigŋa devddii mu ja eŋgel doalvvui mu stuora , alla vári ala ja čájehii munnje bassi gávpoga , Jerusalema , mii 	njiejai 	almmis , Ipmila luhtte .
” De Hearrá 	njiejai 	geahččat gávpoga ja toartna , maid olbmot ledje huksemin , ja celkkii : “ Sii leat gusto okta álbmot , ja sis buohkain lea okta giella .
	Njidjot 	vuolás ja moivejehkot sin giela , amas nubbi ipmirdit nuppi giela !
Danne mun áiggun 	njiedjat 	vuolás geahččat leatgo sii duođaid dahkan dan mii váidaluvvo munnje .
Son 	njiejai 	ájagáddái ja devddii ruhkus ja goarkŋui fasttain bajás .
Aiddo go mun ledjen dan jurddašan , de Rebekka bođii ruhkku oalggi alde ja 	njiejai 	ájagáddái goaivut čázi .
De Hearrá 	njiejai 	geahččat gávpoga ja toartna , maid olbmot ledje huksemin ,
	Njidjot 	vuolás ja moivejehkot sin giela , amas nubbi ipmirdit nuppi giela !
Danne mun áiggun 	njiedjat 	vuolás geahččat leatgo sii duođaid dahkan dan mii váidaluvvo munnje .
Son 	njiejai 	ájagáddái ja devddii ruhkus ja goarkŋui fasttain bajás .
Aiddo go mun ledjen dan jurddašan , de Rebekka bođii ruhkku oalggi alde ja 	njiejai 	ájagáddái goaivut čázi .
Son sojahii almmi ja 	njiejai 	, sevdnjes balvvat julggiid vuolde .
Gopmirdehkoset su , buot eatnama válddálaččat , sojaldahttoset čippiideaset sutnje , buohkat guđet 	njidjet 	muoldda sisa .
Mun adnojuvvon sin láhkásažžan guđet 	njidjet 	hávdái , mun lean šaddan olbmá láhkásažžan gii lea massán eallinvuoimmi .
Jábmit eai máinno Hearrá , ii oktage sis guhte 	njiedjá 	jaskatvuhtii .
Dasgo go gohččun čuodjá , ja váldoeŋgela jietna gullo ja Ipmila báson skádjá , dalle Hearrá ieš 	njiedjá 	almmis ja vuosttažin bajásčuožžilit sii geat leat jápmán Kristusis .
hávdáduvvui , 	njiejai 	jábmiid riikii ,
riegádii nieida Marias , givssiduvvui Pontius Pilatusa áiggi , russiinávlejuvvui , jámii ja hávdáduvvui , 	njiejai 	jábmiid riikii , bajásčuožžilii jábmiid luhtte goalmmát beaivvi , manai bajás albmái , čohkká Ipmila , buotveagalaš Áhči , olgeš gieđa bealde , boahtá fas doppe dubmet elliid ja jábmiid .
riegádii nieida Marias , givssiduvvui Pontius Pilatusa áiggi , russiinávlejuvvui , jámii ja hávdáduvvui , 	njiejai 	jábmiid riikii , bajásčuožžilii jábmiid luhtte goalmmát beaivvi , manai bajás albmái , čohkká Ipmila , buotveagalaš Áhči , olgeš gieđa bealde , boahtá fas doppe dubmet elliid ja jábmiid .
riegádii nieida Marias , givssiduvvui Pontius Pilatusa áiggi , russiinávlejuvvui , jámii ja hávdáduvvui , 	njiejai 	jábmiid riikii , bajásčuožžilii jábmiid luhtte goalmmát beaivvi , manai bajás albmái , čohkká Ipmila , buotveagalaš Áhči , olgeš gieđa bealde , boahtá fas doppe dubmet elliid ja jábmiid .
	Non-fiction texts –
Oidne ahte čielga dáruiduhttinpolitihkka ii meinestuvvan ja ahte sámiid máhttodássi dárogielas ja risttalašvuođas lei 	njiedjan 	.
60-logus 	njiejai 	oahpahallilohku .
Dalle lei áicojuvvon ahte dievasvarat áboriginálaid lohku lei 	njiedjan 	ja dát navdojuvvui mearkan das ahte aboriginála identitehtta sáhtii cuvkejuvvot suddadeami bokte .
Go geahččá ollis Gáivuona , de lea i di - formatiivva geavahus lassánan buolvvas bulvii , earret váhnenbuolvvas mas 	njiedjá 	sakka .
1998 rájes lea sámegiela válljenávdnasa oahppiidmearri 	njiedján 	.
Vuođđoskuvllas lei vuosttašgielagiid lohku 	njiedján 	njealljái .
Sámegiela vuosttašgielagiid lohku vuođđoskuvllas lei jahkái 2003/04/2003 	njiedjan 	12:i .
Vuosttašgielagiid 	njiedjan 	lohku dáidá čájehit ahte Loabága oahppit ledje válljen sámegiela čovdosa mii heivii buorebut sin gielladillái , muhto jotke oahppamis oasi eará fágaid sámegillii .
Ii leat šat lohpi bohccuiguin bargat - dus ferte leahket enheta , ja dakkára gal illá fitne dáid beivviid gos boazolohku galgá 	njiedjat 	.
Gealdu 	njiedjá 	go novealla juksá alimus klimávs sa , nammalassii go Heandarat fuobmá ahte goavddis lea jávkan .
Muhto seammás gelddolašvuohta 	njiedjá 	dađistaga go áhkku diehtá ráđiid go váhnemat , Hean darat ja boles bohtet viežžat mánáid ja goavdása .
lean doarvái čeahppi ahte veajášin čállit maidege mii dagašii ahte don hálidat geavahit vahkku filbmafestivalas jus dal it jo álggu rájes liiko filmmaide , ja in goittotge veaje čilget man somá dat lea johtit ovtta kinoseavdnjadasas nubbái , ja de , go festivala nohká – viimmat // dađebahábut – kánske oaidnit beaivváša , go leamaš gal beaivvášbeaivi goasnu dieppe gaskkas , muhto filbma álggii ovdal go beaivváš iđii ja nogai maŋŋá go beaivváš lei fas 	njiedjan 	; nu jorrá áigi ovtta nuppi kinofilbmarulla miel , ja jus leat lihkkoš , de filbmarulla govat eai leat menddo sakka skrápejuvvon buot daid eará festivalain gos leamaš , nu ahte beasat oaidnit olles filmma , ja sáhtat ieš oaivvildit juoga daid máŋgga oaiviliid lassin juohke filmma birra , ja itge dárbbaš leat geainage ovttaoaivilis , jus it hálit .
Biergodienas aivve 	njiedjá 	áigodagas 1993–2000 .
Lea šállošahtti go guovllu boazolohku lea nu garrasit 	njiedjan 	boraspiriid ja váttis doaibmadiliid geažil .
Biergodietnasat 	njidje 	1995 rájes 2000 rádjái .
Hattit fertejedje 	njiedjat 	– Máŋemus áigodaga leat olu njuovvan .
Gielda lea guovttegielat gitta dassái go lohku lea 	njiedján 	guđa prosentii .
Nordlándda joatkkaskuvlaoahpahusas lassánii sámi ohppiidlohku , ledje 13 oahppi skuvlajagis maŋŋel Ođastusa 94 gitta 20 oahppi rádjái jagis 1999/2000/1999 , muhto de fas 	njiejai 	lohku 9 oahppi rádjái jagis 2000/2001/2000 .
Máret 	njiejai 	váris [ muoraiguin ] .
Mii oaidnit čielgasit ahte daid ohppiid lohku , geat jotket sámegielain 7. luohká maŋŋá , 	njiedjá 	.
Álbmotlohkamiid loguid galgá várrogasat geavahit , go ii leat lohkamis lohkamii geavahuvvon seammá vuohki árvvoštallat gii gullá man čerdii , geahča ovdamearkka dihte mo sámiid lohku 	njiejai 	1865 ja 1875 gaskkas , ja lassánii fas .
Go álggát 	njiedjat 	luohká vulos , vuoje álggos hui siivvut go skuhterboahkánis lea heajut goazastan effeakta .
Mátkkit lávkaselggiid , tealttain ja stákkuin Oarjeduoddara badjel Ciikojohkii , Máskeluobbalii , Uvjalatnjái , Geassejohkii , Áhkkajávrái - gáfestallan dollagáttis ja luossasneaidabassin geasseija goas gaskaijabeaivváš 	njiejai 	davvin .
Lei heahti go buolašgráđat 	njidje 	30:i .
Universitetsforlaget 1985 ] B jørklunda dutkosis lea dáruiduhttin váldosivvan čearddalaš buhtisteapmái mii orui dáhpáhuvvamin : Sámiid lohku gielddas 1930:s 1950:i 	njiejai 	44%:s gitta nullii !
In leat ovttasge gullan ahte dát duiskalaš gopmi livččii oidnon eará sajis go dán sevdnjeslovttas , ja doaivvun ahte ii 	njieja 	doppe vulos ihkku .
1950-logus lea boazolohku lassánan , muhto dienas biergobuvttadeamis juohke bohccos lea jáhkkimis 	njiedjan 	maŋŋel go rievddai ekstensiiva boazodoallun .
1920:s lea dát lohku 	njiedjan 	37,83 prosentii , ja das leat mielde olbmot geain lea sihke suoma ja sámi gullevašvuohta .
Dát dagaha ahte Sámeskuvlla ohppiidlohku 	njiedjá 	, mii fas dagaha skuvlla boahtteáiggi eahpečielggasin .
Dat fas lea mielddisbuktán ahte olmmošlohku lea 	njiedjan 	mealgat .
Oahppilohku 	njiejai 	beliin .
Siskkit Lágesvuona olmmošlohku lea 	njiedjan 	dramáhtalaččat maŋimus logijagiid .
Ovdal ledje « siskkit ja olggut suohkan » sullii seamma stuorrát , muhto siskkit oasi olmmošlohku lea dál 	njiedjan 	goalmmadassan .
[ 1 ] Vaikko Dutnjesvuona skuvla lea áigá juo heaittihuvvon ja Ákŋovuona suohkana olmmošlohku fas issorasat 	njiedjan 	, de ledje goit 2005 čavčča ovcci sámi máná dieđihuvvon sámegieloahpahussii , suohkana 130 oahppi gaskkas .
Loabága olmmošlohku , mii lei lagabui 2000 maŋŋelaš soađi , lea 	njiedjan 	sakka , ja 2006:s leat doppe sullii 1050 ássi .
Geat olgun ledje , besse oaidnit hirbmat guhkes čuovgi dollanjuokčama 	njiedjamin 	skorsteinráiggi áibmui .
De lea olmmošlohku vehážiid mielde 	njiedjan 	čuođivihttalogi rájes 1970 ja 1990 , ja lea vuolil čuođi olbmo odne .
Doppe orrot 30-náre olbmo ( 2009 ) , olmmošlohku lea 	njiedjan 	maŋemus jagiid .
Danin bázii sámegiella vierisgielfálaldaga fálatkeahttá ovtta jagi , ja ohppiidlohku sámegielfágas 	njiejai 	sakka .
Ohppiidlogu ii leat 	njiedjan 	dušše daningo skuvlabiires lea eretfárren .
	Fiction texts –
Bálggis 	njiedjá 	dievážis jogašleahkái suhkes sieđgarođu čađa .
Son ii loga 	njiedjat 	leat váddáseappot go goarkŋut .
Lea hirpmus 	njiedjat 	, muhto buot manná bures gitta dassái go lea bággu vázzit stuorra geađggi meattá ja luoitit moadde mehtera ceakkos bávtti mielde vulos .
Earát 	njidjet 	bávtti mielde ja besset dearvan vuollelebbui .
Áigin lea 	njiedján 	bávtti mielde ja doallá iežas ovttain gieđain gitta báktesálvvus .
Badjeolbmot oste mohtorgielkkáid ja ledje loahpalaččat 	njiedjan 	badjosiin dáluid lusa .
Mihttár 	njiejai 	muhtun beivviid gitta njealjelohkái nu ahte bargguid šattai ain bissehit , amaset divrras mašiinnat cuovkanit .
Oahpaheaddji šattai geavahit buot čehppodagas , amas massit vátna oahppiidis , lohku ii ožžon ii heađisge 	njiedjat 	vuollel viđa , dasgo dalle gielddas dahje Skuvlaráđđehusas lei vuoigatvuohta loahpahit diekkár gánnetmeahttun fálaldaga .
Veaigin Heaika oinnii mo biila 	njiejai 	gulul luohkás , dat ii lean Nillá , dát lávii eambbo luoitilit bodnái .
Sin deaivvadanmokta 	njiejai 	dađistaga .
Son 	njiejai 	gulul stánže čievrageainnu mielde iežas vistti guvlui .
Kafea dietnasat ledje hotealla rahpama rájes 	njiedjan 	, muhto dábálaš bures bearašfitnodat gánnehii ainge .
Hotealla ordnema maŋŋá dan dietnasat ledje 	njiedjan 	, muhto dábálaš bures kafea gánnehii ainge .
Áddjá maid 	njiedjá 	lovttas .
Maŋŋelis 	njidjen 	gulul johkagáddái ja guldalin mo biillat vudje geaidnoráigge njealjelot mehtera duohken : dat šuvihedje ain meattá ja jietna jávkkai fargga .
Gullen mo uksa leahkkasii ja su lávkkiid : dat 	njidje 	ráhpaid bodnái .
Go ledjen veallán njeallje jándora , de bivastuvvagohten ja feber 	njiejai 	.
nuppi juolggi gummejuolgeláhpi 	njiejai 	hui váddásit ja dego heahpanatta dearvvas juolggi báldii ja gessui fárus .
	Law texts –
Dat ahte eallindási njiedjan ii leat mearkkašmeahttun , mearkkaša dan ahte divššohasa eallindássi 	njiedjá 	mearkkašahtti lágiin divššu haga bákčasa dahje givssi geažil , váttisvuođaid geažil dakkár eallineaktosaš eallindoaimmaid oktavuođas nugo ovdamearkka dihtii biebmoávkkástallama , dahje njiedjan fysihkalaš dahje psykihkalaš doaibmadási geažil .
čielggas ahte juohke oapmelaš rievtti eaiggát sáhttá gáibidit buhtadasa go vuoigatvuohta masso dahje árvu 	njiedjá 	bággolonisteami geažil . #árvu
Dasa lassin 	njiedjá 	dalle bienalaš dássái mas dál áibbas unnán lea konkrehta rievttálaš ávnnas masa dorvvasta .
	njiedjá 	ja bivdet
1959 rájes , go lea logahallon eanemus doaluid Finnmárkkus , 1992 rádjai , de lea stuorrátgo 5 mihtu doalut 	njiedjan 	4756:s 718 rádjái .
Boazolohku lea maŋimušjagiid 	njiedjan 	.
Ođđaásaheamit báktedoaimmas ja industrias leat garrasit 	njiedjan 	oktiibuot atnueatnamiin 6095 m
Kantursajiid ásaheapmi lea seamma áigodagas 	njiedjan 	19062 m
Riikkas oppalaččat navdá Birasgáhttendepartemeanta ahte jearaldat lea 	njiedjan 	sullii 18% dállodoaluin 1978:s gitta sullii 11% 1984:s .
Navdo 	njiedjat 	maŋŋilgo gielddat ožžo hálddašit stáhta bivdovuoigatvuođa Guovdageainnus .
Eanavuovdinkantuvra diediha ahte sáhttá daddjot váidagiid lohku lea 	njiedjan 	maŋimušjagiid .
1984 rájes 1992 rádjai lea guollebivdiid lohku 	njiedjan 	3123 rájes 2583 rádjai , namalassii 540 olbmuin , dahje badjelaš 17% .
Ollesvirgeguolásteaddjiid lohku leat seamma áigodagas 	njiedjan 	sullii 25% ja lotnolasguolásteaddjiid oassi seamma áigodagas lea lassánan badjelaš 15% .
Gaskal 15-19,9 mehtera fatnasiidda lea 	njiedjan 	sullii 40% .
Gaskal 5 ja 9,9 mehtera guhkodaga fatnasat leat áigodagas 1984 gitta 1992 rádjai 	njiedjan 	2240 rájes 1275 rádjai , namalassii olles 43% .
Lea mearkkašaveara ahte birrajage fatnasat Finnmárkkus 	njidje 	362:s 1989-90 gitta 288:i 1991-92 ( 20% Bivdofatnasiid ahki lea datte áigodaga ovdánan buoret guvlui .
Barggaheapmi 	njiejai 	garrasit jagiin 1993 rádjai .
	Min Aigi –
– Doarjja sámi álbmotkultuvrralaš ( almenkulturelle ) ulbmiliidda leat maid duohtaságas 	njiedjan 	maŋimuš jagiid go váldá vuhtii hadde- ja gollolassáneami .
Mannan mánu 	njiejai 	bargguhisvuohta 77 olbmuin njukčamánu ektui , ja 171 olbmuin jos buohtastáhttá 1996 cuoŋománu loguiguin .
Jeđđehus eiseválddiide lea , ahte borgguheaddjiid lohku 	njiedjá 	mađi alit oahpu olbmot váldet .
Journalisttat fertejit johtit unnit , ja luohtobargiid oassi maid 	njiedjá 	, mii mearkkaša ahte min guovlu gáržu .
Liikká lei goastan čuohte , beannot čuohte mehtera ja gitta njárgii 	njiedjan 	.
Muhtin báikkiin lea maiddái gáibidišgoahtán eahpealmmolaš skuvlaruđa ja oahppiidlohku 	njiedjá 	, čállo Education for All ( Oahpahus buohkaide ) raporttas .
Aserbajdsjanas 	njiejai 	joatkkaskuvlaproseantta 60:s gitta 40:i .
Micklewright muitala maid ahte biktasat ja gápmagat eai šat subsiderejuvvo , ja stipeanddat oahppiide geat orrot guhkin eret ruovttus , leat garrasit 	njiedjan 	.
1996:s lei lohku 	njiedjan 	250000 mánnái .
Ohcejoga ja Keminmaa gielddain bargguhisvuođaproseanta lea 	njiedjan 	vuollel guovttelogi .
Dat mearkkaša ahte lohku lea 	njiedjan 	41 % ain .
Vuovdindienas 	njiejai 	seammá olu 1996 maid .
Eanemusat 	njidje 	bomulla- , njuoskagumme- ja hámpaháttit .
Sivvan dasa lea sihke unnon buvttadeapmi ja 	njiedjan 	haddi .
Maiddái sisaboađut niso- , riise- ja eará gordnešlájain leat 	njiedjan 	20 proseanttain geafes riikkain .
	Njiedjan 	valuhtat Asias lea mielddisbuktán uhcit beroštupmi dáid gálvvuin , juoidá mii fas lea dahkan gilvvu garrasabbon . #valuhtta
	Njiejaimet 	Rávttošvuopmái , 3-4 kilomehtera geahčai jávrris ja šlivgugođiimet .
Almmatge lea boazolohku veahá 	njiedjan 	maŋimuš áiggi .
Ii leat nu beare ollu maid sahet beaivái , dan dihte vai ii 	njieja 	hattis .
Nordlysas 	njiejai 	dássi ja leaktu hedjonii .
Čájehuvvon lea ahte láhkarihkkumat leat 	njiedjan 	jahkásaččat ja dasa sáhttá sivva , go bearráigeahčču lea buorránan jagis nubbái .
Muhto go geahččá olles Finnmárkku , de 	njiedjá 	bargguhisvuohta dađistaga .
Meløy ii jáhke boazologu leat 	njiedjan 	dušše dálkkádagaid geažil Finnmárkkus .
Dat lea mu jáhku mielde oaivesivvan , go boazulohku lea 	njiedjan 	1989 rajes , čilge Jon Meløy .
Jus leš nu ahte gaskamearálaš deaddu lea 	njiedjan 	bohccuin maŋimuš áiggiid , iigo dalle leat nu ahte mearraguovlluin sáhtášii gávdnat dán ášši čovdosa , iige guorban duoddaris ?
Bálkkát leat ruđa fárus 	njiedjan 	nu sakka ahte boahtteáiggi ii sáhte oktage einnostit .
Boazolohku lea 	njiedjan 	maŋemuš jagiid , muhto liikká lea fágalaš duohtavuohta ahte Finnmárkkus leat beare ollu bohccot dan ektui máid dálá guohtoneatnamat guddet , cealká boazodoallostivra .
Maŋemuš 20 jagi leat eiseválddit geahččalan iešguđetlágan ruhtaortnegiiguin giktalit heaitit bohccuiguin vuoi boazolohku 	njiejašii 	.
Go luossaveajehat boahttevuođas 	njidjet 	riegádanjogas Njuohttejávrái de dat galggašedje dádjadit stuorra buođđoáldása čađa Badje-Doallána buođu lusa .
Dat mii váivvida sin lea , go láigevuovdin lea maŋemuš jagiid 	njiedjan 	hirbmosit ja , ahte nuorra nissonat eai máhte šat gođđit .
Muhto go nuppi čuoggá bálkestii ášševuojeheaddji , de 	njiejai 	dat badjelaš 200 000 ruvdnui .
Gáržžes bušeahtta dárbbašuvvo vai reantu 	njiedjá 	.
Vaffellátna 	njiejai 	johtilit ja veahkki Håkon Aslaksen beasai duollet dálle skillalahttit kássamášiidni ruđa , bursii boahtima mearkan .
Sámegiel hálliid lohku orru 	njiedjamin 	garrasit , čuoččuha kronihkkačálli Torkel Rasmussen .
Ollu báikkiin hállet sámegiela dušše vuoras olbmot , ja dan dihte sáhttá sámegielhálli lohku 	njiedjat 	garrasit ovddosguvlui .
Reantovuolideapmái sivva lea go ruhtamárkanreantu lea 	njiedjan 	.
Jus son lea Messias , manin son dalle ii 	njieja 	vulos ruossas ?
Ovdamearkka dihtii lea nissoniid lohku gielddastivrras 	njiedjan 	47,4 proseanttas ( 9 ) mannan áigodagas ( 1991-95 ) 26,3 prosentii dán áigodagas ( 95-99 ) .
Dán guovllu guolástus lea sakka 	njiedjan 	maŋŋá go fanas vuojui olggobeale Emiráhtaid , Ajman ja Umm al Qaiwain duovdagiid lahka .
Eai buot siiddat leat vel gávpečorraga vuovdán , nu ahte logut 	njidjet 	.
Boazolohku 	njiedjá 	giđđi .
Diibmá šadde máŋemussan ráidočiekčamiin , ja livčče galgan 	njiedjat 	njealjádii .
Jagi maŋŋil fas 	njiejai 	.
Valáštallanjoavkkuid ja earenoamážit čuoiganjoavkkuid lohku lea 	njiedjan 	maŋemus jagiid .
Muhto eai dušše čuoigit , čuoiganjoavkkuid lohkuge lea sakka 	njiedjan 	.
– Go valáštalliid lohku lea 	njiedjan 	, ferte geahččat dan oktavuođas go dál lea measta juohke viesus dihtor .
Mannan spábbačiekčanjagi 	njiejai 	njealját divišuvdnii , muhto fállui čiekčat goalmmádis go eará joavkut geassáde .
Muitalastá vel ahte ii ádján go sulli guokte diimmu jus 	njiedjá 	vulos Hillágura bokte .
Poastabálvalusat šaddet dađistaga divraset , seammásgo poastabálvalusaid dássi 	njiedjá 	.
Áltá , Hámmarfeasta ja Čáhcesuolu leat buot dakkár ovdamearkkat : 1990-logu álggogeahčen olmmošlohku lassánii , dál dat orru 	njiedjamin 	.
Váikko hattit leat 	njiedjan 	áiggi mielde lea ain nu divrras ahte ovdamearkka dihte skuvla mas leat máŋga dihtora ferte máksit moadde čuođi duháha ruvnnu jus galggaš čállit sámegillii buot dihtoriiguin .
Riegáduslohku lea sakka 	njiedjan 	muhtun riikkain .
Meara temperatuvra Peru rittu olgobealde lea 	njiedjan 	golmmain grádain maŋimuš mánu . #temperatuvra XT-Com
Dál temperatuvra 	njiedjá 	ja Peru dálkedutkit leat dieđihan ráđđehussii ahte sáhttá vuordit El Nino oappá La Nina fitnamin guossis . #temperatuvra
Muhto bargguhisvuohta lea 	njiedján 	. #bargguhisvuohta
Buohtastahttojuvvon jagi 1996 gaskameriin lea nettobargguhisvuohta ( áibbas barggu haga ) 	njiedjan 	804 olbmuin dahje 23 proseanttain .
Buohtastahttojuvvon maŋimuš vihtta jagiid gaskameriin lea nettobargguhisvuohta 	njiedjan 	1.116 olbmuin .
TROMSA : Gaskamearálaš brutto bargguhisvuohta ( áibbas barggu haga + olbmot dábálaš barggahandoaimmain ) lea 	njiedjan 	4.917 olbmos 3.687 olbmui jagis 1996 jahkái 1997 .
Dát mearkkaša , ahte bruttobargguhisvuohta lea 	njiedjan 	1.230 olbmuin dahje 25 proseanttain .
TROMSA : Jagis 1996 jahkái 1997 lea gaskamearálaš lohku olbmuin dábálaš bargomárkandoaimmain 	njiedjan 	493 olbmuin .
FINNMÁRKU : Miessemánu bargguhisvuođalogut leat dál gárvásat ja čájehit ahte bargguhisvuohta Finnmárkkus lea jagis 	njiedjan 	25 % .
Buot bargokantuvrrain , earret Sis-Finnmárkkus , leat áibbas barggu haga olbmuid logut 	njiedjan 	cuoŋománus miessemánnui .
Positiivamus lea Mátta-Várjjagis gos bargguhisvuohta lea 	njiedjan 	404 olbmuin 325 olbmui , dahje olles 1,6 % .
Bargguhisvuohta lea 	njiedjan 	olles proseanttain diimmá cuoŋománu ektui .
Sihke eatnama geavahanárvu ja vuovdinháddi lea 	njiedjan 	go bivdit eai šat beasa bivdit luosa , Liland fuomášuhttá . #árvu
Earenoamážit leat biŋgodietnasat 	njiedjan 	hirbmadit .
Maŋemus jagiid lea veahkkedivššársuorggi ohppiidlohku 	njiedjan 	jagis jahkái .
IPS-Rio de Janeiro:1998:s vuvddii Brasil olgoriikkaide eanet káfe go maid lei dahkan 1992 rájes , muhto dienas gal lea 	njiedjan 	.
Go 1997:s manai nu bures , de buvttadedje menddo olu maŋit jagi , ja hattit de dieđus 	njidje 	.
Davvibađaeatnamis lassanii olmmošlohku 1990-94 áigodagas , muhto dan rájes go Ruoŧŧa šattai EU-miellahttun jagis 1995 , lea olmmošlohku 	njiedjan 	6700:in .
Farhan-Haq:IPS:Nieiddaid lohku , geaid vuolil čuohpadit , lea 	njiedjan 	Egyptas , dán čájehit varas logut .
Min Áigi maid doaivu dan seamma maid buohkat earát , ahte Čorgas 	njiedjá 	.
1989 rájes otnážii lea boazolohku 	njiedjan 	75 000 bohccuin - 38 % .
Buolbmát boazosuohkanis lea boazolohku eanemus 	njiedjan 	, namalassii goappašiid orohagain 56 proseanttain .
Kárášjoga boazosuohkanis lea boazolohku 	njiedjan 	sullii 40 proseanttain .
Oarjejohtolagain lea oppalohkai boazolohku 	njiedjan 	38 proseanttain .
Olggut orohagain lea boazolohku 	njiedjan 	55 proseanttain ja siskkit orohagain fas 18 proseanttain .
Guovdojohtolagain lea boazolohku 	njiedjan 	26 proseanttain .
Olggut orohagain lea boazolohku 	njiedjan 	42 proseanttain ja siskkit orohagain 17 proseanttain .
Nuortajohtolagain lea boazolohku 	njiedjan 	48 proseanttain .
Olggut orohagain lea boazolohku 	njiedjan 	40 proseanttain ja siskkit orohagain fas 48 proseanttain .
Allagasain 	njiedjá 	áimmu oksygensisdoallu , goikan lassána ja ultrafiolehtta suonjardeapmi ja kosmalaš ioniseren lassána .
Jus reantu ain 	njiedjá 	, nugo ráđđehusa áigumuš lea , de gielddain vel ain geahpeduvvojit golut ja dalle sáhttet sii eanet mearredit ruhtaatnimis .
Norgga militearfámu Hercules mašiidna lea 	njiedjamin 	Evenášši girdinšilljui muhtin dálvebeaivvi dá duvle .
Skuvlaahkásaš mánáin máhttet ain lagabui goalmmát oassi sámegiela , muhto vuollelskuvlaahkásaččain 	njiedjá 	lohku dramáhtalaččat .
Lassin daid lobihis beliide , de dat čájeha ahte muhtin birrasiin leat morálaárvvut 	njiedjamin 	vel dákkár sámi servodagasge mii olgguldasas čájehuvvot leat jábálaš ja ahtanušši gieldan , cealká Sámi NissonFuruma báikkálaš lahtut preassadieđáhusas .
– Uhccán jáhkehahtti lea ahte Sámi giellaráđi árvu olggosguvlui 	njiejašii 	go Sámi giellaráđđi šaddá oassin Sámedikki hálddahusas , nu go ráđđi čuoččuha . #árvu
Gieldda eanandoalohoavda Nils Aslak Boine ballá ahte lohku vel garrasit 	njiedjá 	moatti jagis .
Čoavjeluođđa dagaha máŋgii ahte biergu nuoskkiduvvo ja kvalitehta 	njiedjá 	. #kvalitehta
Dalle leage hui dehálaš ahte bivdit devdet juohkebeaivválaččat « Sett elg » - skoviid amas eat boađe dan dillái ahte ealgahivvodat laská nu ahte biergokvalitehta 	njiedjá 	. #kvalitehta
Kárášjoga olmmošlohku lassána , sosiálagolut 	njidjet 	, bargguhisvuohta maid ja vearromáksu gildii lassána garrasit .
– Soapmasat siskkobealde Norgga Boazosápmelaččaid Riikkasearvvi ( NBR ) gutnejahttejit ealáhusa go boazolohku lea 	njiedjan 	Finnmárkkus .
– Váldosivva manne boazolohku lea 	njiedjan 	Finnmárkkus lea boranávddit , ja heajosealáhat dálvvit ja guorbaeatnan kombinašuvdna , lohká Boazodoallohoavda Jon Meløy .
Stuorát 	njiedjan 	mánáidgárddi bušeahtas mielddisbuktá heajut fálaldaga min deháleamos geavaheddjiide - namalassii mánáide .
Dát leat sivat manne mii oaivvildit boazolohku ferte 	njiedjat 	vel eanet .
Boazolohku lea 	njiedjan 	, muhto ii doarvái .
Boazolohku ferte 	njiedjat 	, lea sin cealkámuš , ja
Boazolohku ii leat vuos 	njiedjan 	nanu dássái vuos luondduvuođu ektui .
Boazolohku ferte 	njiedjat 	issorasat , vástideaddji guohtoeatnamiid heajosmahtton nanuvuhtii .
3 Bievlavuodjin ferte 	njiedjat 	issorasat .
Olmmošlohku Finnmárkkus lea garrasit 	njiedjan 	maŋimuš jagiid .
Guovdageainnus ja Deanus lea jienastuslohku fas 	njiedjan 	.
Sámi NissonForum ii dohkket ovdáneami gos nissonáirraslohku Sámedikkis 	njiedjá 	.
Maŋimuš 10 jagiid leat kollektiivafálaldagat 	njiedjan 	garrasit ja olu bargosajit FFR:s leat jávkan .
Dattege lea gávpi 	njiedjan 	20 proseanttain .
Mus lea vuovdin 	njiedjan 	20 proseanttain dan rájes go duođaštuvvui gussamielahisvuohta Suomas , lohká SPAR biebmogávpeeaiggát Seppo HŠrkšnen Gáregasnjárggas .
Iskkadeami boađus ii hirbmahuhte biergovuovdi , muhto lohká dát ii atte áibbas rivttes gova go vuovdin lea 20 proseantta 	njiedjan 	, iige beliin .
– Lea dárbu dan digaštallagoahtit go juo NBR miellahttolohku 	njiedjá 	ahte njiedjá .
– Lea dárbu dan digaštallagoahtit go juo NBR miellahttolohku njiedjá ahte 	njiedjá 	.
1997 rájes lea lohku 	njiedjan 	2 proseanttain .
Boazolohku goarkŋui gitta 1989 rádjái , muhto dan rájes lea boazolohku beare 	njiedjan 	miehtá 1990-logu .
Bajimus boazologojagi -1998- rájes lea gal Finnmárkku boazodoalus jahkedoaimmat garrasit 	njiedjan 	, muhto liikká ii leat leamaš seamma ovdáneapmi boazodoalu olbmuid logus .
Loguin boahtá ovdan ahte 1996 rájes leat miellahttočuoggát 	njiedjan 	NBRs jagis jahkái , muhto diimmá ektui lea fas leamaš smávit lassáneapmi .
Johansen ákkastii maiddái ahte boazolohku lea garrasit 	njiedjan 	maŋemus jagiid sin boazodoalloguovllus , mii lea dahkan ahte buot orohagain lea boazolohku vuollel mearreduvvon logu .
Dan dihtii lea vuordámuš ahte áiggi mielde sáhttá el-rávdnjehaddi 	njiedjat 	vulobeallái 20 evre // KWh .
Listtut mat leat biddjon dán jagi válggaide čájehit ahte nissonovddasteapmi 	njiedjá 	ain eambbo ođđa Sámedikkis .
Guokte jagi áigi 	njiejai 	beroštupmi teáhterii masá 40 proseantta . #beroštupmi XT-Acc
Bargguhisvuohta dievdduid gaskkas Japanas lea 	njiedjan 	, muhto bargguhisvuohta nissoniid gaskkas lea fas lassánan .
Dál beasat oaidnit badjána go vai 	njiedjá 	go olmmošlohku du ruovttugielddas .
Oppa sámi hálddašanguovllus , Unjárggas , Deanus , Kárášjogas , Porsáŋggus , Guovdageainnus ja Gáivuonas 	njiedjá 	lohku oktiibuot 636 olbmuin .
Jos einnosteapmi ollašuhttojuvvo , de 	njiedjá 	Gáivuona olmmošlohku 421 olmmuin ( 17,7% 2000-2010 áigodagas .
Olles Norggas leat dušše čieža gieldda gos olmmošlohku 	njiedjá 	eanet go Gáivuonas .
Maiddái Porsáŋggus , Deanus ja Unjárggas meroštallojuvvo olmmošlohku 	njiedjat 	.
Vaikko vel olmmošlohku oktiibuot 	njiedjá 	olles sámi hálddašanguovllus , de gal kárášjohkalaččat ja guovdageaidnulaččat ožžot mojohallat .
Dat lohku lea 	njiedjan 	1994-iskkadeapmi ektui .
Boađus lea ahte jienastuslohku lea 	njiedjan 	muhtun sajiin .
Tromsssas ja Nordlánddas fas 	njiejai 	ollislaš turistajohtolat 3 ja 2 proseanttain .
Oahppiid lohku 	njiedjá 	
FINNMÁRKU : Bargguhisvuohta lea 	njiedjan 	Finnmárkkus , muitalit logut maid fylkabargohoavda lea almmuhan .
Eanaš ealáhusain lea 	njiedjan 	bargguhisvuohta .
Máŋgga báikkiin leat unnán nissonolbmot ja dat áitá servodatovdáneami go olmmolohku 	njiedjá 	.
Sámediggi oaidná dehálažžan doaimmaid hábmet nu ahte boazodoalliide bohccobiergohattit eai 	njieja 	.
Dát dilli sáhttá earret eará dagahit ahte bohccobiergu haddi 	njiedjá 	.
Lohku lea garrasit 	njiedjan 	guokte maŋimuš jagi .
Dattetge leat massimat 	njiedjan 	garrasit guokte maŋimuš jagi .
Dán maŋŋá leat massimat 	njiedjan 	beliin .
Boahtte áigodagas 	njiedjá 	dát lohku 17:ái .
Duogážin lei olmmošlogu 	njiedjan 	, váttisvuođat guolástanealáhusas ja ollu bargguhisvuohta 1980-jagiin .
Doaibmabidjoguovllu olmmošlohku lassánii 1990-jagiid álggus , muhto maŋŋel 1995 fas 	njiejai 	doaibmabidjoguovllu olmmošlohku ja bargiidlohku .
Jus oasusmárkan 	njiedjá 	, de leat dahkiduvvon oažžut ruovttoluotta dan maid leat bidjan báŋkui sisa .
Jus oasusmárkan 	njiedjá 	, de leat dáhkiduvvon oažžut ruovttoluotta ruđa maid ieš leat máksán .
Otná boazolohku lea 100.000 , muhto galgá 	njiedjat 	64.000 bohccui .
Reantu lea 	njiedjan 	ja dat lea mielddisbuktán ahte loanat leat hálbon .
– Mii fertet earráláhkái smiehtat , ja beavttálmahttit doalu , nu ahte olggosgolut 	njidjet 	.
Sin mielas lea baicca eanet miellagiddevaš oaidnit ahte dat gielddat gos lea eanemusat lassánan olmmošlohku leat lahka stuora gávpogiid , ja dat gielddat main lea eanemus 	njiedjan 	olmmošlohku leat dat gielddat mat leat guhkkin eret stuora gávpogiin .
Miehtá 1980-vuođđologu lei olmmošlohku dán guovllus 	njiedjan 	.
Kárášjoga Sámeálbmot Bellodat ( SáB ) šálloša go Sámedikkis dađis 	njiedjá 	nissonpolitihkár lohku .
1990-2002 áigodagas 	njiejai 	olmmošlohku doaibmabidjoguovllus guvttiin proseanttain .
Mearkkašahtti lea ahte lei riddoguovlluin gos olmmošlohku eanemusat 	njiejai 	.
Smávvaluossalohku ges molsašuvvá jagis jahkái , muhto liikká ii leat gaskamearálaš lohku 	njiedjan 	.
Dat mii balddihahttá lea go stuorraluossalohku orru leamen 	njiedjamin 	.
Oahppilohku 	njiedjá 	jagis jahkái , ja Divttasvuona suohkan áitá heaittihit skuvlla suohkana heajos ekonomiija dihte .
– Maŋŋá go boranávddit leat laskan , de leat eanet ahte eanet sávccat 	njiedjan 	váriin gittiide ja ássanvisttiid šiljuide .
Boranávddit leat maid laskan nu ahte bohccot gavdnjaluvvojit ja 	njidjet 	váriin bodnái , lohká Smuk .
– Mii leat váldán ovttasvástádusa Sámi dáidagii ja jos eat váldde vuostá dáidaga guovtti golmma jahkái de šaddá dárbbašmeahttumin váilevuođa vuorkkás , ja árvu maid 	njiedjá 	. #árvu
Arve- , biegga- ja mearradássi ja temperatuvrrat sáhttet loktanit dahje 	njiedjat 	báikkálaččat .
Duiska ijastalliid lohku lea 	njiedjan 	10 proseanttain go buohtastahttá diimmá borgemánuin .
Njuorggám : Gálddooaivvi boazoisit Vieno LŠnsman ballá olbmuid šlundut boazodoalus , go dienas lea 	njiedjan 	jagis jahkái .
Diimmážis lea dán jagi haddi , mii lea birrasiid 3,50 euro , 	njiedjan 	10 proseanttain .
Preassadoarjja lea 	njiedjan 	daid maŋimus jagiid , ja dat sáhttá mielddisbuktit ahte smávit aviissat reastaluvvet .
Ii oktage duvdašuva eret , ja boazolohku 	njiedjá 	.
Ieš alddis lea maid nu ahte giela stáhtus badjána ja 	njiedjá 	dan mielde , man jábálaččat leat giela geavaheaddjit .
- Galhan dál lea biergohaddi duođaid vuollin ja orru ahte boahtte jahkái sáhttá vel 	njiedjat 	dássážis .
– Rittus olbmot fárrejit eret , muhtin suohkaniin lea olmmošlohku 	njiedjan 	20 proseanttain .
Olles Finnmárkku rittus ja Álttás , mii lea oalle hirpmáhuhtti , leat guossejándorat hirbmadit 	njiedjan 	.
Buot Finnmárkku hoteallain , go obbalaččat geahččá , lea dalle 7850 idjadeami 	njiedjan 	dien golmmajagi áigodagas .
• Dábálašmearri lasseárvodivvagis lassána 24 25:a prosentii • Mearri peršunfievrrideamis lassána 6 7:a prosentii • Mearri biebmoávdnasiin 	njiedjá 	12:s 11 prosentii
Boazodoallohoavda lohká dál čielgasit čájehit ahte boazolohku lea beare badjin Oarje-Finnmárkkus , go buot orohagain leat njuovvandeattut 	njiedjan 	guokte jagi maŋáa lága , earret ovtta orohagas .
« Go jávkanlohku lea 	njiedjan 	, de dat dieđusge geahpida morraša noađi .
Ikte lei jávkanlohku 	njiedjan 	91:ii .
Logut leat 	njiedjan 	maiddái Suomas ja Ruoŧas .
Logut 	njidje 	dramáhtalaččat easka maŋŋá go politiijat almmuhedje namaid .
Go jávkanlohku lea 	njiedjan 	, de dat dieđusge geahpida morraša noađi .
Jus juohke gieldda áššemeannudeaddji oččošii sámi stáven- ja grámmatihkkadárkkisteami iežas PC:ii na dalle han 	njiejašii 	diibmolohku mii lea biddjon giellalágan áigumušaid várás .
Gaskavahku bođii diehtu ahte lohku lea 	njiedjan 	.
Son ii dieđe man olu ruhtajohtu 	njiedjá 	, muhto jáhkká supmi šaddat mearkkašahtti stuorisin .
Dan rájes go olgešbeale bellodagat ožžo ráđđehusfámu , de lea gielddaid bargiidlohku 	njiedjan 	10.000 olbmuin .
– Mii diehtit njuovvandeattut leat 	njiedjan 	ovddit jagiid ektui , de fertet ráhkkanišgoahtit dasa ahte nealgi sáhttá šaddat , lohká Gaup Aamot .
Sponheim čilgii su lea bággu doahttalit Stuorradikki ovttajienalaš mearrádusa , ja son šaddá bidjat johtui bággonjuovvamiid jus boazolohku ii 	njieja 	dan muddui máid Stuorradikkis sáhttet dohkkehit .
Mun maid imaštattan go Hætta 	njiedjá 	nu vuollegis dássái iežas ákkastallamis , ja nu čielgasit badjelgeahččá guokte min nannoseamos dáiddafágaolbmuid namalassii Nils Utsi guoktá Synnøve Perseniin veardidemiid das ahte sirdit Beaivváža eret Guovdageainnus .
Hætta 	njiedjá 	iežas ákkastallamen gitta šláttar dássái .
Dan rájes go Sámediggi lea ásahuvvon , de lea nissoolbmo áirraslohku baicca 	njiedjan 	ahte njiedjan .
Son muitala ovdalaš jagiid beroštumi dušše 	njiedjan 	jagis jahkái .
Njukčamánus 	njiejai 	bargguhisvuohta Finnmárkkus 79 olbmuin .
Jagiin 1987-2004 lea bohccobierggu duođalaš haddi 	njiedjan 	ja lassánan doaibmagolut leat dagahan ahte duođalaš sisaboađut leat luoitán mealgadii .
Ruhttenfágabargiide maid čuohcá dat go min barggu árvu 	njiedjá 	, lohká Lindstrøm . #árvu
Dat lea dagahan ahte válgaoassálastin Oslos lea 	njiedjan 	dramáhtalaččat .
1989 sámediggeválgga oassálastin lei 78 proseantta ja 2001 válggas dat lei 	njiedjan 	56 proseantta .
- Dalle oainnán mun min 20 jagi rahčamušaid oažžut gelbbolaš olbmo virgái duššin , ja sámegiela árvu 	njiedjá 	Gáregasnjárgga skuvllas ja muđui Ohcejoga skuvllain , lohká Rasmus . #árvu
BILLISTIT EALÁHUSA : NBR veterána Nils Anders Eira ballá ahte eiseválddit oalát billistit boazodoalu Finnmárkkus , go Oarje-Finnmárkku boazolohku 	njiedjá 	mearriduvvon lohkui .
Lappiguovllu eananhearrá Hannele Pokka deattuhii iežas sáhkavuorus ahte boazologut leat dal 	njiedjan 	vulosguvlui measta juohke bealde boazodoalloguovllu , ahte leat ollen dan dássái maid boazodoalloláhka gáibida .
Muhto dát lohku lea gal maŋimuš jagi 	njiedjan 	ja dat leat dat stuorámus aviissat mat eanemusat njidjet ja eai nu ollu smávit ja báikkálaš aviissat .
Muhto dát lohku lea gal maŋimuš jagi njiedjan ja dat leat dat stuorámus aviissat mat eanemusat 	njidjet 	ja eai nu ollu smávit ja báikkálaš aviissat .
Deatnu lei dat johka Norggabealde , gos bivdoboađus 	njiejai 	buot eanemus diibmá .
Giela stáhtus badjána ja 	njiedjá 	dađe mielde , man jábálaččat leat dán giela hállit .
Bargguhisvuohta Finnmárkkus lea 	njiedjan 	geassemánu , sivas go turistaealáhus ja huksendoaimmat leat jođus geasset .
Go čáhci fas dievai mágasiinnaide , de ii 	njiedjan 	elrávdnje haddi namuhan veara .
Stuorradiggeválggain njeallje jagi áigi , 	njiejai 	lohku 75 prosentii .
Min Áigái son muittuha ahte 25 maŋimuš jagiid lea Davvi-Norgga olmmmošlohku 	njiedjan 	7000 ássiin .
Ovdal sáhtte olles vahkku veddot , ja dalle han šaddá váivašuvvan smáhkka bierggus ja biergokilo maid 	njiedjá 	, lohká Nilsen Eira .
Muhto vaikko olles riikkas manná bures ealáhusain , de leat dattetge guolástusfitnodagaid ja bargiid lohku 	njiedjan 	.
Muhto go sáhpániid mearri 	njiedjá 	de spiret borragohtet rievssahiid , Liimatainen muitala .
Dat mearkkaša jos boazoeaiggádat nagodivčče njuovvat badjirádjái dán čavčča , de lea vejolašvuohta nagodit gokčat bohccobiergomárkana Norggas , dasa lassin 	njiejašii 	boazolohku fylkkas , árvala Hætta .
Nissonlohku lea 	njiedjan 	erenoamážit dain losimus komiteain .
Ruovttusiidduineaset rávvejit olbmuid geat ođasmahttigohtet , divvugohtet ja huksegohtet dálu , geassit jurddašit mo sii sáhttet buoremusat dan isoleret , vai energiijadárbu dálu liggemii 	njiedjá 	.
Energiijadárbu sáhttá dalle 	njiedjat 	15-20% .
Liggendárbu 	njiedjá 	15-20% .
Jus geahpedat sihke beaivit ja ihkku lieggasa , de 	njiedjá 	energiijadárbu 15-20% .
Luohti lei dahkkon áibbas ođđa hámis , gos gelddolašvuohta dađimielde goargŋu muhtun muddui ja fas 	njiedjá 	.
Ohppiid mearri 	njiedjá 	
Ohcejoga sámelogahaga váldováttisvuohta lea ohppiid meari 	njiedjan 	.
Suoma bealde jagiin 1987-2005 lea bohccobierggu duođalaš haddi 	njiedjan 	ja lassánan doaibmagolut leat dagahan ahte duođalaš sisaboađut leat luoitán mealgadit .
Oarje-Finnmárkkus lea diimmáš loguid ektui 	njiedjan 	boazolohku 6000 bohccuin .
Dasa lassin ahte boazolohku lea 	njiedjan 	Oarje-Finnmárkkus , leat maiddái ollu doalut heaittihuvvon guovllus , čájehit boazodoalu resursarehketdoalu logut .
Misiid gaskamearálaš deaddu lea 	njiedjan 	2,8 kg Oarje-Finnmárkkus maŋemus jagis .
Dassa lassin lea maiddái biergobuvttadeapmi Finnmárkkus 	njiedjan 	ja erenoamážit Oarje-Finnmárkkus .
Dat mearkkaša ahte buozalmasvuođa jávkan lea 	njiedjan 	oalle ollu dan rájes go šiehtadus eanet fátmmasteaddji bargui bođii johtui 2001:as .
Dannego gaskamearálaš kilohaddi juovlamuorračuovggain lea 	njiedjan 	58 ruvnnos , 41 ruvdnui .
Ollislaš marsipána importa lea 	njiedjan 	, namalassii olles 46 proseantta , ja 236 tonna unnit , čájehit Statistihkalaš guovddášdoaimmahaga logut .
Dán jagi lea fas 	njiedjan 	54 proseanttain , dat mearkkaša ahte 149 440 lihttara akevihtta lea skábmamánu lohppii ostojuvvon Norgii .
- Olbmuid jápminlohku johtolatlihkohisvuođain Davvi Norggas lea mealgat 	njiedjan 	.
Norgga johtolatorganisašuvdna Trygg Trafikk dieđiha ahte 2005:s 	njidje 	johtolatlihkohisvuođat beliin 2004 ektui , gos olbmot dušše .
Riikka dásis 	njiejai 	lohku 2004 rájes 257 duššan olbmuiguin 223 olbmui 2005 .
Maŋemus jagiid lea oahpaheddjiid lohku , geain ii leat oahppu , 	njiedjan 	Finnmárkku vuođđoskuvllain .
Dattetge1998 rájes lea borgguheddjiid lohku Norggas 	njiedjan 	jámma .
2001 lei gaskamearálaš borgguheddjiid lohku Norggas 29,8 proseantta ja 2005:s lei dát lohku 	njiedjan 	25 prosentii .
Jus eat loavtte barggus , de 	njiedjá 	mokta ja mii eat nagot bargat nu mo galggašeimmet .
Nubbi hástalus fas lea skuvlladoaibma , doppe fas oahppiid mearri 	njiedjá 	.
Vuovdeeaiggádat ballet maiddái priváhtavuvddiid muora jearu 	njiedjat 	, jos stáhta vuvddiin doaimmahuvvo uhcit muorra go ovdal .
Sámi olmmošlogut 	njidjet 	
PORSÁŊGGUS NJIEDJAN : Sámi suohkaniin lea olmmošlohku Porsáŋggus 	njiedjan 	eanemus , 77 olbmui .
Eanas sámi suohkaniin 	njiedjá 	olmmošlohku
Eanemus lea olmmošlohku 	njiedjan 	Porsáŋggu gielddas .
Muhto maiddái eará sámi suohkaniin lea 	njiedjan 	olmmošlohku .
Muhto maiddái Finnmárkkus oppalaččat lea 	njiedjan 	olmmošlohku 137 olbmuin .
Dás čájehuvvo ahte olmmoslohku lea 	njiedjan 	15 jagis , eret- ja sisafárremat , galles riegádit ja jápmet ja sohkabeliid vuollegat gaskamearálaš eallinahki ja vuollegis alit oahppodássi .
Eanandoallodepartemeanta fas lea mearridan ahte jus boazolohku ii 	njieja 	dán mearriduvvon boazologu radjái , de čađahit bággonjuovvama .
GUOVDAGEAIDNU : - Boazodoallostivra ii álgge bákkus njuovahit bohccuid Oarje-Finnmárkkus vai boazolohku 	njiejašii 	, dan lohká Boazodoallostivrra jođiheaddji Mona Røkke NRK Sámi Radios .
Johnsen ballá sámi ohppiid lohku 	njiedjá 	jus Skániid Joatkkaskuvla heaittihuvvo , ja čuohcá garrasit sámekultuvrra ovdánahttimii márkosámi guovllus , go joatkkaskuvlla biras geasuha olbmuid guvlui .
Jos heaittiha Skániid joatkkaskovllá , de mii ballat ahte sámegielohppiid lohku 	njiedjá 	ja ahte dát maid váikkuha mánáidskovllá sámegielohppiid logu Evenáššis ja Skániid suohkanis .
Jagiin 1987-2005 lea bohccobierggu duođalaš haddi 	njiedjan 	ja lassánan doaibmagolut leat dagahan ahte duođalaš sisaboađut leat luoitán mealgadit .
Dán bálkáceahkis leat eanemus 	njiedjan 	inkassoáššit , muhto maiddái sis geat dinejit vuollil 100 000 leat diimmážis njiedjan inkassoáššit 16 proseanttain .
Dán bálkáceahkis leat eanemus njiedjan inkassoáššit , muhto maiddái sis geat dinejit vuollil 100 000 leat diimmážis 	njiedjan 	inkassoáššit 16 proseanttain .
Ja lea buorre ágga muittuhit man dramáhtalaččat rekrutteren vuođđoealáhusaide lea 	njiedjan 	obbalaččat - ja guolástusealáhussii erenoamážit .
Vaikke ruksescuohpat guliid sálaš 	njiejai 	diibmá ovddit jagiid ektui , de oppalaš sálaš bisui seamma dásis .
Maiddái čuovžžaid mearri lea 	njiedjan 	moatti tonne jahkefárttain maŋimuš jagiid áigge .
Maiddái kultuvrralaš stáhtus lea dehálaš , mii laktása gielalaš váldái , Giela stáhtus badjána ja 	njiedjá 	dađe mielde , man jábálaččat goas leat dán giela hállit .
Go lea fitnan gurremin , de lea baikačáhcegiera 	njiedjan 	15 cm. .
Muhto maŋimuš jagiid lea lohku 	njiedjan 	2500 galledeaddjái .
Ruhta mii manná oktasaš kássii galgá geavahuvvot sihkkarastit eambbo elfámu nu ahte hattit 	njidjet 	.
Maŋimuš 5-6 jagi lea albbaslohku 	njiedjan 	oba riikkas , muhto dál orro dát lohku fas lassáneamen , čállá Luondduhálddašandirektoráhta .
Dan rájes lea beare 	njiedjan 	, ja diimmá jagis eai buhtaduvvon eará 11,4 proseantta dan 36 916 bohccos mat ledje ohccon návdevahágin .
Manin lea beroštupmi 	njiedjan 	ruoŧabeal sámi spábbačiekčanjoavkkuin ? #beroštupmi
Dan rájes lea beare 	njiedjan 	, ja diimmá jagis eai buhtaduvvon eará 11,4 proseantta dan 36 916 bohccos mat ledje ohccon návdevahágin .
Buot eará filkkain go Finnmárkkus 	njiejai 	lohku man ollu rievssahiid báhče .
Ovllá-rohkki muitalii , ahte fáŋga báhtarii duiskalaččaid ájaráigge bajáš Uhca-Čohka birra ja justa go lei vas 	njiedjamin 	ordarájás , de duiskalaš soalddát bážii albmá , luođđa manai čielggi čađa .
Meahcceloddelohkamat Mátta-Várjjagis čájehit ahte logut ain 	njidjet 	
Diimmážii lei lohku 	njiedjan 	logi oahppái .
Olmmošlohku boaittobealbáikkiin 	njiedjá 	.
- Jáhkkimis lea jorgalanrusttega haddi 	njiedjan 	beannot duhát ruvdnii go analoga sáddagat bissehuvvojit , lohká NTV-hoavda Svein R. Aarvik Avisenes Nyhetsbyråii ( ANB ) .
Sáltečáhcihan sáhttá 	njiedjat 	vuollel nolla gráđđii , Kylmäaho muitala ja lasiha , ahte Deanu guvžá gáibidivččii vuđolaš dutkama .
Váldováttisvuohta Ohcejoga vuolláibáhcaga šaddamii lea , ahte stáhtadoarjagat leat maŋimuš logi jagi áigge 	njiedjan 	Ohcejogas 16 proseantta , vaikke Lappi leanas dat leat loktan gaskamearálaččat 34 proseantta .
Dan lassin sisaboađut leat maŋimuš jagiid 	njiedjan 	ja golut fas lassánit jahkásaččat , Pesonen lohká .
Gehččiid lohku lea garrasit 	njiedjan 	, ja NRK Sámi Radio kulturmágasiinnas lea dát áššin .
Maŋemus njeallje jagi lea sámi našunála teáhter vásihan ahte gehččiidlohku lea garrasit 	njiedjan 	.
Lean rehkenastán , ahte bohccuid deaddu 	njiedjá 	gaskamearálaččat guokte kilo fievrredeamis ja dan lassin muhtun oasi biergguin ferte hilgut , jus čoarbbealit ja čoamohasat sáhpodit fievrredeamis .
Boraspirevahágat lea mealgat 	njiedjan 	.
30 buolašceahkái láve temperatuvra muhtin jagiid 	njiedjat 	, muitala son .  #temperatuvra DE-Ill
- Dát lea maid riektehistorjá dán áššis , go ii goassige ovdal leat gielda stevdnen stáhta go olmmošlohku lea 	njiedjan 	, lohká ádvokáhtta Gunnar Nerdrum .
Earát fas dorvvastedje dasa ahte dál go mii ieža eaiggáduššat , de baicce bohtet hattit 	njiedjat 	.
Go boađán sin geahčai , Áslat lea aiddo 	njiedjamin 	lovttas , telefon bealljis , njálbmečiegas vel suollemas modji .
Máŋga Finnmárkku suohkaniin 	njiedjá 	olmmošlohku ja rahčet servodaga ja ealáhusa ovdanahttimiin .
Iskan čájeha ahte suonjarfápmu 	njiedjá 	25% .
Dál ovttaskas gps-čeabetbátti haddi lea 250 euro , muhto jus dasa leat eambo geavaheaddjit , de haddi 	njiedjá 	dies oluge .
Assás skálvviid siste ealggat eai šat goastta johttit johkagežiin ja 	njidjet 	ohcat biepmu Deanu leahkái .
Deanu sálaš molsašuddá dego bárru , sullii čieža jagi gaskka sálaš 	njiedjá 	ja goargŋu .
In jáhke dan dáhpáhuvvat , go ain lea gielas dan mađe nana sadji sámiid gaskkas , muhto lea čielggas go lea čuvvon sámepolitihka muhtun áiggi ahte sámegiela árvu ja mearkkašupmi lea 	njiedjan 	ja hedjonan maŋimuš logemat jagi . #árvu
Cuoŋománu rájes lea bargoohcciid lohku 	njiedjan 	217 olbmuin .
Jagiin 1987-2005 lea bohccobierggu duođalaš haddi 	njiedjan 	ja lassánan doaibmagolut leat dagahan ahte duođalaš sisaboađut leat luoitan mealgadit .
Stuorraluossanálit miehtá Deanu čázádaga leat 	njiedjan 	logus .
Kárášjoga ja Iešjoga stuorraluossanálit maid leat 	njiedjan 	hirbmadit logus maŋemus jagiid .
Kárášjoga ja Iešjoga luossanáliid leat juo kártegoahtán , go dihtet ahte lea leamaš stuorra 	njiedjan 	luossa logus dáid guovtti jogain .
- Min ossodagas eat diehtán ovdal dán giđa ahte Anárjoga luossalohku maid lea 	njiedjan 	issorasat , nugo Kárášjogas ja Iešjogas , lohká guolástus hálddašeaddji .
- Reantu 	njiedjá 	skábmamánus
Norggas lea njálalohku 	njiedjan 	hui ollu ja 1930-rájes lei njálla ráfáidahttojuvvon ealli .
Eanemus lea 	njiedjan 	Guovdageainnus .
Guovdageaidnu lea dat suohkan gos barggohisvuohta lea 	njiedjan 	eanemus go borgemánus ledje 7,2 proseantta barggu haga dán suohkanis gos lea guhká leamaš alla barggohisvuohta .
Dál lea dilli rievdame danin go ovddit mánu ledje 9,2 proseantta barggu haga ja lohku leage 	njiedjan 	olles guvttiin proseanttain .
Jagiin 1987-2006 lea bohccobierggu duođalaš haddi 	njiedjan 	ja lassánan doaibmagolut leat dagahan ahte duođalaš sisaboađut leat luoittán mealgadit .
Mearradássi maid badjánii olu , muhto de beaivvášliekkas fas 	njiejai 	, jade bođii unna jiekŋaáiggáš 1690s .
- Gálddoaivvi bealde rievssahat leamašan iešalddes buorebut go diibmá , muhto Báišduoddaris gal rievssatnálli vuhtto čielgasit 	njiedjan 	diimmážis , Gáregasnjárgga guovllus ja Muotkeduoddaris in leat fitnan , muhto máŋgga sajis gullan , ahte rievssatdilli lea fuotni , Jarmo muitala .
1700-logus 	njiejai 	olmmošlohku eanas Finnmárkku bivdosadjiguovlluin ja muhtin guovlluin fárrejedje máŋggas eret ja muhtin guovllut gis báhce ávdin .
Sámiid ruovttuguovllu gielddain 	njiedjá 	sámegiel oahpaheddjiid lohku go oahpaheaddjit mannet ealáhahkii ja go lea váttis eará olbmuid fitnet sin sadjái .
Sámiid ruovttuguovllu gielddain 	njiedjá 	sámegiel oahpaheaddjiid lohku go oahpaheaddjit mannet ealáhahkii ja go lea váttis eárá olbmuid fitnet sin sadjái .
Duogážin gáržžideapmái lea go Finnmárkku luossajogaid luođoluossamáddodagat orrot 	njiedjamin 	, ja dál áigu Luondduhálddašandirekoráhta mearridit muddema boahtte 5 jahkkái .
Sámiid ruoktoguovllus mearri gis 	njiedjá 	.
Ruoktoguovllus mearri lea 	njiedjan 	váile čuđiin .
	Science texts –
Son lea maid oahpahaddan 	njiedjat 	máná dássái ja
Ovddit beaivve leai 	njiedjan 	váris , gárdumis .
Áššedovdikomitea lea guoddán stuorra fuola julev- ja lullisámegielaid hedjonan ja rašes dilis , dasgo hálliid lohku lea 	njiedjan 	sakka .
62 atnit dan , ahte sápmelaččaid lohkumearri sámeguovlluin lea 	njiedjan 	ja lea ain njiedjamin , ja erenoamážit ollu mánát ja nuorat ásset eará sajis go guovd dášsámeguovlluin , ovdamearkka dihte Suomas 70 proseantta vuollil skuvlla ahkásaš mánáin ásset juo olggobealde Sámiid ruoktoguovllu .
62 atnit dan , ahte sápmelaččaid lohkumearri sámeguovlluin lea njiedjan ja lea ain 	njiedjamin 	, ja erenoamážit ollu mánát ja nuorat ásset eará sajis go guovd dášsámeguovlluin , ovdamearkka dihte Suomas 70 proseantta vuollil skuvlla ahkásaš mánáin ásset juo olggobealde Sámiid ruoktoguovllu .
Nuorttanaste dolliidlohku lei 	njiedjan 	, ja váldodoaimmaheaddji H. O. Heika sivahalai dáruiduhttima leat váikkuhan sáme bi juohke láhkai , iige diktit dan duššat nu álkit .
váhnenbuolvvas mas 	njiedjá 	sakka .
kveanaid lohku lea 	njiedjamin 	sakka , ja ahte sihke sámegiella ja kveanagiella orru
ahte sámegielagiid lohku lea 	njiedjan 	issorasat , sullii 14 proseanttain guhtta jáhkái , 1994s
Guovllus lea sámegielagiid lohku 	njiedjan 	garrasit 1900 logu mielde .
