Boađus: 131
Cealkkačájeheapmi
Administrative texts – 
Mánáidgárddis	oaidnalit	bargit ja váhnemat beaivválaččat go lea buktin- ja viežžanáigi . #recip
Dáid lagamuš beivviid besset olbmot gullat ja oaidnit din giela ja kultuvrra , dii beassabehtet	oaidnalit	oahppásiiguin ja oahpásmuvvat ođđa olbmuiguin , ja dii beassabehtet ráhkkanit ođđa hástalusaide boahttevaš jagiide . # + Com
Oaidnalat	Sajosis 28.-29.03 !  #recip
Oaidnalit	Heahtás !  #recip
Oaidnalit	Heahtás !  #recip
Aššu – 
Jearahallagohten sus ságaid , nugo juo vierru lea ge go guhkes áigái eat leat	oaidnalan	.  #recip
Oaidnalit	boahtte jagi ?  #recip
Mii	oaidnalit	fas ođđajagis  #recip
Per Høst-rohki bárdni , Jan Høst , ja Niillasa Gáren Ánná eaba lean	oaidnalan	dan rájes go filbma “ Same Jakki ” ráhkaduvvui .  #recip
- Ferten vuolgit bargat , muhto sávan ahte	oaidnaletne	dánssas eahkes , logai son .  #recip
Maŋŋel go vuosttaš skuvlabeaivi nogai , lohká oahpaheaddji : - Gal mii	oaidnalit	fas ihttin iđđes !  #recip
Dušše okte ovdal ledje sii	oaidnalan	, márkanbáikkis muhtun lávvordaga . #recip
Buot somámus čuovvovaš konfereanssas lea	oaidnalit	buot daid olbmuinguin , geaidda dál leat oahpásmuvvan ja muittašit Ođđa Zealandda mátkki ja vásáhusaid . # + Com
Nu fal , gal mii	oaidnalit	fas boahtte háve , lávdde nalde dahje dán siiddus . #recip
Gal mii fas	oaidnalit	! #recip
Girječálliide lea maid hui ávkkálaš beassat	oaidnalit	lohkkiiguin ja oahpásnuvvat ođđa báikkiide . # + Com
Nieida lei gal lohkan ahte ii muitte ovttage niegu gos soai leaba	oaidnalan	, muhto eŋgel várra veaháš jieppadii go duohtamáilmmis gávnnadeigga .  #recip
Gal mii	oaidnalit	maŋŋel beassážiid !  #recip
Avvir – 
Suohtas fas	oaidnalit	Son lohká suohtasin fas oaidnit iežas dološ ohppiid .  #recip
In ipmirdan jurdilit ahte ean dáidde šat	oaidnalit	goassege go vulgen mearragáddái , ja de in mannan láža áhku luhtte .  #recip
Vaikko eaba leat	oaidnalan	eanet go oktii guhttalogi jagis , de lea ustitvuohta nannoseabbo go goassege ovdal .  #recip
Vaikko eaba leat	oaidnalan	eanet go oktii guhttalogi jagis , de lea ustitvuohta nannoseabbo go goassege ovdal .  #recip
Muorralis mii eat šat beasa duinna	oaidnalit	. # + Com
Erenoamážit váldolávlla mii guoddá olles buvttadeami nama Birrat Birra , ja	Oaidnaletne	leat lávlagat maid maiddái sii geat muđui eai guldal dán suorggi musihka , roahkka vedjet guldalit .
– Dat ii leat dieđusge seamma go	oaidnalivčče	, muhto sámevuhtii dat dáidá leat buressivdnádus , go sápmelaččat leat nu moattis ja ásset iešguđetge guovlluin . #recip
Gal mii ihttin bearjadaga	oaidnalit	ávvufeasttas !  #recip
Álgojagiid ledje eanaš Finnmárkku sámit , muhto mii maid šattaimet	oaidnalit	hui hárve .  #recip
Stuorra oassái sámi álbmogii mearkkaša dat ahte sii	oaidnalit	, ja sidjiide ii leat dan čurvemis mihkkege oaivilii .  #recip
Dat válddahivčče dan sierra mearkkašumi ahte leat mii geat	oaidnalat	eai ge soapmásat earát , nugo sáhttá navdit oaivvilduvvot .  #recip
Mii	oaidnalit	!  #recip
Justa dál ii leat vel dađi eanet diehtu prošeavttas , muhto koarra áigu baicce	oaidnalit	ja hárjehallat ja muittohallat lávlagiid ja luđiid maiguin leat ovdal bargan .  #recip
Jievja beasaige masá dallánaga go máhcai Ohcejohkii , johttát fas ja	oaidnalit	vuosttas háve turisttaiguin juo nuppi juovlabeaivvi . # + Com
Oaidnalit	go fas ollet ruoktot olgoriikkas .  #recip
Oaidnalit	sotnabeaivvi !  #recip
Mannet dal dearvan , mii	oaidnalit	fas giđđat !  #recip
Mii	oaidnalit	!  #recip
– Jus eat livčče ovttasbargan , de eat livčče	oaidnalan	nu dávjá .  #recip
– Mii	oaidnalit	NRK 3:s , duorastagaid dii : 2105 , hástaleaba soai .  #recip
Lihkostuvvan beaivvi maŋŋá nu oahppit go earáge giliolbmot sávve	oaidnalit	Ruktajávrris fas boahtte giđa . #recip
Mánát geat deaivvadedje háliidit áinnas	oaidnalit	fas .  #recip
Mii	oaidnalit	! #recip
Go boađán sisa , ii oktage vástit go rávkkan ’ hei ’ ja go manan , de ii oktage beroš go dajan ’	oaidnalit	’ . #recip
Olusat eai leat	oaidnalan	1968 rájes . #recip
- Jurddeš dalle go gearggaimet , čuččodeimmet skuvlašilljus ja dajaimet ahte gal mii fargga	oaidnalit	, ja oallugat eai leat oaidnalan 40 jahkái , lohka Issát Sámmol Hætta . #recip  #recip
- Jurddeš dalle go gearggaimet , čuččodeimmet skuvlašilljus ja dajaimet ahte gal mii fargga oaidnalit , ja oallugat eai leat	oaidnalan	40 jahkái , lohka Issát Sámmol Hætta . #recip  #recip
– Dat lea hárjehallan go nieiddat eai	oaidnal	nu dávjá ja sii han orrot Snoasas gitta Unjárgii , máŋgii lea váttis sin čohkket ja lea maid hui divrras , muitala Lindseth . #recip
Eanet in sáhte dál muitalit , muhto mun beare neavvun dál nieiddaid ahte dál gálget albmaládje hárjehallat ja mii	oaidnalit	Nilut Cupas Guovdageainnus , hástala Sámi nieiddaš AWG-joavkku hárjeheaddji Frank Lindseth . #recip
Son háliida maid cealkit dearvvuođaid Sofe-áhkkui ja buot oahppásiidda Kárášjogas , mii	oaidnalit	geassái . #recip
Na goit jus lea guhká dassážii go mii fas	oaidnalit	. #recip
Oaidnale	boradanbottus . #recip
… várra liikka stuora vejolašvuohta go dat ahte moai goassege fas	oaidnaletne	! #recip
‹ ‹ Mun spáigen Turi čálli juohke háve go	oaidnaleimme	- muhto ii goasse darvánan mihkke báhpirii . #recip
Go dáid riidduid geažil šaddet dušše unohasvuođat boanddaid ja boazodolliid gaskii , geat beaivválaččat galget orrot sullii guhtta mánu seamma báikkis ja nu šaddet	oaidnalit	beaivválaš eallimis maiddái . #recip
Mii háliidit maid rámidit studeanttaid go dustet loktet dákkár ášši mediai , vaikko galget vel unnimus jagi dahje moadde jagi duolbmut Diehtosiidda feaskáriid ja	oaidnalit	singuin geaid dál moitet garrasit . # + Com
Mii	oaidnalit	!  #recip
Vuordinlanjas leat ollu olbmot ja buohkat čalbmetbealit , eatnašat sis leat ovddit jagiid	oaidnalan	dán vuordinlanjas ja muhtimat dovddadit oalle bures . #recip
Mii	oaidnalit	? #recip
Suohtas fas	oaidnalit	 #recip
– Mii	oaidnalat	suoidnemánu 21. beaivvi , loahpaha riddu riđđulaš Ragnhild Dalheim Eriksen .
Oaidnalit	vahkkoloahpa . #recip
Gal mii	oaidnalit	bearjadateahkeda , go dalle mii boahtit duinna ovttas ávvudit du stuora beaivvi . #recip
Dearvvuođat buot du kollegain dás Ávviris , ja	oaidnalit	fas čavččaguvlui ! #recip
Go lei luossaveajet , de son luittii dan ja sávai	oaidnalit	fas go leat gollán áiggit . #recip
Religion texts – 
Herodes illosii sakka go oinnii Jesusa , dasgo son lei gullan su birra ja lei guhká hálidan	oaidnalit	suinna . # + Com
Son muitalii mo dii áibbašehpet	oaidnalit	muinna , moraštehpet mu dihtii ja bealuštehpet mu stuora áŋgirvuođain , nu ahte mun illosin velá eanebut . # + Com
Mii ohcaleimmet din ja duođaid hálideimmet	oaidnalit	dinguin . # + Com
Lei dárbu	oaidnalit	ja guldalit muitalusaid Jesusa birra , gullat maid Jesusa eallin ja jápmin ja bajásčuožžileapmi mearkkašii . #recip
Non-fiction texts – 
Moai gal	oaidnaletne	goitge geassit ” , čilgesta áhkku ja loahpaha ságastallama . #recip
Dasgo miihan gal várra	oaidnalit	 #recip
Dasgo miihan gal várra	oaidnalit	Olmmáivákkis daid stuorra váriid gaskkas ? #recip
Mii	oaidnaleimmet	joga alde #recip
Maŋimuš 4 vahkus ovdal dikšuiváldima , galliigo	oaidnaleiddet	? #recip
Go dál	oaidnalan	iežan olbmuiguin , de sávašin máhttit sámegiela , muhto dalle ii lean hupmu ge beassat atnit sámegiela bealjehemiid skuvllas , juobeson vel giehtagiela oahppu min jovkui . # + Com
Mánáid sosiáliseren geat muđui unnán	oaidnaledje	: #recip
– Dárbbašin goitge	oaidnalit	eará olbmuiguin . # + Com
Dan mátkki maŋŋil bieđganeimmet iešguđet guvlui , eat ge leat šaddan	oaidnalit	šat nu dávjá . #recip
Go dál	oaidnalan	iežan olbmuiguin , de sávašin máhttit sámegiela , muhto dalle ii lean hupmu ge beassat atnit sámegiela bealjehemiid skuvllas , juobeson vel giehtagiela oahppu min jovkui . # + Com
Dat mearkkašii ahte oappát ja vieljat geat ledje iešguđet vuorus sirrejuvvojedje , sii vázze skuvlla vuoruid mielde ja	oaidnaledje	dušše fal juovllaid , beassážiid ja geasseluomus . #recip
Dalle maiddái	oaidnalin	vuohččan Finnmárkkuin . # + Com
– De bođii áigodat go in bargan nu ollu sámi áššiiguin , muhto skuvladirektevran goitge	oaidnalin	dainna eará skuvladirektevrrain , ja erenoamážit muittán Finnmárkku dalá skuvladirektevra Randi Nordback Madsena . # + Com
Ollu mánát besset de maiddái	oaidnalit	fulkkiidisguin dávjjibut go muđui . # + Com
Evakuerema rájes soai eaba šat	oaidnalan	ovdalgo Mary 60 jagi maŋŋil vulggii oambealis guossái boarrásiidsiidii Osloi Min mors hemmelighet - filmma ráhkadeami oktavuođas . #recip
Fiction texts – 
Dat sáhttá bure sge nu ahte ean leat ovdal	oaidnalan	, dáiddat leat mus nuorat , man boarisban don leat ? #recip
- Dieđan ahte letne fulkkežat vaikko ean leat	oaidnalan	. #recip
Dahke gieđas dearvvuođaid ja vurdno fas fargga	oaidnalit	ja vázziledje . #recip
- Dat dat dainna ruđain	oaidnalit	, hoahkalii Birgget . #?
Ammal liiggásge , go nu hárve	oaidnaleigga	muđui muođus muhtui . #recip
Eat leatge guhkes áigái	oaidnalan	. #recip
Ja lei čáŋadan maiddái Tunturin Helmis boradeamen , ja dalle soai leigga vuot	oaidnalan	. #recip
Jalla go in gulaskuddan goasses son mat leaš várin — masihin vejolašvuođa oktii boahtit goasse	oaidnalit	várin ja gonne deaivvadit . #recip
Oanebotta čuoččuime , sátni ii njivkasan , ja mon jáhkán moai goappašaga gamusteame dovddaime hálvat balus moai ean goassege šat	oaidnal	, hivástahtii vas , ja oidnen baksamiidis birra lihkai juoidá maid ii diktán jitnosii , mus alddam vigge baksamat lihkkat , dadjat juo galgen juoidá , oaidnledno soames hávi ― val sánit eai bođežan , oanebotta dugo bákkávállásii šattaimet goappašaga . #recip
Soai hivástahttaleiga ; dát várra šaddá maŋimus gearddi go soai	oaidnaleaba	. #recip
Puddii galggan rámidit go	oaidnaledne	nuppus ; dadjat : Háh , vuoi gáđa hal lávvi go it vuolgán mielde . #recip
Ean	oaidnalan	šat . #recip
Ja Duolljága nieida , ii lean dušše nieidalihtor šat maŋimus gearddi go	oaidnaleigga	, vuoi , lei juo máilmmi fávrruid ben . #recip
Min Aigi – 
Ovddežis leat ilbman « Boađe mu mielde » , « Sárá ja su ustibat » , « Bures , bures fas » ja «	Oaidnalit	» . #recip
Gávnnadit go ja	oaidnalit	go . #recip
Ii han dalle lean nu ahte dajat duon mun galggašin fidnet , muhto dat lei suohtas vuordit dušše beasat go	oaidnalit	nuppes . #recip
Beassat	oaidnalit	fas eará fulkkiiguin . # + Com
Smávvamánnaolbmot geahččalit čuovvut mielde dain mottiin fálaldagain mat gávdnojit sámi mánáide , ovdamearkka dihte ipmilbálvalusain ja sámi álbmotbeaivvedoaluin , muhto jus dan háve ii sáhte , de manná jahkebealli ovdalgo nuppes	oaidnalit	!  #recip
–	Oaidnalat	boahtte jagi ! #recip
Muhto go Murula vázzilii eret , de muittuhii vel ahte soai han	oaidnaleaba	boahtte vahkkus dan eanadoallovahátčoahkkimis . #recip
Juo ,	oaidnaletne	. #recip
Ollu fulkkežagat dán guovllus deaivvadedje dan dálus ja eará mátkkošteaddjit maid	oaidnaledje	doppe . #recip
Danne lea Máret	oaidnalan	eambbo olbmuiguin go eatnasat earát ja son lea vásihan feará maid guhkes eallimis mas lea dáhpáhuvvan ollu , muhtomin maid leat leamaš oalle issoras dáhpáhusat . # + Com
Sadda soma fas	oaidnalit	. #recip
Juo ,	oaidnaletne	. #recip
Eat beasa goassege ráfis	oaidnalit	, lohká son . #recip
Soai leigga	oaidnalan	Rittu Riđu festiválas dán geasi . #recip
Oaidnale	ihttin unnoraš . #recip
Mii	oaidnalit	ođđa Infonuorra Sápmi ruovttusiidduin ! #recip
Ollu lihkkusávaldagat du riegádanbeivviin - moai	oaidnaletne	vahkkoloahpa ! #recip
Oaidnalit	Sirpmás dien eahkeda ! #recip
Oaidnalat	dasto geassit ! #recip
Vuosttaš háve go	oaidnaleimme	bohtet mu čorgadis ruktui albma biepmu borrat ... #recip
Šaddá somá fas	oaidnalit	fargga ! #recip
Eira Sorsa	oaidnalii	Jovnnain vuosttas geardde Gámasmohkis 15 jagi dás ovdal ja ráhkisvuohta oaččui dalle vuosttas čuotnama . # + Com
Vuoi , ean leat doložis	oaidnalan	! #recip
Oaidnalit	du stuorra beaivvis . #recip
Muhto mii	oaidnaleimmet	juohke beaivvi . #recip
- Stuorimus hástalussan jáhkán sutnje dadjat ii , ja válljet makkár áššiiguin bargá , lohká Nystø gii láve duos dás	oaidnalit	vieljas bearrašin maiddái priváhta oktavuođain . # + Com
Gal mii fargga	oaidnalit	! #recip
Oaidnalit	ávvudeamis Bissujogas . #recip
Sávvat Mihkkalii vel buot buriid boahtte áigái ja sávvamis	oaidnalit	fargga . #recip
Ean leat guhkes áigái	oaidnalan	! #recip
Mii	oaidnalit	doaluin lávvordaga ! #recip
Juohkehaš mu skihpáriin vulget juohkehaš iešguđet guvlui ja dieđe goas fas	oaidnalit	. #recip
Muhtumat eai lean	oaidnalan	guhkes áigái . #recip
Earát eai lean goasse	oaidnalan	, go badjemánát ledje konfirmánttat beassážiid áigge , ja fástaássit ges guovddáš geasi . #recip
- Finan mun muonái geardde jagis Ohcejogas boares ruovttus	oaidnaleamen	ustibiiguin . # + Com
Ja dat maid fas lea soma gullat , go gulan “ Ja Raimo dat lea ihttán vuot min guvlui , o somá fas	oaidnalit	” , muitaladdá Raimo . #recip
