
Boađus: 19
					
Cealkkačájeheapmi
	Administrative texts –
Muhto bodnerivohiid eretváldin , doapparsuhppen , 	vuodjudit 	mohti ja hukset mearrabodnái gildojuvvo iešalddis . #TH-Acc-*Ani
	Avvir –
Ja Heatta muitala son ieš geavaha rieggá go galgá 	vuodjudit 	iežas jurdagiid feara masa nu . #TH-Acc-*Ani
Go leavssuid barggadettiin bargá eará de lea váttis 	vuodjudit 	skuvlabargguid ja dat dagaha ahte áigi manná muhto ii leat goitge oahppan lihkka ollu go livččii galgan áiggi ektui . #TH-Acc-*Ani
Nina Hansen , gii lea oahpaheaddji Berger skuvllas , gal eahpida leat go ohppiin návccat 	vuodjudit 	go eai daga dušše ovtta diŋgga hávális #no Acc *
Buot mii lea bálkestuvvon , ja maid luonddufámut leat 	vuodjudan 	gávdnojit čiekŋalasain . #TH-Acc-*Ani
– Go doppe leat maid eará vánhemat , de olmmoš beassá háleštit earáiguin ja lea vejolašvuohta 	vuodjudit 	ovdamearkka dihte dihto fáddái . #no Acc but Ill * should be vuodjudahttit or vuodjudit iežas
	Non-fiction texts –
Vánhemat vásihit ahte skuvla mielas addá rávvaga , jus leažžá nu ahte oahppi ii leat nu čeahppi dárogielas , matematihkas , eŋgelasgielas dahje earás , ja ráva lea dávjá ahte oahppi berrešii baicca 	vuodjudit 	daidda fágaide sámegiela sadjái . #no Acc but Ill * should be vuodjudahttit or vuodjudit iežas
muhtin oahppit eai nákce 	vuodjudit 	bargguide ja de lea oahpaheaddji ferten sin #no Acc* should be vuodjudahttit or vuodjudit iežas
Máhtte 	vuodjudii 	heastta jeaggái . #TH-Acc-Ani
Áigi ja báiki ferte láhččojuvvot vai sáhttá 	vuodjudit 	iežas bargui bidjat sániid árbevirolaš máhttui dearvvašvuođasuorggis .  #TH-Acc-Ani
	Min Aigi –
Don 	vuodjudat 	bargguide ja leat čeahppi doaimmahit daid . #no Acc but Ill * should be vuodjudahttit or vuodjudit iežas
Dán vuoru eai orron buot Beaivváš Sámi Teáhtera neavttárat doarvái bures 	vuodjudan 	teavstta gorudii . #TH-Acc-*Ani
Don 	vuodjudat 	bargguide ja dieđát maid hálidat . #no Acc but Ill * should be vuodjudahttit or vuodjudit iežas
Sivvan dasa sáhttá leat go it nagot 	vuodjudit 	áššiide ja leat eahpečielga njuolggadusat , ja dákko soaittát ložžet gáibádusaid .#no Acc but Ill * should be vuodjudahttit or vuodjudit iežas
Tor Persen muitala ahte sii prošeavttajoavkkus leat ráhkadan buhtes prográmma masa mánát sáhttet iežas 	vuodjudit 	amas eai gaskalduva ja vajálduva . #TH-Acc-Ani
SÁL jáhkká ahte gártá beare olu ja olmmoš ii háhppet 	vuodjudit 	daid áššiid . #TH-Acc-*Ani
	An Account of the Sami
Ja go stállu jámii , de ohce geđggiid ja čatne stálu čeabehii ja 	vuodjudedje 	dakko rudnái . #no Acc but ok
	Science texts –
” ( CEFRL 2009 : 26 [ 2001 ] ) , de sáhttá dobbe lii bidjat mihttomeriid dahje 	vuodjudit 	eará beliide giellaovdáneamis . #no Acc but Ill * should be vuodjudahttit or vuodjudit iežas
Lohkanoahpahusa oktavuođas galggašii ovddidit gielalaš diđolašvuođa buot beliid iige 	vuodjut 	dušše ovdamearkan fonologalaš diđolašvuhtii . #vuodjut
