Boađus: 32
Cealkkačájeheapmi
Aššu – 
Čuoikkat huraidedje bealljemáddagis ja ovdalgo vázzileimmet vuovdái	vuoiddadeimmet	iežamet čuoikavuoidasiin ja divodeimmet gurppiideamet bissunláhkái . # + Acc
Lihkus oktage ii boaldán iežas , muhto gal mii fertiimetge	vuoiddadit	oppa áigge . #recip + 0
De álggii nieida	vuoiddadit	ámadajo . #recip + Gen?
Avvir – 
Juolgesuorpmaid gaccaid ferte maid jámma čuohppat ja liikki	vuoiddadit	. # + Acc
Oallugat eai sáhte vuolgit gosage	vuoiddatkeahttá	. #
Vuoiddadit	Facebooka govain #
Religion texts – 
Sii ádje olggos ollu bahá vuoiŋŋaid ja	vuoiddadedje	ollu buhcciid oljjuin ja buoridedje sin . # + Com
Ovddalgihtii son lea	vuoiddadan	mu rupmaša hávdádeami várás . # + Acc
Go sábbát lei vássán , de Márjá Magdalena ja Márjá , Jáhkoba eadni , ja Salome oste njálggahájat vuoidasiid , vai besset vuolgit	vuoiddadit	su . # + Acc
Bassi Vuoigŋa lei su badjel , ja Vuoigŋa lei almmustahttán sutnje ahte son ii muosát jápmima ovdal go lea oaidnán su gean Hearrá lea	vuoiddadan	. # + Acc
Sutnje geigejuvvui profehta Jesaja girji , ja son rabai girjegearu ja gávnnai báikki gosa lea čállojuvvon : Hearrá Vuoigŋa lea mu badjelis , dasgo son lea	vuoiddadan	mu sárdnidit illusága váivvážiidda . # + Acc
Duođaid , sii leat lihtodan dán gávpogis du bassi bálvaleaddji Jesusa vuostái , gean don leat	vuoiddadan	, sihke Herodes ja Pontius Pilatus oktan báhkiniiguin ja Israela álbmogiin , ollašuhttin dihtii dan maid du giehta ja dáhttu lei juo mearridan . # + Acc
Ipmil ieš čatná min ja din nannosit Kristusii ja	vuoiddada	min . # + Acc
Dan dihtii , Ipmil , lea du Ipmil	vuoiddadan	du ilu oljjuin , du , eanebut go du guimmiid .  # + Acc + Com
Jos oktage din gaskkas lea buohcamin , de rávkos lusas searvegotti vuorrasiid , ja sii galget rohkadallat su ovddas ja	vuoiddadit	su oljjuin Hearrá nammii . # + Acc + Com
De gullojedje almmis alla jienat mat celke : Máilmmi gonagasváldi gullá dál min Hearrái ja sutnje gean son lea	vuoiddadan	, ja son ráđđe álo ja agálašvuhtii . # + Acc
Ja mun gullen alla jiena cealkimin almmis : « Bestojupmi ja fápmu ja riika gullá dál min Ipmilii , ja váldi sutnje gean son lea	vuoiddadan	. # + Acc
Mun lean gávdnan Dávveda , bálvaleaddján , ja lean	vuoiddadan	su bassi oljjuin . # + Acc + Com
dasgo son lea	vuoiddadan	mu # + Acc
Non-fiction texts – 
iežat	vuoiddadit	ja hárjehala # + Acc
Base gáhku alccesat , divtte iežat	vuoiddadit	ja hárjehala sámegiela dolastalladettiin . #leat yourself be flattered
ovddas , mii	vuoiddadat	su oljjuin ja guoddit su du ovdii duohtaváimmot rohkosiiguin : Divttášit su dearvvašnuvvat . # + Acc + Com
Máhte guovttos	vuoiddadeigga	. #recip
Min Aigi – 
Elisabeth	vuoiddada	ámadeajus iešguđet ivnniguin , cogga sákki njálbmái ja dagaha iežas albma ropmin . # + Com
Dákkáraš vuoidan lea šaddan bivnnut eará báikkiin , gos olbmot leat suovvan ja bivdán iežaset	vuoiddadit	feara movtge . #recip?
– Manan	vuoiddadit	, čurve son fáhkka . #recip
- Šaddat ieža gal	vuoiddadit	. #recip
Mun viežžalin fatnasis šluppoha ja dainna mun	vuoiddadin	dan dassái go leimme sihkkarat ahte dat ii šat eale . # + Com
An Account of the Sami
Ja go ruobbu njálbmi , dasa lea maiddá dálkkas cuoppu , go suinna deattaša ja	vuoiddada	. # + Com (Ani)
Science texts – 
Máhte guovttos [ DAHKKI + ČUOZÁHAT ]	vuoiddadeigga	 #recip
Son lávii	vuoiddadit	ja ruvvedit dainna , muhto ii noaidut : # + Com
Joo ja dainna dat lávii duotge Ánde	vuoiddadit	ja # + Com
