LEXICON ab ! this is the lexicon for abbrs that may or may not have a dot
ab-not-add-dot ;
ab-dot ;

!LEXICON ab-nodot ! This is the lexicon for abbrs that do not have dots.
!ab-not-add-dot;  ! But we are not interested in them, are we?



LEXICON ab-not-add-dot
 +ABBR:0 # ;  ! no period, that is.

LEXICON ab-dot ! This is the lexicon for abbrs that must have a period.
 +ABBR:%.0 # ; 

LEXICON ACR
+N+ABBR+Sg+Nom:%- NounRoot ; ! compounds!
+N+ABBR+Sg+Nom:%-@P.NeedNoun.ON@ VerbRoot ; ! compounds!
+N+ABBR+Sg+Nom: K ;
+N+ABBR+Sg+Gen:%:a K ;
+N+ABBR+Sg+Acc:%:a K ;
+N+ABBR+Sg+Loc:%:s K ;
+N+ABBR+Sg+Ill:%:i K ;
+N+ABBR+Sg+Kom:%:in K ;
+N+ABBR+Ess:%:n K ;


LEXICON Abbreviation

! Acronyms
! --------
!AAD:AAD3 ACR ;
!AAD:AAD3 ACR ;
!AMD:AMD3 ACR ;
!AT	ACR ;
Art	ACR ;
Bb	ACR ;
!BFD:BFD3 ACR ;
!BOF	ACR ;
!BRD:BRD3 ACR ;
!DIN:DIN3 ACR ;
!DN:DN3	 ACR ;
DnB:DnB3 ACR ;
DssnDssn3 	ACR ;
!EA	ACR ;
!EDB:EDB3 	ACR ;
!EDB:EDB3 ACR ;
!EO	ACR ;
!FID:FID3 ACR ;
!FIN:FIN3 ACR ;
!IBM:IBM3 ACR ;
!IKT	ACR ;
!ILO	ACR ;
!IT 	ACR ;
!KGB:KGB3 ACR ;
!KRD:KRD3 ACR ;
!KUD:KUD3 ACR ;
!MBD:MBD3	ACR ;
!MLM:MLM3 ACR ;
!MSN:MSN3 ACR ;
!MVD:MVD3 ACR ;
!NAC1	 ACR ;
!NHD:NHD3 ACR ;
!NBR	ACR ;
!NIBR 	ACR ;
!NJA	ACR ;
!NORAD:NORAD3 	ACR ;
!NOU 	ACR ;
!NSR	ACR ;
!NSB:NSB3 ACR ;
!NTB:NTB3 ACR ;
!NTH:NTH3 ACR ;
!NVE	 ACR ;
NgL	 ACR ;
!OED:OED3 ACR ;
!ON	ACR ;
!RG	ACR ;
!RU	ACR ;
Rp 	ACR ;
!SÁl	ACR ;
!SDD	ACR ;
!SHD:SHD3 ACR ;
!SI	ACR ;
!SND:SND3	ACR ;
!SOF	ACR ;
!SOU	ACR ;
!SSB:SSB3 	ACR ;
!SSSR ACR ;
!SUN:SUN3 ACR ;
SvJT	 ACR ;
UiB:UiB3 ACR ;


! Real abbreviations
! ------------------
!St% died1	ab ;
Chr  ab-dot ;
Eks  ab-dot ;
Gwh:Gwh3	ab ;
Innst		ab-dot ;
Od:Od3		ab-dot ;
Ot		ab-dot ;
Rt	ab-dot ;
St	ab-dot ;
Twh:Twh3	ab ;
UOB  	ab-dot ;
a 	ab-dot ;
adg 	ab "EDM N" ;
art	ab-dot ;
b 	ab-dot ;
buo	ab-dot ;
c 	ab-dot ;
c1 	ab-dot ;
cea	ab-dot ;
cit	ab-dot ;
cluo:c1uo3 	ab-dot ;
d 	ab-dot ;
d1 	ab-dot ;
dea	ab-dot ;
died1	ab-dot ;
dl 	ab ;
dok:dok3   ab-dot ;
e 	ab-dot ;
ea		ab;
edg:edg3 	ab-dot ;
ee 	ab-dot ;
f 	ab-dot ;
fak:fak3 	ab-dot ;
g 	ab-dot ;
gc1	ab-dot ;
ggl	ab-dot ;
gr	ab ;
h 	ab-dot ;
hg:hg3 	ab ;
hl 	ab ;
http:http3	ab ;
i 	ab-dot ;
j 	ab-dot ;
jed:jed3 	ab-dot ;
jna 	ab-dot ;
jne 	ab-dot ;
jnv	ab-dot ;
js	ab-dot ;
k 	ab-dot ;
km2:km%2	ab ;
kap:kap3	ab ;
kg 	ab ;
km	ab ;
koord:koord3		ab-dot ;
kr 	ab ;
l 	ab-dot ;
m 	ab-dot ;
meld:meld3 ab-dot ;	
mg:mg3 	ab ;
milj	ab-dot ;
mill	ab-dot ;
ml 	ab ;
n 	ab-dot ;
n1 	ab-dot ;
ng:ng3	ab ;
nr 	ab ;
o 	ab-dot ;
omd:omd3 	ab-dot ; ! no period, waiting for preprocessor
osd:osd3 	ab-dot ;
p 	ab-dot ;
prop	ab-dot ;
prp 	ab-dot ;
q 	ab-dot ;
r 	ab-dot ;
rev	ab-dot ;
ru	ab-dot ;
s 	ab-dot ;
s1 	ab-dot ;
st 	ab-dot ;
t 	ab-dot ;
t1 	ab-dot ;
u 	ab-dot ;
utg:utg3   ab-dot ;
v 	ab-dot ;
vrd:vrd3 	ab-dot ;
w 	ab-dot ;
x 	ab-dot ;
y 	ab-dot ;
z 	ab-dot ;
z1 	ab-dot ;
á 	ab-dot ;
ä 	ab-dot ;
å 	ab-dot ;
æ 	ab-dot ;
ö 	ab-dot ;
ø 	ab-dot ;


! <+c,+n> (+c,+n means clb if followed by capital,number)
! Abbreviations that end a sentence if 
! followed by letter in upper case or a number.
! These are typically nouns.

A.L	ab-dot ; 
A.S	ab-dot ; 
Eftf	ab-dot ;
Fr.P	ab-dot ; 
Fr.p	ab-dot ; 
Fuom	ab-dot ; 
Inc	ab-dot ;
K.S	ab-dot ; 
Kbh	ab-dot ; 
Kr.F	ab-dot ; 
Kr.f	ab-dot ;
Krf	ab ; 
Ltd:Ltd3	ab-dot ; 
N.A.F	ab-dot ; 
NB:NB3	ab ; 
O.S	ab-dot ; 
Sth	ab-dot ; 
adj	ab ; 
adm	ab-dot ; 
adv	ab ; 
arkeol	ab-dot ; 
avd	ab-dot ; 
bakt	ab-dot ; 
bea	ab-dot ;
bear	ab ;
bearj	ab ;
!bm	ab ; 
bot	ab-dot ; 
c1ál	ab-dot ; 
dis	ab-dot ;
!disp	ab-dot ; 
!do	ab-dot ; 
duo	ab-dot ;
duor	ab ;
e.e	ab-dot ; 
ee	ab-dot ;
eg:eg3	ab-dot ; 
!eng	ab ; 
en1g:en1g3	ab-dot ;
est	ab-dot ; 
etc	ab-dot ; 
!ev.luth	ab-dot ; 
fem	ab-dot ; 
fi	ab-dot ; 
fil	ab-dot ; 
!fl	ab-dot ; 
fon	ab-dot ; 
fuom:fuom3	ab-dot ; 
!fut	ab-dot ; 
gas	ab-dot ;
gask	ab ;
gen	ab ; 
gram:gram3	ab ; 
hell	ab-dot ; 
hist	ab-dot ; 
!hoh	ab ; 
holl	ab-dot ; 
háldd	ab-dot ; 
id:id3	ab-dot ; 
imp	ab ; 
imperat	ab-dot ; 
imperf	ab-dot ; 
inc	ab ; 
iness	ab-dot ; 
inf	ab ; 
!innb	ab ; 
instr	ab ; 
int	ab ; 
interj	ab-dot ; 
intr	ab-dot ; 
intrans	ab-dot ; 
inv	ab-dot ; 
jna	ab-dot ; 
jnv	ab-dot ; 
joatkkask	ab-dot ; 
jr	ab-dot ; 
kem	ab-dot ;
kgl.res	ab-dot ; 
km:km3	ab ; 
lat	ab-dot ; 
!lg	ab-dot ; 
!lim	ab-dot ; 
ln	ab-dot ; 
lst	ab-dot ; 
lstr	ab-dot ; 
ltd:ltd3	ab-dot ; 
láv	ab-dot ;
lávv	ab ; 
m.Kr	ab-dot ; 
ma	ab-dot ; 
mat	ab-dot ; 
med:med3	ab-dot ; 
!medl	ab ; 
miel	ab-dot ;
mil	ab ; 
min	ab-dot ; 
!mod	ab-dot ; 
mus	ab-dot ; 
mán	ab-dot ;
mánn	ab ;
ndf	ab-dot ; 
ned:ned3	ab-dot ; 
nl	ab-dot ; 
nn	ab-dot ; 
!nord	ab-dot ; 
nuor	ab-dot ;
o.Kr	ab-dot ; 
oKr	ab-dot ;
oss	ab-dot ; 
p.s	ab-dot ; 
pass	ab-dot ; 
pol	ab-dot ; 
!port	ab-dot ; 
pres	ab-dot ; 
pret	ab-dot ; 
pst	ab-dot ; 
q.e.d:q.e.d3	ab-dot ; 
refl	ab-dot ; 
reg:reg3	ab-dot ; 
repr	ab-dot ; 
rom	ab-dot ; 
ru	ab ; 
sek	ab ; 
sen	ab ; 
sg:sg3	ab ; 
sing:sing3	ab ;
sotn	ab ;
ss	ab-dot ; 
strl	ab ; 
tyrk	ab-dot ; 
ung:ung3	ab-dot ; 
v.v	ab-dot ; 
vuoss	ab ;
vgs	ab ;

! <-c,+n>
! Abbreviations that are only CLB 
! if followed by a number.
! Mainly titles.

! INTRANSNUMABBR [
1.aman	ab-dot ; 
Avd.dir	ab-dot ;
Bj	ab-dot ; 
Chr	ab-dot ; 
Dep	ab-dot ; 
Edv	ab-dot ; 
!Fr	ab-dot ;
H.K.H	ab-dot ; 
H.M	ab-dot ; 
Johs	ab-dot ;
Kr	ab-dot ; 
!Mme	ab-dot ; 
Mr	ab-dot ; 
Mrs	ab-dot ; 
Ms	ab-dot ; 
Seb:Seb3	ab-dot ; 
Siv.ark	ab-dot ;
aman	ab-dot ; 
ass	ab-dot ; 
avd.dir	ab-dot ; 
!avs	ab-dot ; 
!bet	ab-dot ; 
cand.mag:cand.mag3	ab-dot ; 
cand.oecon	ab-dot ; 
cand.philol	ab-dot ; 
cand.real	ab-dot ; 
cand.scient	ab-dot ; 
cand.theol	ab-dot ; 
cand:cand3	ab-dot ; 
dipl.ing:dipl.ing3	ab-dot ; 
dipl.ins	ab-dot ; 
dir	ab-dot ; 
dr.art	ab-dot ; 
dr.med:dr.med3	ab-dot ; 
dr.philos	ab-dot ; 
dr.theol	ab-dot ; 
dr	ab-dot ; 
eksp.hoavd:eksp.hoavd3	ab-dot ;
eksp.sj	ab-dot ; 
fil.tri	ab-dot ;
!fenr	ab-dot ; 
!gen.lt	ab-dot ; 
!genr.lt	ab-dot ; 
!genr	ab-dot ; 
h.r.adv	ab-dot ; 
hr	ab-dot ; 
!kapt	ab-dot ; 
!korp	ab-dot ; 
!korpr	ab-dot ; 
lekt	ab-dot ; 
lic	ab-dot ; 
ltn	ab-dot ; 
mag.art	ab-dot ; 
mag:mag3	ab-dot ; 
merc	ab-dot ; 
mr	ab-dot ; 
mrs	ab-dot ; 
ms	ab-dot ; 
!obl	ab-dot ; 
!oblt	ab-dot ; 
odont	ab-dot ; 
oecon	ab-dot ; 
!ordf	ab-dot ; 
ossod.dir	ab-dot ;
!overs	ab-dot ; 
pharm:pharm3	ab-dot ; 
philol	ab-dot ; 
polit	ab-dot ; 
prof	ab-dot ; 
!psychol	ab-dot ; 
psyk	ab-dot ; 
res.kap	ab-dot ; 
scient	ab-dot ; 
sekr	ab-dot ; 
!sgt	ab-dot ; 
siv.ark	ab-dot ; 
!sjt	ab-dot ; 
!stud.phil	ab-dot ; 
!stud.polit	ab-dot ; 
!stud.psych	ab-dot ; 
!stud.real	ab-dot ; 
!stud.scient	ab-dot ; 
!stud.theol	ab-dot ; 
!stud	ab-dot ; 
u.dir	ab-dot ; 
varaordf	ab-dot ; 
vit.ass	ab-dot ;


! <+c,-n>
! Abbreviations that only end a sentence
! if followed by an upper case letter,
! not when followed by a number.

! INTRANSCAPABBR [
1.Sam	ab-dot ; 
2.Sam	ab-dot ; 
Akersgt	ab-dot ; 
!B.innst.S.nr	ab-dot ; 
!Besl.L.nr	ab-dot ; 
!Besl.O.nr	ab-dot ; 
Co	ab-dot ; 
Dan	ab-dot ; 
Dok.nr	ab-dot ; 
!Dronningensgt	ab-dot ; 
!Eidsvollsgt	ab-dot ; 
!Elvegt	ab-dot ; 
!Hausmannsgt	ab-dot ; 
!Holmegt	ab-dot ; 
!Industrigt	ab-dot ; 
Innst.O.nr	ab-dot ; 
Innst.S.nr	ab-dot ; 
!Johansgt	ab-dot ; 
Josv	ab-dot ; 
!Kirkegt	ab-dot ; 
Kong:Kong3	ab-dot ; 
Kongensgt	ab-dot ; 
!Langgt	ab-dot ; 
Mark	ab-dot ; 
Matt	ab-dot ; 
Mos	ab-dot ; 
!Musegt	ab-dot ; 
Nkr	ab ; 
Ob	ab-dot ; 
!Olavsgt	ab-dot ; 
!Oslov	ab-dot ; 
Ot.prp.nr	ab-dot ; 
Paul	ab-dot ; 
!Prinsensgt	ab-dot ; 
Rom:Rom3	ab-dot ; 
!Rådhusgt	ab-dot ; 
Sam:Sam3	ab-dot ; 
!Slottsgt	ab-dot ; 
St.meld.nr	ab-dot ; 
St.prp.nr	ab-dot ; 
Storgt	ab-dot ; 
!Strandgt	ab-dot ; 
!Trondheimsv	ab-dot ; 
!a.D	ab-dot ; 
bd:bd3	ab-dot ;
borg:borg3	ab-dot ;
c1akc1	ab-dot ;
cuon1	ab-dot ;
!da	ab-dot ; 
geas	ab-dot ;
gnr	ab-dot ; 
golg:golg3	ab-dot ;
guov	ab-dot ;
it	ab-dot ; 
jnr	ab-dot ; 
juov	ab-dot ;
kap	ab-dot ; 
kr	ab-dot ; 
lnr	ab-dot ; 
ltd:ltd3	ab-dot ; 
ltr	ab-dot ; 
maks	ab-dot ; 
mar	ab-dot ; 
mask	ab-dot ; 
mies	ab-dot ;
mobiltlf	ab-dot ; 
njuk	ab ;
no	ab-dot ; 
nr	ab-dot ; 
od1d1j	ab-dot ;
p.b:p.b3	ab-dot ; 
pb:pb3	ab-dot ; 
pgf	ab-dot ; 
ru	ab ;
rv	ab-dot ; 
skáb:skáb3	ab-dot ;
suoi	ab ;


! dot% noStb.db
! <-c,-n>
! Abbreviations that never end a sentence, also if followed
! by a capital letter or a number.

! TRANSABBR 
Alm:Alm3	ab-dot ;
Dom:Dom3	ab-dot ;
Eftf	ab-dot ; 
Eks	ab-dot ; 
Esek	ab-dot ; 
!I.% N.% D	ab-dot ; 
!I.N.D	ab-dot ; 
!IL	ab-dot ; 
Innst	ab-dot ; 
Jer	ab-dot ; 
Joh	ab-dot ; 
!Lim	ab-dot ; 
Lt	ab-dot ; 
!Neh	ab-dot ; 
Od:Od3	ab-dot ; 
!Ot.% prp	ab-dot ; 
Ot.prp	ab-dot ; 
Ot	ab-dot ; 
!Pf	ab-dot ; 
!Pfg:Pfg3	ab-dot ; 
Rt	ab-dot ; 
Sd.% died1 ab-dot ;
Sd.% prp   ab-dot ;
St.% meld	ab-dot ; 
St.% prp	ab-dot ; 
St.meld:St.meld3	ab-dot ; 
St	ab-dot ; 
!Su	ab-dot ; 
!Sv	ab-dot ; 
Tel	ab-dot ; 
Tlf.nr	ab-dot ; 
Tlf	ab-dot ; 
Univ	ab-dot ; 
adr	ab-dot ; 
!afr	ab-dot ; 
akk	ab ; 
!alb	ab-dot ; 
alm	ab-dot ; 
am	ab-dot ; 
amer	ab-dot ; 
arab:arab3	ab-dot ; 
art	ab-dot ; 
!atomnr	ab-dot ; 
att	ab-dot ; 
!austr	ab-dot ; 
aut	ab-dot ; 
!balt	ab-dot ; 
!bet	ab-dot ; 
bib:bib3	ab-dot ; 
biol	ab-dot ; 
bnr	ab-dot ; 
!brig	ab-dot ; 
!brit.-am	ab-dot ; 
!brit.-austr	ab-dot ; 
brit	ab-dot ; 
bto	ab-dot ; 
buo	ab-dot ; 
c1uo	ab ;
ca	ab-dot ; 
cea	ab-dot ;
cf	ab-dot ; 
cit	ab-dot ;
co	ab-dot ; 
!d.% c	ab-dot ; 
!d.% d	ab-dot ; 
!d.% m	ab-dot ; 
!d.c	ab-dot ; 
!d.d	ab-dot ; 
!d.m	ab-dot ; 
!d.s	ab-dot ; 
dat	ab-dot ; 
dea	ab-dot ; 
dept	ab-dot ; 
died1	ab-dot ; 
dim:dim3	ab-dot ; 
div	ab-dot ; 
dkr	ab-dot ; 
dok	ab-dot ;
ds	ab-dot ; 
e.g:e.g3	ab-dot ; 
ee	ab-dot ; 
eftf	ab-dot ; 
!eks	ab-dot ; 
!ekskl	ab-dot ; 
!et	ab-dot ; 
etc	ab-dot ; 
eur	ab-dot ; 
ev	ab-dot ; 
evt	ab-dot ; 
!fec	ab-dot ; 
fig	ab-dot ; 
!fol	ab-dot ; 
ff	ab-dot ; 
fr	ab-dot ; 
gc1	ab-dot ; 
!geom	ab-dot ; 
ggl	ab-dot ;
gr	ab-dot ; 
!hebr	ab-dot ; 
!i.% e	ab-dot ; 
i.e	ab-dot ; 
ib:ib3	ab-dot ; 
ibid:ibid3	ab-dot ;
ill	ab-dot ; 
ind:ind3	ab-dot ; 
!indoeur	ab-dot ; 
inkl	ab-dot ; 
!j.d	ab-dot ; 
!j.e	ab-dot ; 
!j.s	ab-dot ; 
!jap	ab-dot ; 
jur	ab-dot ; 
jvf	ab-dot ; 
kat	ab-dot ; 
kgl	ab-dot ; 
kl	ab-dot ; 
km/t	ab-dot ; 
konj	ab-dot ; 
konst	ab-dot ; 
kst	ab-dot ; 
kurd	ab-dot ; 
kvm	ab ; 
!l.c	ab-dot ; 
!l.r.d	ab-dot ; 
!lab	ab-dot ; 
!lat.-gr	ab-dot ; 
!log	ab-dot ; 
!m.v	ab-dot ; 
m/sek	ab-dot ; 
mek	ab-dot ; 
!meld	ab-dot ; 
!mil.-tekn	ab-dot ; 
mill	ab-dot ; 
mrd:mrd3	ab-dot ; 
mv	ab-dot ; 
mva	ab-dot ; 
myt	ab-dot ; 
nkr	ab ; 
!no.-da	ab-dot ; 
nom:nom3	ab-dot ; 
nr	ab-dot ;
num:num3	ab-dot ; 
o.m.a	ab-dot ; 
o.m.d:o.m.d3	ab-dot ;
o.m:o.m3	ab-dot ; 
obj	ab-dot ; 
obs	ab-dot ; 
off	ab-dot ; 
!op.% cit	ab-dot ; 
op.cit	ab-dot ; 
op	ab-dot ; 
!ot.% prp	ab-dot ; 
ot.prp	ab-dot ; 
!p.% a	ab-dot ; 
!p.% m	ab-dot ; 
!p.% p.% m	ab-dot ; 
!p.% p	ab-dot ; 
!p.% r	ab-dot ; 
!p.a	ab-dot ; 
!p.m	ab-dot ; 
!p.p.m	ab-dot ; 
!p.p	ab-dot ; 
!p.r	ab-dot ; 
!p.t	ab-dot ; 
!pa	ab-dot ; 
!pf	ab-dot ; 
pkt	ab-dot ; 
pl	ab-dot ; 
pop	ab-dot ; 
!pr.pr	ab-dot ; 
pr	ab-dot ; 
prep	ab-dot ; 
pron	ab ; 
prp	ab-dot ; 
q.s	ab-dot ; 
red:red3	ab-dot ; 
rek	ab-dot ; 
rev	ab-dot ; 
!rum.-am	ab-dot ; 
!sc	ab-dot ; 
!sd	ab-dot ; 
!serbokr	ab-dot ; 
sign	ab-dot ; 
sovj	ab-dot ; 
!spes	ab-dot ; 
!sr	ab-dot ; 
!st.% meld	ab-dot ; 
!st.% meld	ab-dot ; 
!st.% prp	ab-dot ; 
st.meld	ab-dot ; 
st.prp	ab-dot ; 
st	ab-dot ; 
subj	ab-dot ; 
subst	ab-dot ; 
!sveits	ab-dot ; 
!Tekn	ab-dot ; 
Tel	ab-dot ; 
Tlf.Nr	ab-dot ; 
tlf	ab-dot ; 
vol	ab-dot ; 
vrd	ab-dot ;
vs	ab-dot ; 
v.r.d	ab-dot ;
