# typos.tx
# This file contains common typos and their corrections separated by
# <tab> character.
# leif<tab>feil
# Corrections that consist of two or more parts are not splitted
# further in the preprocessor, because there is no way of knowing
# whether the token is multipart expression or not.
# Beware of removing sentence delimiters (.!?) in correction, since
# they may indicate sentence boundaries.

 
!Beardus		Bearddus This is right, no CG! (TO)
!Sijtei	Sijtii this is Sijtei (TO)
!Statoilain	Statoiliin !these are right (TO)
!Statoilas	Statolis !these are right (TO)
!Walesas	Walesis THIS IS BERN (TO)
!báktelaccaŧ	báktelaccat XXX What is this?
!dahkamáš	dahkamaš !XXX What is this?
!rádjaguovlluid	rádjáguovlluid !This is ok
-earenoamážit	-earenoamážit
1heavvanit	heavvanit
1riikkačaohkkima	riikačoahkkima
35-ahkásaš	35-jahkásaš
9.luohkká	9. luohkká
Afrihkas	Afrihkás
Afriika	Afrihkká
Afriikii	Afrihkái
Afriikka	Afrihká
Aigi	Áigi
Aisttorn	Aistton
Altta	Álttá
Alttas	Álttás
Amerihkas	Amerihkás
Ameriihka	Amerihká
Ameriika	Amerihkká
Ameriikii	Amerihkái
Ameriikka	Amerihká
Ameriikkas	Amerihkás
Andersenas	Andersenis
Anárá	Anára
Artic	Arctic
Artihkkalistis	Artihkkalisttis
Asla	Aslat
Austalia	Australia
Avžžhuhusa	Ávžžuhusa
Aššenr	Áššenr
Ašši	Ášši
Bahkkejeaddjiŧ	Bahkkejeaddjit
Bajásčuožželeami	Bajásčuožžileami
Bajášaddan	Bajásšaddan	
Bajáššaddan	Bajásšaddan 
Banana	Banána
Bargiibellodaga	Bargiidbellodaga
Bargiibellodagas	Bargiidbellodagas
Bargiibellodgain	Bargiidbellodagain
Bargiidabellodaga	Bargiidbellodaga
Bargiidbeallodaga	Bargiidbellodaga
Bargiidbeallodat	Bargiidbellodat
Bargiidbelldoat	Bargiidbellodat
Bargiidbelloat	Bargiidbellodat
Bargiidbellodasa	Bargiidbellodaga
Bargiidbelloga	Bargiidbellodaga
Bargiidebellodagas	Bargiidbellodagas
Bargoja	Bargo- ja
Beaivvaš	Beaivváš
Bearráigeahččanja	Bearráigeahččan ja
Beatless	Beatles
Beazedievva	Beazedievvá
Beiavvášgieddi	Beaivvášgieddi
Bern-konvešuvnna	Bern-konvenšuvnna
Biebmobearraigeahču	Biebmobearráigeahču
Biebmostállama	Biepmostallama
Bieggomillorusttegiid	Bieggamillorusttegiid
Bihtta	Bihttá
Billeahtta	Bileahta
Billeahtta	Bileahtta
Birasgáhttendeparte-meanta	Birasgáhttendepartemeanta
Boadus	Boađus
Boarrasit	Boarrásit
Boazodaollolága	Boazodoallolága
Boazodoalliid	Boazodolliid
Boazodoalliide	Boazodolliide
Boazodoalliin	Boazodolliin
Boazodoallo	Boazodoallu
Boazodoalluhálddahus	Boazodoalluhálddáhus
Bodeajjus	Bodeajus
Bonjákasas	Bonjáhasas
Boraspirevátttisvuohta	Boraspireváttisvuohta
Boršejávrriŧ	Boršejávrrit
Buletjavri	Buletjávri
Buoddun	Buođđun
Buodu	Buođu
Bággolonistanvuoigatvuodavuoddu	Bággolonistanvuoigatvuođavuođđu
Báktevuoigatvuodaid	Báktevuoigatvuođaid
Báktevuoigatvuodat	Báktevuoigatvuođat
Bálvaleaddjiid	Bálvaleddjiid
Bálvaleaddjiide	Bálvaleddjiide
Bárgosadji	Bargosadji
CD-singel	CD-siŋgel
CD-singela	CD-siŋgela
CD:id		CD:aid
Cuovvovaccat	Čuovvovaččat
Cuovvovaš	Čuovvovaš
Cupai	Cupii
Cáhcealdásaŧ	Čáhcealdásat
Dadibahábut	Dađi bahábut
Darogiel	Dárogiel
Davvi-Kyprosas	Davvi-Kyprosis
Davviriikaid	Davviriikkaid
Davvirikkaid	Davviriikkaid
Dearvuođaiguin	Dearvvuođaiguin
Dearvuođat	Dearvvuođat
Deatnolaš	Deatnulaš
Dehálšamoš	Deháleamos
Depermeanta	Departemeanta
Diggeoasseváldiŧ	Diggeoasseváldit
Diggeálbmoŧ	Diggeálbmot
Dikšunja	Dikšun ja
Distaga	Disdaga
Distat	Disdat
Divvumaŧ	Divvumat
Doalliide	Dolliide
Duojárid	Duojáriid
Duolbmukeahttá	Duolmmokeahttá
Duođa-štuvvon	Duođaštuvvon
Dupmasa	Duopmása
Dutkosistis	Dutkosisttis
Dørun	Dørum
Dállodoalliid	Dállodolliid
Dásseárvo	Dásseárvu
Dássožii	Dassážii
Dásá		Dasa
Dávvi-Romssa	Davvi-Romssa
Eahpikeahttá	Eahpitkeahttá
Eahpitheahttá	Eahpitkeahttá
Eai oru 	Eai oro 
Ealisabeth	Elisabeth
Ealuigun	Ealuiguin
Ealáhusdoalliide	Ealáhusdolliide
Eanadalit	Eandaliid
Eanadoalliid	Eanadolliid
Eanadoalliide	Eanadolliide
Eanaeaiggáŧ	Eanaeaiggát
Eanaháldduŧ	Eanahálddut
Eanamiid	Eatnamiid
Eanandoalloálggahandoaimmaŧ	Eanandoalloálggahandoaimmat
Earenoamažit	Earenoamážit
Eiseváldit	Eiseválddit
Enenezer	Ebenezer
Ere-noamážit	Erenoamážit
Esti	Eesti
Evttohuš	Evttohus
FInnmárkku	Finnmárkku
Feastonuohtiin	Feastonuhtiin
Finnmrkku	Finnmárkku
Finnmrkkus	Finnmárkkus
Finnmrku	Finnmárku
Finnmáerkkuláhka	Finnmárkoláhka
Finnmárkkukommišuvnda	Finnmárkkukommišuvdna
Finnámrkku	Finnmárkku
Fuoskus	Fuoskkus
Fágalaccat	Fágalaččat
Fámuhuhttejuvvon	Fámuhuhttojuvvon
Fápmudanja	Fápmudan ja
Fápmuduš	Fápmudus
Gahcahatvuoigatvuodat	Gahcahatvuoigatvuođat
Gaoppašiid	Goappašiid
Garigasnjárgga	Gáregasnjárgga
Gaskái	Gaskii
Gaupai	Gaupii
Geahččalanja	Geahččalan ja
Geaidnodoaimmahaŧ	Geaidnodoaimmahat
Geaidnoossodaŧ	Geaidnoossodat
Geatnegáhttá	Geatnegahttá
Geavaheaddjiid	Geavaheddjiid
Gelbbolašvuođaloktenja	Gelbbolašvuođalokten ja
Genev:as	Genevas
Girjjálašvuoa	Girjjálašvuođa
Girkogeaidnui	Girkogeidnui
Girkonjár	Girkonjárgga
Gnddat	Gánddat
Goahtegerret	Goahtegearret
Goahttegearrega	Goahtegearrega
Goalmmat	Goalmmát
Goađáŧ	Goađát
Gorvvejávris	Gorvvejávrris
Greanpeace	Greenpeace
Greenpeaca	Greenpeace
Guhkesnárga	Guhkesnjárga
Guoladága	Guoládaga
Guoldaga	Guoládaga
Guollebiebmanealáhuš	Guollebiebmanealáhus
Guollebivdovuoigatvuoda	Guollebivdovuoigatvuođa
Guolásteaddjiid	Guolásteddjiid
Guovdageaidnui	Guovdageidnui
Guovdageainni	Guovdageainnu
Guovdageinnu	Guovdageainnu
Guovddášdoaimmadat	Guovddášdoaimmahat
Gurutbealde	Gurut bealde
Guvodageainnu	Guovdageainnu
Gáissáá	Gáissá		
Gáresavvon	Gárasavvon
Gáresavvona	Gárasavvona
Gáresavvonii	Gárasavvonii
Gáresavvoniin	Gárasavvoniin
Gáresavvonis	Gárasavvonis
Gárigasnjárgga	Gáregasnjárgga
Gáržžideamiŧ	Gáržžideamit
Gávpejeaddjiide	Gávpejeddjiide
Gávpenjuolggadusaŧ	Gávpenjuolggadusat
Haetta	Hætta
Historjjalaččat	Historjjálaččat
Huskyis	Huskys
Hábmiris	Hápmiris
Hálddahuslaccat	Hálddahuslaččat
Háldejeaddjiide	Háldejeddjiide
Hålogalandda	Hålogalanda
ILO-konvešuvnna	ILO-konvenšuvnna
Iaat	leat
Iassánan	lassánan
Iesjohtjoavku	Iešjotjoavku
Ii oru 	Ii oro 
Iige oru 	Iige oro 
Ikkáldas	Ikkaldas
Ikkáldasas	Ikkaldasas
InfoNuorra	Infonuorra
Infoja	Info- ja
Internáhttá	Internáhtta
Internšunála	Internašunála
IskkonMáhtte	Iskkon Máhtte
Issaht	Issát
Issat	Issát
Ivniiguin	Ivnniiguin
Jahkedieđahusastis	Jahkedieđáhusasttis
Jieastanstivra	Jienastanstivra
Jienasteaddjiid	Jienasteddjiid
Jienasteaddjiin	Jienasteddjiin
Joatkaskuvla	Joatkkaskuvla
Joatkaskuvllat	Joatkkaskuvllat
Joavkojođiheaddjide	Joavkojođiheddjiide
Johttisapmelaččaid	Johttisápmelaččaid
Jompanen	Jomppanen
Jorgaleaddjiid	Jorgaleddjiid
Joðiheaddjiid	Jođiheddjiid
Jođiheaddjiide	Jođiheddjiide
Juohkinkeahttá	Juogakeahttá
Juoigiid	Juigiid
Juornalisttaid	Journalisttaid
Jussaŧ	Jussá
Jáhpánis	Jáhpanis
Jámolaš-vuohta	Jámolašvuohta
Jønnson		Jønsson
Kalaalit	Kalaallit
Karášjoga	Káráššjoga
Kiinnás	Kiinás
Kommunistalaš	Kommunisttalaš
Konklusuvdna	Konklušuvdna
Kulturmuittuŧ	Kulturmuittut
Kárájoga	Kárášjoga
Kárájogas	Kárášjogas
Káršájoga	Kárášjoga
Káršájohka	Kárášjohka
Kárášjoh	Kárášjoga
Kárášjot	Kárášjoga
Kárášjoht	Kárášjoga
Lagabuid	Lagabui
Lagašvuohta	Lágášvuohta
Lansaman	Länsman
Lasihus	Lasáhus
Leavas	Leaváš
Leavnjas	Leavnnjas
Leavnjja	Leavnnja
Leavnjjas	Leavnnjas
Likká	Liikká
Linnjáfierpmádaŧ	Linnjáfierpmádat
Loabaga	Loabága
Loabakáiddi	Loabákáiddi
Loabat	Loabák
Logaldallamistis	Logaldallamisttis
Lotnolasealáhusdoalliin	Lotnolasealáhusdolliin
Lujvrri	Lujávrri
Lujvrris	Lujávrris
Lujávrres	Lujávrris
Lulli-Afrihkii	Lulli-Afrihkái
LuoktaMavas	Luokta-Mavas
Luopmánid	Luopmániid
Lágabui	lagabui
Mahtte	Máhtte
Maret	Máret
Maze	Máze
Meannudemit	Meannudeamit
Mearradoalloealáhuš	Mearradoalloealáhus
Mearradusat	Mearrádusat
Meksikoas	Meksikos
Mielkebuvttadeaddjiid	Mielkebuvttadeddjiid
Mietinen	Miettinen
Mieđihán	Mieđihan
Mihtádusvuoigavuohta	Mihtidanvuoigatvuohta
Miin	Min
Minaralutvikling	Mineralutvikling
Mineralutviklig	Mineralutvikling
Moskii		Moskái
Muorralčázádaŧ	Muorralčázádat
Murmanskas	Murmánskkas
Murmanskij Viestnik	Murmanskij Vestnik
Má.ga	Má.ga
Mátke	Mátkke
Mátkkoštuseláhus	Mátkkoštusealáhus
Mátta-Várjaga	Mátta-Várjjaga
Máŋimuš	Maŋimuš
Máŋŋá	Maŋŋá
Nakkelajervi	Näkkäläjärvi
Navuona		Návuona
Našuvnnalš	Našuvnnalaš
Neavttarat	Neavttárat
Niitovuopi	Niitovuopio
Niitošjoga	Niittošjoga
Niitošjogas	Niittošjogas
Niitošjogaš	Niittošjogaš
Niityvuopio	Nittyvuopio
Nittyvuopio	Niittyvuopio
Njealjját	Njealját
Njealljis	Njealjis
Njeallját	Njealját
Njuorggánii	Njuorggámii
Njuorggániin	Njuorggámiin
Njuovva mat	Njuovvamat
Njávddáma	Njávdáma
Nordlandda	Nordlándda
Norggaáittárdeaddji	Norggaáittardeaddji
Numeralaš	Numerálalaš
Nuorta Finnmárkku	Nuorta-Finnmárkku
Nuvtta	Nuvttá
Näkkeläjärvi	Näkkäläjärvi
Oaffarealliid	Oaffarelliid
Oahpaheaddjiid	Oahpaheddjiid
Oahpahusfálaldagid	Oahpahusfálaldagaid
Oahpahusja	Oahpahus- ja
Oahppiid	Ohppiid
Oahppofáláldagas	Oahppofálaldagas
Oaindnit	Oaidnit
Oamasvuona	Omasvuona
Oamasvuotna	Omasvuotna
Oanehaccat	Oanehaččat
Oanádusaŧ	Oanádusat
OarjeFinnmárkku	Oarje-Finnmárkku
Oassálasttit	Oassálastit
Ohcamistis	Ohcamisttis
Okasašmearrádusaid	Oktasašmearrádusaid
Oktibuot	Oktiibuot
Oktiibuoŧ	Oktiibuot
Ollesvirgeguolásteaddjiid	Ollesvirgeguolásteddjiid
Olymppia	Olympia
Organiserenamálle	Organiserenmálle
Orušii	Orošii
Oskuoahpahussi	Oskuoahpahussii
OslosSámediggi	Oslos Sámediggi
Ouiti	Outi
Ovdamearkkadihte	Ovdamearkka dihte
Ovdamearkkadihtii	Ovdamearkka dihtii
Ovdanahttin	Ovdánahttin
Ovdaneami	Ovdáneami
Ovddadusbellodat	Ovddádusbellodat
Ovddasvástideaddjiid	Ovddasvástideddjiid
Ovddidanfitnodagaindanne	Ovddidanfitnodagain danne
Ovdeliš	Ovdelis
Ozovuoigatvuoda	Ozovuoigatvuođa
Pariissas	Parisas
Parlamentaralaš	Parlamentáralaš
Parlamenttaralaš	Parlamentáralaš
Perualaččat	Perulaččat
Pirtiijärvi	Pirttijärvi
Pirtijävri	Pirttijärvi
Poktasašvuohta	oktasašvuohta
Politiat	Politiijat
Politiiját	Politiijat
Porche		Porsche
Porsánggu	Porsáŋggu
Porsángu	Porsáŋgu
Poršaŋggu	Porsáŋggu
Poršánggu	Porsáŋggu
Poršánggus	Porsáŋggus
Posáŋggus	Porsáŋggus
Prinsippa	Prinsihpa
Privahta	Priváhta
Prošeakteruđaid	Prošeaktaruđaid
Prošeeaktaáigodagas	Prošeaktaáigodagas
Pršaŋgui	Porsáŋgui
Pulvvaraparahtaid	Pulvvarapparáhtaid
Radiojietnasáddenja	Rádiojietnasádden ja
Ressurssat	Resurssat
Rievttimielde	Rievtti mielde
Riikkaidgaskassaš	Riikkaidgaskasaš
Rikkarevišuvnnas	Riikkarevišuvnnas
Roavesávvonis	Roavesavvonis
Roavvesávvonnis	Roavesavvonis
Romantalaš	Románttalaš
Romssaas	Romssas
Romssii	Romsii
Romálaš	romalaš
Roung	Ruong
Ruksesriebanaŧ	Ruksesriebanat
Rungu	Ruŋgu
Ruota	Ruoŧa
Ruotabealde	Ruoŧa bealde
Ruotas	Ruoŧas
Ruotta	Ruoŧŧa
Ruovttubáikematkkošteaddjiid	Ruovttubáikemátkkošteddjiid
Ruoŧabeal	Ruoŧa beale
Ruoŧta	Ruoŧŧa
Rusttegiida	Rusttegiidda
Ráddehus	Ráđđehus
Rádjarasttildeamiin	Rádjarasttildemiin
Ráissá	Ráissa
Ráissás	Ráissas
Ránskkas	Ránskkás
Rástegáissa	Rástegáissá
Rávdna	Rávdná
Rávisobmuidoahpahus	Rávisolbmuidoahpahus
Sabassen		Sabbasen
Saháovdamuniŧ	Saháovdamunit
SamSamTak:a	SamTak
SamSamtak:a	SamTak
Samediggi	Sámediggi
Samedikki	Sámedikki
Samedikkis	Sámedikkis
Sameradio	Sámeradio
Sami	Sámi
Samiid	Sámiid
Samtak:a	SamTak
Sara:i		Sarai
Sarrre		Sarre
Satnejođiheaddji	Sátnejođiheaddji
Sd.dieđ	St.dieđ
Seseana	Sesana
Seurajärvi-Kari	Seurujärvi Kari
Shcnitler	Schnitler
Sieiddajoga	Sieiddájoga
Sierrapedagogálaš	Sierrapedagogalaš
Sisilialáččat	Sisilialaččat
Skeanka	Skeaŋka
Skervvás	Skiervvás
Skoválaččaŧ	Skovalaččat
Sloahtta	Šloahtta
Smediggi	Sámediggi
Smedikki	Sámedikki
Soabbada	Soabada
Soaittan	Soaittán
Soaiála-	Sosiála-
Soapmasat	Soapmásat
Sobmy	Somby
Soffa	Soffá
Solbakken-Härkonen	Solbakken-Härkönen
Solbergga	Solberga
Solberggas	Solbergas
Somby:ii	Sombyi
Sorjjakehtes	Sorjjakeahtes
Sosialistalaš	Sosialisttalaš
Sosialkántuvra	Sosiálkántuvra
Sosiálistalaš	Sosialisttalaš
Sosiálisttalaš	Sosialisttalaš
Sosiálja	Sosiála ja
Spektrumas	Spektrumis
Spellemannprisena	Spellemanbálkkašumi
Stahta	Stáhta
Stahtaráđis	Stáhtaráđis
Statoilo	Statoil
Statskogs	Statsskoga
Stierdná	Stiertná
Stockolmmas	Stockholmmas
Stoltenbergga	Stoltenberga
Storradiggi	Stuoradiggi
Strandebarmma	Strandebarma
Strindberggas	Strindbergas
Studenttaid	Studeanttaid
Stuorabrittania	Stuorra-Británnia
Stuorraboazodoalliid	Stuorraboazodolliid
Stáhtá	Stáhta
Summa	Summá
Sunnje	Sutnje
Suodjaluskommánddo	Suodjaluskommando
Suoladeapmin	Suoládeapmin
Suorgihahtti	Suorggahahtti
Suoššjávre	Šuoššjávri
Sutno	Sudno
Suväjärvi	Syväjärvi
Sveits:as	Sveitsas
Sáb		SáB
Sáhtan	Sáhtán
Sáhtat	Sáhtát
Sáhtáná	Sáhtána
Sámdiggeráđđi	Sámediggeráđđi
Sámdiggi	Sámediggi
Sámedeggeválgga	Sámediggeválgga
Sámediggeráde	Sámediggeráđe
Sámediigi	Sámediggi
Sámediki	Sámedikki
Sámeguovllunjuolggadusaŧ	Sámeguovlonjuolggadusat
Sámiteahter	Sámi teáhter
Sápmeláččat	Sápmelaččat
Tamperees	Tamperes
Tapio:ii	Tapioi
Taxi	Tákse
Teahter	Teáhter
Tekhihkalas	Teknihkalaš
Tennesee	Tennessee
Thailandda	Thailanda
Thailanddas	Thailandas
Thommessen	Thommesen
Tingsret	Tingsrett
Troanddima	Troandima
Troanddimis	Troandimis
Unicoda-teknologiija	Unicode-teknologiija
Univeristehta	Universitehta
Universetehtas	Universitehtas
Universietehtii	Universitehtii
Universitehtta	Universitehta
Univesitehta	Universitehta
Unjargga	Unjárgga
Unversitehtastivra	Universitehtastivra
Unviersitehtas	Universitehtas
V.Igeland	V. Igeland
Valkeapaa	Valkeapää
Veakehit	Veahkehit
Vearidida	Veardida
Vearroguitečálliŧ	Vearroguitečállit
Vedhuggnes		Vedhugnes
Viedokonferánsarusttegat	Videokonferánsarusttegat
Vihkkedallamistis	Vihkkedallamisttis
Viidasit	Viidásit
Viiđát	Viđát
Virgáibidjámis	Virgáibidjamis
VBL lahttut	VBL lahtut
Vuoofágalohkama	Vuođđofágalohkama
Vuordetmeahttun	Vuordemeahttun
Vuorkkagovva	Vuorkkágovva
Vuorká-Dávvviriin	Vuorká-Dávviriin
Vuorká-dávviriid	Vuorká-Dávviriid
Vuostebealiŧ	Vuostebealit
Vuotnaguolásteaddjiid	Vuotnaguolásteddjiid
Vuovdemassii	Vuovdimassii
Váiddakeahttá	Váiddekeahttá
Váillevaš	Váilevaš
Váilojit	Váilot
Válaštallan	Valáštallan
Váldoáššálaccat	Váldoáššálaččat
Vástideaddjiide	Vástideddjiide
Yle:s	Yles
Yorkis	Yorkas
Állet geahča	Allet geahča
ŦJeagge	Jeagge
ŦSančuariŧ	Sančuary
abstrakta	abstrákta
addan	addán
adjanivččii	ádjánivččii
adnojuvvoi	adnojuvvui
advokahtta	advokáhtta
aht	ahte
ahte dákku veadjá	ahte dákko veadjá
aibbas	áibbas
aiddoliđđon	aiddo liđđon
aiddostahttiŧ	aiddostahttit
aiggo	áiggo
aigot	áigot
aigu	áigu
ainjuo oru 	ainjuo oro 
aitosaccat	aitosaččat
aj	ja
aktiivalaččat	aktiivvalaččat
aktivisttat	aktivistat
aktoealihaŧ	aktoealihat
aktoráđálaččaŧ	aktoráđálaččat
akšuvdadoaluin	akšuvdnadoaluin
alaš	aláš
alddineaset	alddiineaset
alfabeahtalaš	alfabehtalaš
alggahan	álggahan
allagealddamásttaŧ	allagealddamásttat
allaskuvllaŧ	allaskuvllat
almmai	almmái
almmolaccat	almmolaččat
almmuhuvvoi	almmuhuvvui
alo	álo
amadadju	ámadadju
amadaju	ámadaju
amadajuid	ámadajuid
amadajut	ámadajut	
amalgama	amalgáma
ambasadevra	ambassadevra
amerihkalaš	amerihkálaš
amerihkkálaš	amerihkálaš
ammatsuorgái	ámmátsuorgái
andagassii	ándagassii
anehahtti	anihahtti
apeallas	kapeallas
apparahta	apparáhta
apparahtta	apparáhtta
arenáin	arenain
arenát	arenat
arktitektuvrras	arkitektuvrras
arrat	árrat
artihkalistis	artihkkalisttis
artihkkalistis	artihkkalisttis
arvvostallat	árvvoštallat
arvvoštallat	árvvoštallat
asahit	ásahit
atnojit	adnojit
avisii	áviisii
avžžuhat	ávžžuhat
aŋke	aŋkke
badjelbáza	badjebáza
badjelmearálaccat	badjelmearálaččat
badjeolbuid	badjeolbmuid
badjerádjemeariŧ	badjerádjemearit
badjil	badjel
badjilmearalaccat	badjelmearálaččat
bahabut	bahábut
bahánihkkanat	baháneahkkánat
baiccá	baicca
bajabealde	bajábealde
bajas	bajás
bajemus	bajimus
bajemusas	bajimusas
bajemussii	bajimussii
bajásčuožželeami	bajásčuožžileami
balddalagaid	bálddalagaid
balla	ballá
balleahta	baleahta
balvalusaid	bálvalusaid
balá	bala
banana	banána
barga	bargá
barggiidde	bargiide
barggiide	bargiide
barggit	bargit
bargguigun	bargguiguin
bargiidde	bargiide
bargohárjaneami	bargohárjáneami
bargohárjaneapmi	bargohárjáneapmi
bargoja	bargo- ja
bargomátkiid	bargomátkkiid
bargomátkiin	bargomátkkiin
bargoáhki	bargoahki
bc	bc.
bdii	bođii
beahtala	biehttala
beaivit	beaivvit
beaivvaduvvon	beaiváduvvon
beaivvalaččat	beaivválaččat
beaivves	beaivvis
beaivvirádjai	beaivvi rádjái
beaivváduvvon	beaiváduvvon
beaiváš	beaivváš
beakkanis	beakkánis
beakkáneammos	beakkáneamos
bealatkeahttá	bealatkeahttá
bealdi	bealde
bealgoalmmat	bealgoalmmát
bealjjehis	bealjehis
beallefinálai	beallefinálii
beallemuttos	beallemuttus
bealljeheamit	bealjeheamit
bealátkeahttá	bealatkeahttá
bearoškeahttá	beroškeahttá
bearraŧ	bearrat
bearražis	bearrašis
bearráigeahččanja	bearráigeahččan ja
bearráša	bearraša
bearrášiid	bearrašiid
bearrášiin	bearrašiin
beassa	beassá
beassaimet	beasaimet
beassašbeaivi	beassášbeaivi
beastiŧ	beastit
beavttalmahttit	beavttálmahttit
beaškkala	beaškala
behttala	biehttala
behttalit	biehttalit
bellodatnjágadeaddjiid	bellodatnjágadeddjiid
beroškeahtta	beroškeahttá
berošteaddjiid	berošteddjiid
berošteaddjiide	berošteddjiide
beroštisgoahtit	beroštišgoahtit
berreivčče	berrešedje
berresivčče	berrešedje
berrešivčče	berrešedje
berrešivččii	berrešii
berrešivččiigo	berrešiigo
berrrešivččiigo	berrešiigo
bessat	beassat
bevlamáđiijaid	bievlamáđijaid
biddjat	bidjat
bidja	bidjá
bidju	biedju
bidján	bidjan
bidját	bidjat
biehtala	biehttala
biehtalkeahteš	biehtalkeahtes
bierggastiŧ	bierggastit
bifila	bifiila
bihta	bihtá
bihtas	bihtás
biilavuodjit	biilavuoddjit
bilikeahttá	bilitkeahttá
billeahta	bileahta
billeahtaid	bileahtaid
billeahtta	bileahtta
biologijjii	biologiijii
birasgealbofierpmádaŧ	birasgealbofierpmádat
birasgáhttenkampanja	birasgáhttenkampánja
biret	biiret
birrasistis	birrasisttis
biru	biro
bisanan	bisánan
bisanit	bisánit
bistii	bisttii
bisttáhallaŧ	bisttáhallat
bisániii	bisánii
bisáná	bisána
bivdimiš	bivdimis
bivdinja	bivdin ja
bivdoskihpar	bivdoskihpár
bivdoskihppáris	bivdoskihpáris
bivdovuoigatvuoda	bivdovuoigatvuođa
bivttasdiŋggáid	bivttasdiŋggaid
boahkana	boahkána
boahta	boahtá
boahtan	boahtán
boahte	boahtte
boahtegohte	boahtigohte
boahtevaš	boahttevaš
boahteáiggis	boahtteáiggis
boahtoja	boahto- ja
boahtteváš	boahttevaš
boaittobealođastusaŧ	boaittobealođaštusat
boareš	boares
boarrasamos	boarrásamos
boarraseamos	boarráseamos
boarraseappot	boarráseappot
boarraset	boarráset
boarrasit	boarrásit
boarrasut	boarrásut
boastaboksái	boastaboksii
boasttogáldduid	boasttogálduid
boasttovuođaid	boasttuvuođaid
boasttut	boastut
boasttuvuoda	boasttuvuođa
boastu		boasttu
boatkkakeahttá	boatkkekeahttá
boazo	boazu
boazodoalliid	boazodolliid
boazodoalliide	boazodolliide
boazodoalliin	boazodolliin
boazodoallo	boazodoallu
boazodoalloja	boazodoallo- ja
boazodoallokántuvra	boazodoallokantuvra
boazodoallui	boazodollui
boazodutkkit	boazodutkit
boazoguođohanvuoigavuohta	guođohanvuoigatvuohta
boazoguvlluin	boazoguovlluin
boazoi		bohccui
boazoÂ­doalliid	boazodolliid
boazudoalliid	boazodolliid
boazudoallu	boazodoallu
boazudoalu	boazodoalu
boazudollui	boazodollui
boađašii	boađášii
boađusárvvoštallamisastis	boađusárvvoštallamisttis
bodii	bođii
bohccoid	bohccuid
bohccu	bohcco
bohcidahttá	bohciidahttá
bohcidan	bohciidan
bohcidit	bohciidit
bohtosiidhaga	bohtosiid haga
bohččuiguin	bohccuiguin
boraspiirid	boraspiriid
borramusa	borramuša
borrádit	boradit
bosada	bosáda
botnái	bodnái
bronšša	bronssa
brošjyrain	brošyrain
budšeahta	bušeahta
buhtadankeahttá	buhtatkeahttá
bukta	buktá
buoddun	buođđun
buodu	buođu
buogustahttá	boagustahttá
buohcciid	buhcciid
buohccuvuođa	buohcuvuođa
buohtalága	buohtalaga
buorebot	buorebut
buorideamiŧ	buorideamit
buorranivččii	buorránivččii
buorremus	buoremus
buvttadeaddjiid	buvttadeddjiid
buvttadeaddjiin	buvttadeddjiin
bušeaha		bušeahta
bušehtas	bušeahtas
bádjel	badjel
bággobargogeatnegasaŧ	bággobargogeatnegasat
bággolonistanláhkavuodu	bággolonistanláhkavuođu
bággolonistanvuoduŧ	bággolonistanvuođut
báhkkada	báhkada
báhkkodeamiin	báhkkodemiin
báhpaidhaga	báhpaid haga
báhča	báhčá
báhčimiš	báhčimis
báicca	baicca
báicce	baicce
báicco	baicca
báicco	baicce
báikalaš	báikkálaš
báikiin	báikkiin
báikkaid	baikkaid
báikkat	baikkat
báikkálaccat	báikkálaččat
báikkáláš	báikkálaš
bájimuš	bajimuš
báktefágalaccat	báktefágalaččat
báktevuoigatvuodaid	báktevuoigatvuođaid
báktevuoigatvuodaide	báktevuoigatvuođaide
báktevuoigatvuodat	báktevuoigatvuođat
bálddalágaid	bálddalagaid
bálddasteahttit	bálddastahttit
bálddonas	balddonas
bálkašumi	bálkkašumi
bálkašupmi	bálkkašupmi
bálkkášumi	bálkkašumi
bálkkášupmi	bálkkašupmi
bálkášumi	bálkkašumi
bálkášupmi	bálkkašupmi
bálvalanbiret	bálvalanbiiret
bálvaleddji	bálvaleaddji
bárgiidbellodat	bargiidbellodat
bárta	barta
bártnime	bárdnáme
bártta	bartta
bárttaid	barttaid
bázáhusat	bázahusat
cada	čađa
cakcat	čakčat
cand.scient	cand.scient.
cealka	cealkka
cealkamuša	cealkámuša
cealkkekeahteš	cealkkekeahtes
cealkká	cealká
cearddalaccat	čearddalaččat
celkojuvvoi	celkojuvvui
celkosiida	celkosiidda
celká	cealká
cehkkiid	cehkiid
cieggadiŧ	cieggadit
ciekŋalat	čiekŋalat
cielga		čielga
coaganaŧ	coaganat
cohkodaŧ	cohkodat
cujuheami	čujuheami
cujuhit	čujuhit
cuoggá	čuoggá
cuoggás	čuoggás
cuohcá	čuohcá
cuovvovacca	čuovvovačča
cuovvovaš	čuovvovaš
cup:a	cupa
cup:s	cupas
cáhcecoahkuŧ	čáhcecoahkut
cáhcejodu	čáhcejođu
cálalaccat	čálalaččat
cállon		čállon
cázádatvuoigatvuodaid	čázádatvuoigatvuođaid
cázádatvuoigatvuodain	čázádatvuoigatvuođain
dadja	dadjá
dadján	dadjan
dafus	dáfus
dahkkun	dahkkon
dahkká	dahká
dahttot	dáhttot
dakkr	dakkár
dallán	dalán
dandihte	dan dihte
dappe	dáppe
darbbaš	dárbbaš
darbbašit	dárbbašit
darbbuid	dárbbuid
darbu	dárbu
darvanan	darvánan
dassažii	dassážii
dassožii	dassážii
dastanaga	dasttánaga
dasá	dasa
davas	davás
davimuš	davimus
davvi-norgalaččaid	davvinorgalaččaid
davvi-norggalaš	davvinorggalaš
davviameriikká	Davvi-Amerihká
davviriikaid	davviriikkaid
davviriikalaš	davviriikkalaš
dađimielde	dađi mielde
dađisdaga	dađistaga
daža	dáža
deadduha	deattuha
deahalaš	dehálaš
deahálaš	dehálaš
deaivadii	deaivvadii
deaivasa	deaivása
deaivvida	deaivida
dearvuođaid	dearvvuođaid
dearvuođat	dearvvuođat
deatnolačča	deatnulačča
deatnolaš	deatnulaš
deavda	deavdá
deađalaš	dieđalaš
dehálaccat	dehálaččat
dehálas	dehálaš
deháleammos	deháleamos
deháleamoš	deháleamos
departemeabnta	departemeanta
dervvašvuođa-	dearvvašvuođa-
deŧaleabbo	deháleabbo
deŧaleabbon	deháleabbon
didjide	didjiide
diede	dieđe
diediha	dieđiha
diedihangeatnegasaŧ	dieđihangeatnegasat
dieduid	dieđuid
diedut	dieđut
diehta	diehtá
diehtelasat	diehttelasat
diehtocáluš	diehtočálus
diehtoja	diehto- ja
diehttávassii	diehttavassii
dienláhkái	dien láhkái
dienna		dieinna
dieut		dieđut
dievasčpahkkimis	dievasčoahkkimis
dievasđoahkkimiin	dievasčoahkkimiin
dievaščoahkkin	dievasčoahkkin
dievdo		dievdu
dievusge	dieđusge
dieđia		dieđiha
dieđálaš	dieđalaš
dieđálašvuođa	dieđalašvuođa
diftonga	diftoŋga
diggut		diggot
diggut	diggot
digástallá	digaštallá
digáštallama	digaštallama
digáštallamii	digaštallamii
digáštallamiidda	digaštallamiidda
digáštallan	digaštallan
digáštallat	digaštallat
digáštallá	digaštallá
dihtomielalaččaŧ	dihtomielalaččat
diibma	diibmá
diibmabeali	diibmobeali
diimma	diimmá
diinet	dinet
diinešeaigga	dinešeigga
dikšunja	dikšun ja
dikšunrusttegiida	dikšunrusttegiidda
dilálašvuodaid	dilálašvuođaid
dilálášvuođaid	dilálašvuođaid
dilálášvuođain	dilálašvuođain
distaga	disdaga
distat	disdat
divrriguin	divrriiguin
divššohasbearráigeahččiin	divššohasbearráigehččiin
doahttalkeahtesvuođaŧ	doahttalkeahtesvuođat
doaibmabiddjo-eavttuhussii	doaibmabidjoevttohussii
doaibmabiddjoguovllu	doaibmabidjoguovllu
doaibmabidjuevttohusaid	doaibmabidjoevttohusaid
doaibmabidjuin	doaibmabijuin
doaibmaekonomalaččaŧ	doaibmaekonomalaččat
doaibmaguovlustis	doaibmaguovllustis
doaibmaprofilaid	doaibmaprofiillaid
doaimmadeaset	doaimmaideaset
doaimmaheaddjiid	doaimmaheddjiid
doaimmaheaddjiide	doaimmaheddjiide
doaimmaide olgon	doaimmaide olgun
doaivvon	doaivvun
doakára		doaktára
doalahiŧ	doalahit
doalla	doallá
doalliid	dolliid
doalliide	dolliide
doarján	doarjjan
doarvai	doarvái
doarvvái	doarvái
doavtter	doavttir
doavttergrada	doavttergráda
dohkalaččat	dohkálaččat
dohkalaš	dohkálaš
dohkalašvuođa	dohkálašvuođa
dohkalažžan	dohkálažžan
dohkeheapmin	dohkkeheapmin
dohkehit	dohkkehit
dohkka		dohkká
dohkkalaš	dohkálaš
dohkkehuvvonš	dohkkehuvvon
dohkkenit	dohkkehit
dohkkáš	dohkáš
dohkálaccat	dohkálaččat
dokumenterenja	dokumenteren ja
dollojuvvoi	dollojuvvui
dorkkasealliid	dorkkaselliid
doudji		duodji
dovdaŧ	dovdat
dovdduseamos	dovdoseamos
dovdduš	dovddus
dppe	dáppe
drama	drámá
drbbuid	dárbbuid
dráma	drámá
drámahtalaš	dramáhtalaš
drámas	drámás
duhat	duhát
duhkkáid	duhkáid
duhkorasvovda	duhkorasvovdna
duhtivaččat	duhtávaččat
duhttadit	duhtadit
dulvegeahpedanrustteŧ	dulvegeahpidanrusttet
dunnje	dutnje
duogabealde	duogábealde
duogaš	duogáš
duohpaga	doahpaga
duohtandagakeahteš	duohtandagakeahtes
duoljji	duolji
duolloja	duollo- ja
duolluin	dulluin
duopmogirjjid	duopmogirjjiid
duorasdaga	duorastaga
duosta	duostta
duođa-štallamiidda	duođaštallamiidda
duođaláš	duođalaš
duođastivččii	duođaštivččii
duođastusastis	duođaštusastis
duođaštiŧ	duođaštit
duođá-štallamiidda	duođaštallamiidda
duođáštusávdnasaŧ	duođaštusávdnasat
dupmehallon	dubmehallon
dupmejit	dubmejit
dupmen	dubmen
dupmet	dubmet
dutakmiid	dutkamiid
duthavaš	duhtavaš
dutkamistis	dutkamisttis
dutkanprofilas	dutkanprofiillas
dutkanrievttiš	dutkanrievttis
dutkansurggide	dutkansurggiide
dutkkit		dutkit
dutkosistis	dutkosisttis
dutno	dudno
duššadanja	duššadan ja
dábalaččat	dábálaččat
dábalaš	dábálaš
dábálaccat	dábálaččat
dáhje	dahje
dáhpáhuvva	dáhpáhuvvá
dáhpáhuvvai	dáhpáhuvai
dáhtušii	dáhtošii
dáida	dáidda
dáidalaččat	dáiddalaččat
dáidarat	dáidárat
dáiddalaš	dáiddalaš
dáiddarat	dáiddárat
dáiddariid	dáiddáriid
dáidguin	dáiguin
dáktegávdnosaŧ	dáktegávdnosat
dálkkudanvuogit	dálkkodanvuogit
dálkkudit	dálkkodit
dállastiŧ	dállastit
dállobiireseŧ	dállobiireset
dálloluottaŧ	dálloluottat
dálločomaŧ	dálločomat
dálveguohtonÂ­eatnamiid	dálveguohtoneatnamiid
dálveÂ­guohtonÂ­eatnamiid	dálveguohtoneatnamiid
dárbbaslaš	dárbbašlaš
dárbbašlaccat	dárbbašlaččat
dárbbašlas	dárbbašlaš
dárbbáš	dárbbaš
dárbbášit	dárbbašit
dárkilastitahte	dárkilastit ahte
dárkkistiŧ	dárkkistit
dárogielja	dárogiel ja
dároja	dáro- ja
dássasaš	dássásaš
dássažii	dassážii
dássediŧ	dássedit
dássivuohta	dássitvuohta
dássivuođa	dássitvuođa
dássožii	dássážii
dásá	dása
dátabáŋku	databáŋku
dátabáŋkku	databáŋkku
dávja	dávjá
dáčč	dáčča
dáččaŧ	dáččat
dáččá	dáčča
dáđistaga	dađistaga
dåsis	dásis
eahpedahtti	eahpidahtti
eahpeozolaccat	eahpeozolaččat
eahpesihkár	eahpesihkar
eahpikeahttá	eahpitkeahttá
eahppedahtti	eahpidahtti
eahppidahtti	eahpidahtti
eai áiggu	eai áiggo
eai oru 	eai oro 
eai oruge	eai oroge
eai sii oačču	eai sii oaččo
eaiggadiidda	eaiggádiidda
eaiggádušša	eaiggáduššá
eaiggáduššamiš	eaiggáduššamis
eaiggáduššanháldduŧ	eaiggáduššanhálddut
eaiggáduššanvuoigatvuoda	eaiggáduššanvuoigatvuođa
eaiggáduššanvuoigatvuodas	eaiggáduššanvuoigatvuođas
eaiggáduššanvuoigatvuođ	eaiggáduššanvuoigatvuođa
eaiggáduššanvuoigavuohta	eaiggáduššanvuoigatvuohta
eaiggátmearkkaŧ	eaiggátmearkkat
eaigáda	eaiggáda
eaktodáhtolaccat	eaktodáhtolaččat
ealgabivdiguin		ealgabivdiiguin
eallemin	eallimin
ealliid	elliid
ealliide	elliide
ealáhusdoalliid	ealáhusdolliid
ealáhusdoalliide	ealáhusdolliide
ealáhusovdáneamiin	ealáhusovdánemiin
ealáhusovvdidanbarggus	ealáhusovddidanbarggus
ealáhussoahpámuša	ealáhussoahpamuša
ealáhusvisttid	ealáhusvisttiid
ealásusovddideami	ealáhusovddideami
eambogiid	eambbogiid
eambosiid	eambbosiid
eamiálbmogjid	eamiálbmogiid
eanadatlágaŧ	eanadatlágat
eanadatsuodjalanguovlluŧ	eanadatsuodjalanguovllut
eanadivatsisaboađuŧ	eanadivatsisaboađut
eanadoalliid	eanadolliid
eanadoalliide	eanadolliide
eanadoallo	eanadoallu
eanaeaiggáduššanvuoigatvuodat	eanaeaiggáduššanvuoigatvuođat
eanaoamasteaddjiide	eanaoamasteddjiide
eanavearuhuš	eanavearuhus
eanavuoigatvuodaid	eanavuoigatvuođaid
eandalit	eandaliid
eanetbealaŧ	eanetbealat
eara	eará
earaláhkái	earáláhkái
earasajis	eará sajis
earat	earát
earemoamážit	earenoamážit
earenoamaš	earenoamáš
earrálágan	earálágan
earáhuhttimiida	earáhuhttimiidda
earálagan	earálágan
earálagan	earálágán
earálahkai	eará láhkai
earánoamážit	earenoamážit
earánomáš	earenoamáš
easkká	easkka
easttagiid	eastagiid
eatnamiiidda	eatnamiidda
eatnamistis	eatnamisttis
eatnanvulošiid	eatnanvuložiid
eatnánhearrá	eananhearrá
eavttoheaddjiide	evttoheddjiide
eavttohusa	evttohusa
eavttuguin	eavttuiguin
eavttuidhaga	eavttuid haga
eavttuŧ	eavttut
eisevaldiiguin	eiseválddiiguin
eiseváldiid	eiseválddiid
eiseváldiide	eiseválddiide
eiseváldiiguin	eiseválddiiguin
eiseváldiin	eiseválddiin
eiseváldit	eiseválddit
eknomomálaš	ekonomalaš
ekonoamalaččat	ekonomalaččat
ekonoamalaš	ekonomalaš
ekonomia	ekonomiija
ekonomlaš	ekonomalaš
el-fábmolinjá	el-fápmolinjá
empiiralaš	empiralaš
energia		energiija
energias	energiijas
ereanoamážit	erenoamážit
eremoamáš	erenoamáš
erenoamáþit	erenoamážit
erenoamš	erenoamáš
erenoaámaš	erenoamáš
erenoemážit	erenoamážit
erenomoamážit	erenoamážit
erenoámaš	erenoamáš
erenoámažit	erenoamážit
ereonamážit	erenoamážit
ereonmáš	erenoamáš
eretfárrejeaddjiide	eretfárrejeddjiide
ereŧ	eret
ernoamáš	erenoamáš
errnoamážit	erenoamážit
etnomusihkakguovddáža	etnomusihkkaguovddáža
etnálaš	etnalaš
eurohpa	Eurohpá
eurohpá	Eurohpá
evtohusain	evttohusain
evtohusat	evttohusat
evttokas	evttohas
eárá	eará
eŋgalsgiella	eŋgelasgiella
fahkkestaga	fáhkkestaga
faláldaga	fálaldaga
faláldat	fálaldat
fanasgieddelaš	fanasgieddilaš
farggamušat	farggamusat
fasta	fásta
favllis	fávllis
feará	feara
feastonuohtiin	feastonuhtiin
feministalaš	feministtalaš
fertešivčče	fertešedje
fertešivččii	fertešii
festivalas	festiválas
festiválai	festiválii
fidnodagain	fitnodagain
fidnodagat	fitnodagat
fidnoja	fidno- ja
fierbmebivdovuoigatvuoda	fierbmebivdovuoigatvuođa
fierbmeráddjenguovlluŧ	fierbmeráddjenguovllut
fievrredanbargiŧ	fievrredanbargit
fievrredeaddjiide	fievrrededdjiide
fiidnamus	fiidnámus
filka	fylka
filkii	fylkii
filkka	fylkka
filkkaid	fylkkaid
filkkaide	fylkkaide
filkkaiguin	fylkkaiguin
filkkain	fylkkain
filkkas	fylkkas
filkkat	fylkkat
fillešivčče	fillešedje
finansdepartemanta	finansdepartemeanta
finnmárkoláhkaárvalusa	Finnmárkoláhkaárvalusa
fiolehtta		fioleahtta
fitnemis	fidnemis
formálitehtat	formalitehtat
forumas	forumis
friiddja	friddja
friddjavuođareivveŧ	friddjavuođareivvet
fránskalaš	fránskkalaš
fulkkiguin	fulkkiiguin
fuobman	fuobmán
fuobmat	fuobmát
fuolahanja	fuolahan ja
fuolahusjođiheaddjiid	fuolahusjođiheddjiid
fuolalaccaŧ	fuolalaččat
fuomaš	fuomáš
fuomašan	fuomášan
fuomašit	fuomásit
fuomašuhttá	fuomášuhttá
fuopmá	fuobmá
fuopmái	fuobmái
fuopmán	fuobmán
fuopmát	fuobmát
fuođđoriggodagaŧ	fuođđoriggodagat
fysioterapijja	fysioterapiija
fágagirjjalašvuohta	fágagirjjálašvuohta
fágalaccat	fágalaččat
fágaovdánahttinja	fágaovdánahttin ja
fáladaga	fálaldaga
fálla	fállá
fáláldagaid	fálaldagaid
fáláldat	fálaldat
fámuhuhtui	fámuhuhttui
fápmudanja	fápmudan ja
fárggamusat	farggamusat
fárrolágaid	fárrolagaid
fávdnadit	fávdnádit
fávorihtta	favorihtta
fáŋgabargiidde	fáŋgabargiide
gahcahatvuoigatvuodaid	gahčahatvuoigatvuođaid
gahcahatvuoigatvuodain	gahcahatvuoigatvuođain
gahcahatvuoigatvuodat	gahcahatvuoigatvuođat
galduid	gálduid
galga	galgá
galggaigga	galggaiga
galggašeaigga	galggašeigga
galggašivčče	galggašii
galggá	galgga
galggá	galgá
galggášii	galggašii
garraseamosit	garrasepmosit
garvvis	gárvvis
garžžideapmin	gáržžideapmin
gaskaboddosaccat	gaskaboddosaččat
gaskaboddosaččaŧ	gaskaboddosaččat
gaskarievttiš	gaskarievttis
gaskariikalaš	gaskariikkalaš
gaskavahko	gaskavahku
gaup	Gaup
gavnnaheigga	gávnnaheigga
gavno	gávdno
geadgelágit	geađgelágit
geagrafálaččat	geográfalaččat
geahccat	geahččat
geahcá		geahča
geahčča	geahččá
geahččalanja	geahččalan ja
geahččen	geahčen
geahččiid	gehččiid
geahččiide	gehččiide
gearpmáš	gearpmaš
geatnogahtton	geatnegahtton
geavaga		geavaha
geavahandilálašvuođaŧ	geavahandilálašvuođat
geavahanvuoigatvuoda	geavahanvuoigatvuođa
geavahanvuoigatvuodas	geavahanvuoigatvuođas
geavaheaddjiid	geavaheddjiid
geavaheaddjiide	geavaheddjiide
geavaheaddjiiguin	geavaheddjiiguin
geavaheaddjiin	geavaheddjiin
geavaheameš	geavaheames
geavaheapmai	geavaheapmái
geavahepmi	geavaheapmi
geavva	geavvá
geografalaccat	geográfalaččat
gi	gii
gida	giđa
giddagasás	giddagasas
giddegassii	giddagassii
giedahallá	gieđahallá
gieldabarggiide	gieldabargiide
giellageavaheaddjiid	giellageavaheddjiid
giellaráði	giellaráđi
giellaráðði	giellaráđđi
gierdevaččat	gierdivaččat
gierdevaš	gierdavaš
giitii	giittii
gilláimušastis	gillámušasttis
gilvaleaddjiid	gilvaleddjiid
gilvvakeahttá	gilvvikeahttá
girdinšilljut	girdinšiljut
girdišilljuide	girdišiljuide
girdišilljuiguin	girdišiljuiguin
girjebuvttadeaddjiide	girjebuvttadeddjiide
girjiid	girjjiid
girjjid	girjjiid
girjjálašvuoa	girjjálašvuođa
girjjálašvuoas	girjjálašvuođas
gisttáid	gistáid
gnddat	gánddat
goabbašat	goappašat
goalmmat	goalmmát
goappage	goappáge
goarggustallin	goarggostallin
goassiige	goassige
goavddiŧ	goavddit
gohccekeahttá	gozekeahttá
gohčoduvo	gohčoduvvo
goitot	goittot
gokcat	gokčat
gokča	gokčá
golatkeahtta	golatkeahttá
golbmása	golbmasa
golbmásis	golbmasis
golggida	golggiida
golmmajagi	golmma jagi
golmmaoasát	golmmaoasat
golmmá	golmma
gonagasreabbabivdui	gonagasreabbábivdui
gonagasreabbáid	gonagasreappáid
gonagasriikkii	gonagasriikii
gonagsreabbámáddodagat	gonagasreabbámáddodagat
gorževuoigatvuodaid	gorževuoigatvuođaid
gottahalai	gottáhalai
govttohemet	govttoheamit
govvafirji	govvagirji
gozihanja	gozihan ja
gozihanmihttideapmin	gozihanmihtideapmin
grada	gráda
grafálaš	gráfalaš
gramatihkka	grammatihkka
grenselinja	grenselinjá
gránnjá	kránnjá
guhkas	guhkás
guhkelebbui	guhkkelebbui
guhkelii	guhkkelii
guhkkiduvvot	guhkiduvvot
guhkkimusat	guhkimusat
guhkosaš	guhkkosaš
guhta	guhtta
guhtojuvvo	guhttojuvvo
guit	goit
gulahallanja	gulahallan ja
gulaskuddanja	gulaskuddan ja
guldaleaddjiid	guldaleddjiid
gulvui		guvlui
guoddalanásahuš	guoddalanásahus
guoddiiguin	guddiiguin
guohtonÂ­eatnamiid	guohtoneatnamiid
guohtovuoigavuohta	guođohanvuoigatvuohta
guohtunressursat	guohtunresurssat
guollebiebmandoalliide	guollebiebmandolliide
guollebiepmama	guollebiebmama
guollebiepmanrusttegat	guollebiebmanrusttegat
guollebivdovuoigatvuoda	guollebivdovuoigatvuođa
guollebivdovuoigatvuodaid	guollebivdovuoigatvuođaid
guollebivdovuoigatvuodaideaset	guollebivdovuoigatvuođaideaset
guollebivdovuoigatvuodain	guollebivdovuoigatvuođain
guollebivdovuoigatvuodat	guollebivdovuoigatvuođat
guolledikšunbivdimiš	guolledikšunbivdimis
guolásteaddjiid	guolásteddjiid
guolásteaddjiide	guolásteddjiide
guolásteaddjiin	guolásteddjiin
guorbmevávdnageainnuŧ	guorbmevávdnageainnut
guoska	guoská
guoskeváš	guoskevaš
guosselogaldallamistis	guosselogaldallamisttis
guosská	guoská
guovddása	guovddáža
guovddášhálddahuš	guovddášhálddahus
guovllos	guovllus
guovllulaccat	guovllulaččat
guovlui	guvlui
guovluin	guovlluin
guovttebealaŧ	guovttebealat
guovttebealde	guovtte bealde
guovttegearddi	guovtte gearddi
guovttegielalašvuoda	guovttegielalašvuođa
guovtteoasaŧ	guovtteoasat
guovtteoasát	guovtteoasat
guovttesuoraŧ	guovttesuorat
guovttus	guovttos
guovvluin	guovlluin
guođoheaddjiide	guođoheddjiide
gurutbealde	gurut bealde
gustojeddji	gustojeaddji
gustošivčče	gustošedje
guvlluin	guovlluin
guðe	guđe
gáddai	gáddái
gáddevuoigatvuodat	gáddevuoigatvuođat
gáfadiš	gáfadis
gáhtteneiseváldit	gáhtteneiseválddit
gáibadusa	gáibádusa
gáibadusaid	gáibádusaid
gáibadusat	gáibádusat
gáibideada	gáibideaba
gáibideaddjiid	gáibideddjiid
gáibideaddjiide	gáibideddjiide
gáibiduvvojiŧ	gáibiduvvojit
gáibiđivččii	gáibidivččii
gáibádusaŧ	gáibádusat
gáibáduš	gáibádus
gáiddusjohttimaŧ	gáiddusjohtimat
gáidánuohtiin	gáinuhtiin
gáldduid	gálduid
gálduidhaga	gálduid haga
gálvejohttu	gálvojohtu
gánnnehahtti	gánnehahtti
gáranasaŧ	gáranasat
gárgedanja	gárgidan ja
gárggiideamiin	gárggiidemiin
gárrenmirkkoid	gárrenmirkkuid
gárvana	gárvána
gárvanan	gárvánan
gárvanii	gárvánii
gárvanit	garvánit
gáržžekeahttá	gáržžitkeahttá
gáržžetkeahttá	gáržžitkeahttá
gáržžikeahttá	gáržžitkeahttá
gátjut	gádjut
gávccat	gávccát
gávdna	gávdná
gávdnakeahttá	gávnnakeahttá
gávdnojumiŧ	gávdnojumit
gávdnun	gávdnon
gávnnhan	gávnnahan
gávpejasaŧ	gávpejasat
gávpejassearvviŧ	gávpejassearvvit
gávppogiidda	gávpogiidda
hahkat		háhkat
hahká		háhká
halddašanláš	hálddahuslaš
halddášeami	hálddašeami
halit	hálit
heahpášuhttit	heahppášuhttit
heaittiheameš	heaittiheames
heaiveheami	heiveheami
heallumálemaŧ	heallomálemat
heardduhemiid	hearddohemiid
heivehallaŧ	heivehallat
heiveheapni	heiveheapmi
hilgunfanasortneŧ	hilgunfanasortnet
hirpmáhuvvan	hirpmahuvvan
historjjaláš	historjjálaš
hliidit	háliidit
hobehiŧ	hobehit
huksendihte	huksen dihte
huksenkeahttá	huksekeahttá
hukseáššiid	huksenáššiid
huksešivčče	huksešedje
humašivččii	humašii
hupmán	hupman
hupmát	hupmat
hutkkás	hutkás
háddi	haddi
háddjana	hádjána
háhtteŧ	háhttet
háldašeami	hálddašeami
hálddahanja	hálddahan ja
hálddahuseisseváldiide	hálddahuseisseválddiide
hálddahusjođiheaddjiide	hálddahusjođiheddjiide
hálddahuslaccat	hálddahuslaččat
hálddahussi	hálddahussii
hálddašangeavaŧ	hálddašangeavat
hálddašanja	hálddašan ja
hálddašeaddjiid	hálddašeddjiid
hálddašeamiin	hálddašemiin
háldejeaddjiid	háldejeddjiid
háldejeaddjiide	háldejeddjiide
háldiida	háliida
hápme	hábme
hárjanit	hárjánit
hárjehalanáiggiid	hárjehallanáiggiid
hástálussan	hástalussan
háttiid	hattiid
hávdaduvvot	hávdáduvvot
hávdeboraŧ	hávdeborat
idealistalaš	idealisttalaš
ieaset		iežaset
ieažas	iežas
iehcanas	iehčanas
ienastanlihppu	jienastanlihppu
ieseaiggáŧ	iešeaiggát
ievttá	ivttá
iezas	iežas
iešealáhusdoalliid	iešealáhusdolliid
iešgudet	iešguđet
iešgudetlágan	iešguđetlágan
iešguđete	iešguđetge
iešluohtttámuš	iešluohttámuš
iešmearredeami	iešmearrideami
iešstivrenordnegiid	iešstivrenortnegiid
iežasit	iežaset
iežaskka	iežaska
iežaš	iežas
ihkkinassii	ihkenassii
ii oačču	ii oaččo
ii oru 	ii oro 
ii čuovu	ii čuovo
iige oru 	iige oro 
ilmmuheamiid	ilmmuhemiid
imaštálla	imaštallá
individa	indiviida
industriai	industriijai
iniatiiva	initiatiiva
iniatiivvat	initiatiivvat
inkasso	inkásso
innoatiiva	innovatiiva
internáhtti	internáhttii
intrimstivras	interimstivrras
invsterenja	investeren ja
ipmášiid	ipmašiid
isidas		isidis
iskademiidda	iskkademiide
iskanvuoigatvuoda	iskanvuoigatvuođa
iskkademiidda	iskkademiide
iđđessuhkkán	iđđessuhkan
jagaš	jagáš
jage	jagi
jahkan	jáhkán
jahkasaččaide	jahkásaččaide
jahkasaš	jahkásaš
jahkehahtti	jáhkehahtti
jahkenjealljehasas	jahkenjealjehasas
jahkkehahtti	jáhkehahtti
jahkásaccat	jahkásaččat
javkán	jávkan
jeahkala	jeahkála
jearatgeahttá	jearakeahttá
jearldat	jearaldat
jearra	jearrá
jieanaid	jienaid
jieanastuslogu	jienastuslogu
jieanastuslogus	jienastuslogus
jienastanvuoigaduvvan	jienastanvuoigaduvvon
jienasteaddjiid	jienasteddjiid
jienasteaddjiide	jienasteddjiide
jirpmet	jirbmet
joatkaskuvla	joatkkaskuvla
joatkaskuvlla	joatkkaskuvlla
joatkaskuvllas	joatkkaskuvllas
joatkašupmi	joatkkašupmi
joatkkaohppofálaldaga	joatkkaoahppofálaldaga
joatkkaohppofálaldagaid	joatkkaoahppofálaldagaid
joatkkaohppofálaldagaide	joatkkaoahppofálaldagaide
joatkkaohppofálaldagat	joatkkaoahppofálaldagat
joatkkaohppofálaldahkii	joatkkaoahppofálaldahkii
joatkkaohppofálaldat	joatkkaoahppofálaldat
joatkkašuvvá	joatkašuvvá
joatkká	joatká
joatkkášuvvá	joatkašuvvá
joavkkui	jovkui
joavkojođiheaddjiid	joavkojođiheddjiid
joavkojođiheaddjiide	joavkojođiheddjiide
joavkojođiheaddjiiguin	joavkojođiheddjiiguin
jodihit	jođihit
johkabuoddun	johkabuođđun
johkosat	juhkosat
johtaleaddjiid	johtaleddjiid
johtalussihkkárvuođaplána	johtalussihkkarvuođaplána
johtasaŧ	johtasat
johtileamosit	johtilepmosit
johtipokála	johttipokála
johtolatvuoigatvuođ	johtolatvuoigatvuođa
johtočála	johtučála
johtočállagiin	johtučállagiin
johtočálus	johtučálus
johttiguolásteaddjiid	johttiguolásteddjiid
johttimii	johtimii
joksandihte	joksan dihte
jordamor	jorddamovra
jordamorbálvalus	jorddamorbálvalus !this is 3-part compound shortening ex. Iešjárgáddi
jordamorbálvalusas	jorddamorbálvalusas !this is 3-part compound shortening ex. Iešjárgáddi
jorgaleaddjiid	jorgaleddjiid
jorgaleaddjiin	jorgaleddjiin
journalistaid	journalisttaid
journalistaoahppui	journalistaohppui
jovkkuide	joavkkuide
joðanit	jođánit
joðiheadji	jođiheaddji
jođan	jođán
jođaneamos	jođáneamos
jođaneappot	jođáneappot
jođanepmosit	jođánepmosit
jođanis	jođánis
jođanit	jođánit
jođihanlinnjaid	jođihanlinnjáid
jođihanlinnjat	jođihanlinnját
jođiheaddjiid	jođiheddjiid
jođiheaddjiide	jođiheddjiide
jođiheaddjiidn	jođiheddjiid
jođiheaddjiiguin	jođiheddjiiguin
jođiheaddjiin	jođiheddjiin
jođiheaddjji	jođiheaddji
jođiheadji	jođiheaddji
jođáneamosit	jođánepmosit
juhkámušaid	juhkamušaid
julggášta	julggašta
julggáštit	julggaštit
julggáštusastis	julggaštusastis
juogakeahttá	juogatkeahttá
juogalagan	juogalágan
juogamasa	juoga masa
juohehaš	juohkehaš
juohkebeaivve	juohke beaivve
juohkediŋga	juohke diŋga
juohkeládje	juohke ládje
juohkeláhkai	juohke láhkai
juohkinkeahttá	juogakeahttá
juohkke	juohke
juohkášupmi	juohkašupmi
juoida	juoidá
juolloda	juolluda
juollodan	juolludan
juolludeamiid	juolludemiid
juornlisttálaš	journalisttalaš
jurddašanja	jurddašan ja
jurddašepmi	jurddašeapmi
juridihkalaccat	juridihkalaččat
juridihkkalaš	juridihkalaš
jursita		jurista
jursitta	juristta
jursittaid	juristtaid
jursittaiguin	juristtaiguin
justiisalávdegoddi	Justiisalávdegoddi
justiisalávdegottis	Justiisalávdegottis
juvddálačcat	juvddálaččat
juvssahattin	juvssahahttin
jágaš		jagáš
jáhkemeahttun	jáhkkemeahttun
jáhketmeahttun	jáhkkemeahttun
jáhkkehahtti	jáhkehahtti
jáhkkásaš	jahkásaš
jápmiid		jábmiid
kampánjja	kampánja
kantina	kantiina
kinopremiere	kinopremieara
kirurgiijja	kirurgiija
klassihkkalaš	klassihkalaš
klostersierralobiŧ	klostersierralobit
kloáhka	kloahka
km.	km
km2	km²
kommentara	kommentára
konsešuvdnageatnegasvuodas	konsešuvdnageatnegasvuođas
kontuvrrain	kantuvrrain
konvenšuvnda	konvenšuvdna
kopimášiinna	kopimašiinna
kreatiivvalaš	kreatiivalaš
kreátiivvalaš	kreatiivalaš
kritihkkalaš	kritihkalaš
kuffára	koaffara
kultumuitolága	kultutmuitolága
kultumuitoláhka	kulturmuitoláhka
kultur-ja	kultur- ja
kulturbálkášupmi	kulturbálkkašupmi
kultureatnadat	kultureanadat
kulturministtarii	kulturministarii
kulturmuitoja	kulturmuito- ja
kulturovdanbukima	kulturovdanbuktima
kulturpolitihkkalaš	kulturpolitihkalaš
kulturskovla	kulturskuvla
kulturvii	kultuvrii
kulturvrra	kultuvrra
kultuviesuid	kulturviesuid
kultuvralaš	kultuvrralaš
kultuvrrálaš	kultuvrralaš
kurša	kursa
kválitehta	kvalitehta
káfea	kafea
káfeas	kafeas
kántuvra	kantuvra
kántuvrra	kantuvrra
kántuvrras	kantuvrras
kápteaidna	kapteaidna
la	lea
lababui	lagabui
laddasa	lađđasa
laddasis	lađđasis
lagabuid	lagabui
lagamušaid	lagamusaid
lagidivččii	lágidivččii
lahkaaddima	láhkaaddima
lahkai	láhkai
lahkái	láhkái
lahttendoaimmahaŧ	lahttendoaimmahat
lahttovuođašiehatadusa	lahttovuođašiehtadusa
lahttuide	láhttuide
lahttut	láhttut
lahtui	lahttui
lantja	latnja
lasahusain	lasáhusain
lassana	lassána
lassanit	lassánit
lassiin	lassin
lassivaikkuhusat	lassiváikkuhusat
lasssin	lassin
lassánaan	lassánan
lavdnjegoađ	lavdnjegoađi
leal	leat
leamin	leamen
leamáš	leamaš
lešgudet	iešguđet
lhkai	láhkái
lhkuhisvuođas	lihkuhisvuođas
li	lei
liekkusit	liggosit
lihkkostuvvat	lihkostuvvat
lihton	lihtton
lihttoláigolacca	lihttoláigolačča
livcce	livčče
livnneteiseváldiide	livnneteiseválddiide
livčii	livččii
livččejit	livčče
livčči	livččii
loahpageahen	loahpageahčen
loahpahuvvvon	loahpahuvvon
loahpalaccat	loahpalaččat
loaččadet	loaččadit
lobalaš	lobálaš
lobihaga	lobi haga
lobáláš	lobálaš
loddevirusas	loddevirusis
logaldallamistis	logaldallamisttis
lohkanja	lohkan ja
lohkká	lohká
lohknaválgastivrii	lohkanválgastivrii
lohkágoahtit	lohkagoahtit
lohpadusaid	lohpádusaid
lohpii	lohppii
lohppi	lohpi
lohppida	lohpida
lohppidan	lohpidan
lohppidii	lohpidii
lohppidit	lohpidit
lohppit	lohpit
lohppádusastis	lohpádusastis
lojalitehttaruossalasvuođat	lojalitehtaruossalasvuođat
lokhkiide	lohkkiide
lotnolasdoalliid	lotnolasdolliid
lotnolasdoalliide	lotnolasdolliide
lotnolasealáhusdoalliid	lotnolasealáhusdolliid
lotnolasguolásteaddjiid	lotnolasguolásteddjiid
luhte	luhtte
lulas	lulás
lunddolaccat	lunddolaččat
luohtamuš	luohttámuš
luohttamuša	luohttámuša
luohttehahtti	luohtehahtti
luonddugáhttensearrvi	luonddugáhttensearvi
luondduresursaid	luondduresurssaid
luondduriggodaid	luondduriggodagaid
luonddusisabáhkkemiidda	luonddusisabahkkemiidda
luonddutiipaide	luonddutiippaide
luossanuohtiin	luossanuhtiin
luossačážádagaid	luossačázádagaid
luottaidhaga	luottaid haga
lupmet	lubmet
luvvešivčče	luvvešedje
lábmásat	lápmásat
lábmásiid	lápmásiid
láddagat	láttagat
láddagiid	láttagiid
láddjenja	láddjen ja
ládjet	láddjet
ládjogittid	ládjogittiid
lágada	lágida
lágadusat	lágádusat
lágamus	lagamus
lágidanšiehtadusaŧ	lágidanšiehtadusat
lágideaddjiid	lágideddjiid
lágideaddjiide	lágideddjiide
lágábuid	lagabui
lágášvuohta	lagasvuohta
láhkaduopmostuluin	láhkaduopmostuoluin
láhkagirjjid	láhkagirjjiid
láhkai oru 	láhkai oro 
láhkariekteolbmáŧ	láhkariekteolbmát
láhkarievadusa	láhkarievdadusa
láhkavuodu	láhkavuođu
láhkavuoduin	láhkavuođuin
láhkonit	lahkonit
láhti	láhtti
láhtis	láhttis
láhttemiš	láhttemis
láiddomistis	láiddomisttis
láigogaskavuođaŧ	láigogaskavuođat
láigohanvuoigatvuoda	láigohanvuoigatvuođa
láigolacca	láigolačča
láigolihttoáigodaŧ	láigolihttoáigodat
láigomassii	láigumassii
láiguhit	láigohit
lásihuvvon	lasihuvvon
lássanit	lassánit
lássiváikuhusat	lassiváikkuhusat
lávdegoddečoahkimat	lávdegoddečoahkkimat
lávdegottid	lávdegottiid
lávvodradaga	lávvordaga
ma..el	maŋŋel
ma..il	maŋŋil
ma..á	maŋŋá
magihkkalaš	magihkalaš
mahccan		máhcan
mahka	mahká
mahkaš	mahkáš
maiddi	maiddái
mailmmi	máilmmi
mainnašuvvo	máinnašuvvo
makkar	makkár
makkarge	makkárge
makkrge	makkárge
maksá	máksá
mangeláhkai	mange láhkai
mangeláhkái	mange láhkái
manjisboahtti	maŋisboahtti
mannjil	maŋŋil
mannodaga	mánnodaga
maoriat	maorit
markkašumiide	mearkkašumiide
massiimiidda	massimiidda
masttavuolábeale	mastta vuolábeale
mat celkojuvvo 	mat celkojuvvojedje 
mat gildojuvvo 	mat gildojuvvojedje 
mat ráhkaduvvojuvvo 	mat ráhkaduvvojuvvojedje 
mat sirdojuvvo 	mat sirdojuvvojedje
mat čuvvojuvvo 	mat čuvvojuvvojedje 
mat čállojuvvo 	mat čállojuvvojedje 
matemátihkka	matematihkka
matriálalaš	materiálalaš
maŋga	máŋga
maŋggakultuvrralašvuođa	máŋggakultuvrralašvuođa
maŋisboahttiid	maŋisbohttiid
maŋisboahttiide	maŋisbohttiide
maŋŋa	maŋŋá
maŋŋebargga	maŋŋebárgga
maŋŋálágaid	maŋŋálagaid
meahcasteaddjiid	meahcásteddjiid
meahccedoalliid	meahccedolliid
meahcceealliid	meahcielliid
meahcceealáhusdoalliid	meahcceealáhusdolliid
meahcceealáhusdoalliide	meahcceealáhusdolliide
meahcceluoddaláhkaásahuš	meahcceluoddaláhkaásahus
meahccesteami	meahcásteami
meahccevalljiid	meahccevaljiid
meahciš	meahcis
meahcásteaddjiid	meahcásteddjiid
meahcásteaddjiide	meahcásteddjiide
meakkašupmi	mearkkašupmi
meannudandagaldumiŧ	meannudandagaldumit
meannudovvon	meannuduvvon
mearariikkii	mearariikii
mearkašumiide	mearkkašumiide
mearkkašatti	mearkkašahtti
mearkkašeamiid	mearkkašemiid
mearradusa	mearrádusa
mearreduvvui	mearriduvvui
mearrideaddjiide	mearrideddjiide
mearridiii	mearridii
mearridusaid	mearrádusaid
mearriduvui	mearriduvvui
mearrádusaŧ	mearrádusat
mearrádussi	mearrádussii
mearás	mearas
mediafáladaga	mediafálaldaga
mediebearráigeahčču	mediabearráigeahčču
medieguovddáža	mediaguovddáža
medállja	medálja
meieridjii	meieriijii
meieriiját	meieriijat
meilde	mielde
meluvdna	melovdna
meluvnna	melovnna
merkkašumit	mearkkašumit
merkkašupmi	mearkkašupmi
merošteamiid	meroštemiid
metállaŧ	metállat
mi	mii
middjiide	midjiide
miediha	mieđiha
miedihit	mieđihit
miehttá	miehtá
mielaevttoŧ	mielaevttot
mielahttostádaid	miellahttostáđaid
mieldddisbuktá	mielddisbuktá
mieldde	mielde
mielddis-buktá	mielddisbuktá
mielddisbukta	mielddisbuktá
mielddisttis	mielddistis
mieldebiddjojuvvon	mielde biddjojuvvon
mieldeváikkuhanja	mieldeváikkuhan ja
mieldisbuktá	mielddisbuktá
miellahtto-vuohta	miellahttovuohta
miellahttoriikain	miellahttoriikkain
miellahttuin	miellahtuin
miellahttut	miellahtut
miellačájeheamiŧ	miellačájeheamit
miellegiddevaš	miellagiddevaš
mielláhttuvuođa	miellahttovuođa
mien	min
miennudanvuogi	meannudanvuogi
mierka		mearka
mieáđiheamiin	mieđihemiin
mieđihuvui	mieđihuvvui
mieđihuvvoŧ	mieđihuvvot
miha	mihá
mihke	mihkke
mihkege	mihkkege
mihtomearrin	mihttomearrin
mihtádusvuoigatvuoda	mihtádusvuoigatvuođa
mihtádusvuoigatvuodaid	mihtádusvuoigatvuođaid
mihtádusvuoigatvuodat	mihtádusvuoigatvuođat
mii muosehuhti	mii muosehuhtii
miiguin	minguin
miin		min
mijovnna	miljovnna
miljardda	miljárdda
miljovnno	miljovnna
miljovvna	miljovnna
miljuvnna	miljovnna
milliarda	miljárda
milliardda	miljárdda
milliárdda	miljárdda
milljon	miljon
milljovnna	miljovnna
milljuvnna	miljovnna
minerálliiggiŧ	minerálliiggit
minerálvuoigatvuodaid	minerálvuoigatvuođaid
minerálvuoigatvuodat	minerálvuoigatvuođat
ministtarat	ministarat
ministtariid	ministariid
mksit	máksit
moaddeloht	moaddelot
moddji	modji
modjá	moddjá
mohtotjohtolatlágaid	mohtorjohtolatlágaid
moitii	moittii
moivásat	moivasat
moktige	moktiige
moktá	mokta
molssašumi	molsašumi
molssašupmi	molsašupmi
molssoevttolaš	molssaevttolaš
monnebavtti	monnebávtti
morašii	morrašii
morráná	morrána
movtiideami	movttiideami
movttida	movttiida
movttidivčče	movttidivčče
movttiidahttinja	movttiidahttin ja
movttiidahttášii	movttiidahtášii
muddenfápmudusaŧ	muddenfápmudusat
muddenvuogádaŧ	muddenvuogádat
mudui		muđui
muht	muhto
muhtiimiiguin	muhtimiiguin
muhtomat	muhtumat
muhtomiin	muhtumiin
muhtomiin	muhtumin
muhtp	muhto
muhtu	muhto
muhtunmuddui	muhtun muddui
muittoha	muittuha
muittuihit	muittuhit
muitála	muitala
munje	munnje
muohtaskohterreagaŧ	muohtaskohterreagat
muorra-dáida	muorradáidda
muorraávnnasgávpašeaddjiid	muorraávnnasgávppašeddjiid
murrengeavaheaddjiide	murrengeavaheddjiide
murrenja	murren ja
museum	musea
museuma	musea
musihkáriid	musihkkáriid
mutto	muttu
mytologia	mytologiija
má.ga	máŋga
má.ggalágán	máŋggalágán
mádjihaŧ	mádjihat
máhtolašuvohta	máhtolašvuohta
máhtá	máhttá
máiguin	maiguin
máilmmes	máilmmis
mákkár	makkár
mákkárge	makkárge
málmmi	máilmmi
málmmis	máilmmis
mánga	máŋga
márkanfievrredit	márkanfievrridit
márkanšiljui	márkanšilljui
márkanšilljus	márkanšiljus
márreŧ	márret
mássavieccahatdoaimmaheaddjiide	mássavieccahatdoaimmaheddjiide
mátkiid	mátkkiid
mátkiide	mátkkiide
mátkiin	mátkkiin
mátkit	mátkkit
mátkkošteaddjiid	mátkkošteddjiid
mátkkošteaddjiide	mátkkošteddjiide
mátkoštanealáhusa	mátkkoštanealáhusa
mátkoštit	mátkkoštit
máttásámi	máttasámi
mávssolaccat	mávssolaččat
máđi	mađi
máđiija	máđija
máđiijat	máđijat
máŋgakultuvrralaš	máŋggakultuvrralaš
máŋggabealaŧ	máŋggabealat
máŋggasuoraŧ	máŋggasuorat
máŋimus	maŋimus
máŋimuš	maŋimuš
máŋŋebargga	maŋŋebárgga
máŋŋebárgga	maŋŋebárgga
máŋŋil	maŋŋil
máŋŋonan	maŋŋonan
máŋŋá	maŋŋá
nagudan	nagodan
nagudit	nagodit
nagut	nagot
nalá	nala
namakeahttá	namatkeahttá
nammadadan	nammadan
nammakonsu-leantabálvalusa	nammakonsuleantabálvalusa
nammásaš	nammasaš
namuhuvvodedje	namuhuvvojedje
namukeahttá	namutkeahttá
nannejiŧ	nannejit
nannesivččii	nannešii
nanneuvvo	nannejuvvo
nautálaš	nautalaš
našunala	našunála
našunalbeaivi	našunálbeaivi
našuvnda	našuvdna
neahttasiiduid	neahttasiidduid
nealgudeaddjiid	nealgudeddjiid
nealgudeaddjiide	nealgudeddjiide
nealguid	nealgguid
nealljejuvlla	njealjejuvllat
nearriduvvon	mearriduvvon
neavttar	neavttár
neavttariid	neavttáriid
neavttariiguin	neavttáriiguin
nejalját	njealját
nieddat	nieiddat
nieddaš	nieiddaš
niehkko	niehku
niehko	niehku
nieiddážiin	nieiddažiin
nihkela		nihkkela
nijeaddjiid	nijeddjiid
nissoniida	nissoniidda
nissoniiin	nissoniin
nissonolbmoid	nissonolbmuid
nissonolbmoin	nissonolbmuin
nissuŧ	nissut
njealjadaskilomehtera	njealjádaskilomehtera
njealastit	njiealastit
njealjje	njealje
njealjje	njeallje
njealjji	njealji
njealjjis	njealjis
njealjját	njealját
njealljejahkásaš	njealjejahkásaš
njealljejahkáš	njealjejahkásaš
njealljejuvllat	njealjejuvllat
njeallječiegat	njealječiegat
njeallječiegatvuhtii	njealječiegatvuhtii
njeallji	njealji
njealljis	njealjis
njealljádasoassi	njealjádasoassi
njealljása	njealjása
njeallját	njealját
njoarusteapmi	njoarosteapmi
njukcamánu	njukčamánu
njukčamáu	njukčamánu
njukčámánu	njukčamánu
njunnužat	njunnošat
njunnužis	njunnošis
njunoš		njunuš
njunoš	njunuš
njunožat	njunnožat
njunožii	njunnožii
njunožis	njunnožis
njunužis	njunnožis
njuoggadusaid	njuolggadusaid
njuoggadusat	njuolggadusat
njuolgguslaŧ	njuolggušlaš
njuonnožat	njunnošat
njuonuš		njunuš
njuovvanja	njuovvan ja
njuovžieabbon	njuovžileabbon
njálmmalaš	njálmmálaš
nomada	nomáda
norggabeal	Norgga beal
norpmáiguin	norpmaiguin
nubbesadjásaš	nuppisadjásaš
nubbijođiheadjji	nubbijođiheaddji
nuohtiin	nuhtiin
nuondda-hallamiidda	nuonddahallamiidda
nuoraguin	nuoraiguin
nuoraidpsykiáhtralaš	nuoraidpsykiatralaš
nuoraidpsyktiatralaš	nuoraidpsykiatralaš
nuorragándán	nuorragándan
nuortalaččaŧ	nuortalaččat
nuppebeale	nuppe beale
nuppebeali	nuppe beali
nuppedáfus	nuppe dáfus
nuppegeardde	nuppe geardde
nuppegežiid	nuppe gežiid
nuppeguvlui	nuppe guvlui
nuppeláhkái	nuppe láhkái
nuppeš	nuppes
nuppásteaddjiid	nuppásteddjiid
nuppásteaddjiide	nuppásteddjiide
nuppásteaddjiin	nuppásteddjiin
nuvtta	nuvttá
nággogážaldat	nággogažaldat
nágodan	nagodan
nágodat	nagodat
nágot	nagot
nákkuŧ	nákkut
nálaštuhttimii	náláštuhttimii
nástiid	násttiid
nástit	násttit
návccáiguin	návccaiguin
návsti	návste
návččaid	návccaid
nášunala	našunála
oaccun	oaččun
oaffaruššujuvvojit	oaffaruššojuvvojit
oahhpogirjjiid		oahppogirjjiid
oahpaheaddjiid	oahpaheddjiid
oahpaheaddjiide	oahpaheddjiide
oahpaheaddjiidoahpahusa	oahpaheddjiidoahpahusa
oahpaheaddjiidoahpahussii	oahpaheddjiidoahpahussii
oahpaheaddjiidseminára	oahpaheddjiidseminára
oahpaheaddjiin	oahpaheddjiin
oahpaheaddjioahpahussi	oahpaheaddjioahpahussii
oahpahusfáladagain	oahpahusfálaldagain
oahpasmuvvan	oahpásmuvvan
oahpasmuvvat	oahpásmuvvat
oahpasnuvvan	oahpásnuvvan
oahpasnuvvat	oahpásnuvvat
oahpasnuvven	oahpásnuvven
oahpasnuvvá	oahpásnuvvá
oahppahusgeatnegas	oahpahusgeatnegas
oahppes	oahpes
oahppiid	ohppiid
oahppiide	ohppiide
oahppiiguin	ohppiiguin
oahppiin	ohppiin
oahppofáladagaid	oahppofálaldagaid
oahppogirjiid	oahppogirjjiid
oahppogirjjid	oahppogirjjiid
oahppogáibadusas	oahppogáibádusas
oahppoja	oahppo- ja
oahpponeavvoovddideaddjiid	oahpponeavvoovddideddjiid
oahppoplánajovkkuide	oahppoplánajoavkkuide
oahppásnuvvat	oahpásnuvvat
oahppášmuvvat	oahpásmuvvat
oahpáhusa	oahpahusa
oaidnindihte	oaidnin dihte
oaidnoja	oaidno- ja
oainnan	oainnán
oainnuigun	oainnuiguin
oainnuiid	oainnuid
oaiviliiddaset	oaiviliiddáset
oaiviliiddat	oaiviliiddát
oaivvila	oaivvilda
oaivvildeje	oaivvildedje
oaivvilduvvoKárášjoga	oaivvilduvvo Kárášjoga
oaivvilduvvoi	oaivvilduvvui
oaivvilidit	oaivvildit
oaivvilidt	oaivvildit
oalat	oalát
oallatge	oallátge
oamastanja	oamastan ja
oamastanvuogádaŧ	oamastanvuogádat
oamasteaddjiin	oamasteddjiin
oamasteddji	oamasteaddji
oamástit	oamastit
oaneduvvon	oaniduvvon
oanehaccat	oanehaččat
oanehaččaŧ	oanehaččat
oanehisšilljogirdimaŧ	oanehisšilljogirdimat
oanehot	oanehut
oapmáhaččaiguin	oapmahaččaiguin
oapponeavvoguovddážis	oahpponeavvoguovddážis
oapponeavvuid	oahpponeavvuid
oasitit		oastit
oasseaiggepolitihkkarat	oasseáigepolitihkkárat
oasseaiggepolitihkkariin	oasseáigepolitihkkáriin
oasselastit	oassálastit
oassemáhtolaš-vuohta	oassemáhtolašvuohta
oassesáigepolitihkkáriid	oasseáigepolitihkkáriid
oassálastii	oassálasttii
oastan	oastán
oastiid	ostiid
oastiin	ostiin
oastinovdavuoigatvuodas	oastinovdavuoigatvuođas
oasálastejit	oassálastet
oasálastii	oassálasttii
oasálasttet	oassálastet
oasálasttit	oassálastit
oasálaččaguin	oasálaččaiguin
oavvilda	oaivvilda
oazzu	oažžu
oaččon	oaččun
oaččoše	oččoše
oaččošedje	oččošedje
oaččošii	oččošii
oaččušii	oččošii
oažžo	oaččo
oažžo	oažžu
oažžundihte	oažžun dihte
obbanassiige	obanassiige
obá		oba
ochan		ohcan
odastuvvojedje	ođastuvvojedje
odda	ođđa
oddajagisartni	ođđajagisártni
oddamállet	ođđamállet
odná	otná
odoaibmaortnega	doaibmaortnega
ohcakeahttá	ozakeahttá
ohcanvuoigatvuoda	ohcanvuoigatvuođa
ohccala	ohcala
ohccat	ohcat
ohcmaiid	ohcamiid
ohppiidjoavkui	ohppiidjovkui
ohppin	oahppin
ohppoplána	oahppoplána
ohppováillat	oahppováillat
oinii	oinnii
oinnimet	oinniimet
okatvuođas	oktavuođas
oktain	oktan
oktanagas	oktanaga
oktasaaš	oktasaš
oktasaccat	oktasaččat
oktavuoa	oktavuođa
oktavuodas	oktavuođas
oktavuoðain	oktavuođain
oktibuot	oktiibuot
oktiibidjankeahttá	oktiibidjankeahttá
oktiilaččat	oktilaččat
oktiilašvuohta	oktilašvuohta
oktilas	oktilaš
oktovuoigatvuoda	oktovuoigatvuođa
oktovuoigatvuođ	oktovuoigatvuođa
olamuddui	olámuddui
olamuttos	olámuttos
olamuttus	olámuttos
olbmoid	olbmuid
olbmoin	olbmuin
olbmoŧ	olbmot
olbmu	olbmo
olbmut	olbmot
olges	olgeš
olggoštuvvojit	olgguštuvvojit
olggubealde	olggobealde
olgoriikalaččaid	olgoriikkalaččaid
olgoriikalaččaide	olgoriikkalaččaide
olgoriikalaččat	olgoriikkalaččat
olgoriikalaš	olgoriikkalaš
olgoriikkii	olgoriikii
oliislaš	ollislaš
olitiijáin	politiijain
ollašuvva	ollašuvvá
ollesvirgeguolásteaddjiid	ollesvirgeguolásteddjiid
ollislaccat	ollislaččat
ollislas	ollislaš
ollogat	ollugat
ollus	olus
ollusa		ollusat
ollásuvvojit	ollašuvvet
ollášuhttiimet	ollašuhtiimet
ollášuvvan	ollašuvvan
ollášuvvon	ollašuvvan
ollášuvvá	ollašuvvá
olmmai	olmmái
olmmáivákki	Olmmáivákki
olympijameašttirin	olympiijameašttirin
oláhus	olahus
olámuttus	olámuttos
ommán	omman
ommánis	ommanis
oposišuvdna	opposišuvdna
oposišuvnnas	opposišuvnnas
oppalaccat	oppalaččat
oppalašvuoda	oppalašvuođa
oppaáigge	oppa áigge
opplaččat	oppalaččat
optimistalaš	optimisttalaš
ordnega	ortnega
ordnegiid	ortnegiid
ordnejuvvun	ordnejuvvon
organisatoraláš	organisatoralaš
organisatuvralaš	organisatuvrralaš
organiserejuvvoi	organiserejuvvui
organiseremistis	organiseremisttis
orgánisašuvdna	organisašuvdna
orgánisašuvnna	organisašuvnna
orgánisašuvnnaid	organisašuvnnaid
orgánisašuvnnain	organisašuvnnain
orgánisašuvnnat	organisašuvnnat
oroleamen	oro leamen
orrotleamen	orrot leamen
ortneŧ	ortnet
oru ahte	 oro ahte
oru bidjamin	 oro bidjamin
oru leamen	 oro leamen
oru leat 	 oro leat 
oskkumušealliid	oskumušealliid
oskkáldasaŧ	oskkáldasat
oskugodii	oskugođii
otna	otná
ovaolmmoš	ovdaolmmoš
ovda	ovdal
ovdalgihtii	ovdagihtii
ovdalgihtii	ovddalgihtii
ovdaláigohiŧ	ovdaláigohit
ovdamanniŧ	ovdamannit
ovdamearkadihte	ovdamearkka dihte
ovdamearkkadihte	ovdamearkka dihte
ovdamearkkadihtii	ovdamearkka dihtii
ovdan-buktá	ovdanbuktá
ovdanahttit	ovdánahttit
ovdanbuktimistis	ovdanbuktimisttis
ovdaneami	ovdáneami
ovdaskuvlaoahpaheaddjiid	ovdaskuvlaoahpaheddjiid
ovdaskuvlaoahpaheaddjiide	ovdaskuvlaoahpaheddjiide
ovddamearka	ovdamearka
ovddamearkka	ovdamearkka
ovddasdeaddji	ovddasteaddji
ovddasdeaddjit	ovddasteaddjit
ovddasteaddjiid	ovddasteddjiid
ovddasteaddjiide	ovddasteddjiide
ovddasteaddjiiguin	ovddasteddjiiguin
ovddasteaddjiin	ovddasteddjiin
ovddasteddji	ovddasteaddji
ovddasvastádus	ovddasvástádus
ovddasvstdus	ovddasvástádus
ovddasvástadus	ovddasvástádus
ovddasvástadusa	ovddasvástádusa
ovddasvástadusas	ovddasvástádusas
ovddasvástideaddjiid	ovddasvástideddjiid
ovddasvástideaddjiide	ovddasvástideddjiide
ovddavástideaddji	ovddasvástideaddji
ovdddas	ovddas
ovddemusát	ovddemusat
ovddes	ovddeš
ovddet	ovddit
ovddidandihte	ovddidan dihte
ovddidanfaonda	ovddidanfoanda
ovddidanprográmmid	ovddidanprográmmaid
ovddidt		ovddidit
ovddidus	ovddádus
ovddidussii	ovddádussii
ovdideami	ovddideami
ovdidit		ovddidit
ovdosii	ovdasii
ovdál	ovdal
ovdánahtašii	ovdánahtášii
ovdáneamiin	ovdánemiin
ovdáná	ovdána
ovgagihtii	ovdagihtii
ovttabealálaččaŧ	ovttabealálaččat
ovttadássasaš		ovttadássásaš
ovttajienalaccat	ovttajienalaččat
ovttakas	ovttaskas
ovttamano	ovttatmano
ovttaolbmoja	ovttaolbmo- ja
ovttasbargojulggáštus	ovttasbargojulggaštus
ovttasbárgojoavku	ovttasbargojoavku
ovttaskaš	ovttaskas
ovttastahttášii	ovttastahtášii
ovttasvástadus	ovddasvástádus
ovttárvosašvuohta	ovttaárvosašvuohta
ozolacca	ozolačča
ozolaccat	ozolaččat
ozovuoigatvuoda	ozovuoigatvuođa
ozovuoigatvuodabáktelága	ozovuoigatvuođabáktelága
ozovuoigatvuodas	ozovuoigatvuođas
oččon	ožžon
oččosedje	oččošedje
ođastiŧ	ođastit
ođđ	ođđa
ođđastit	ođastit
ođđaáigasaš	ođđaáigásaš
ođđá	ođđa
ožžun	oažžun
ožžut	oažžut
pakistánalaš	pakistanalaš
palestiinalaš	palestinalaš
paragrafa	paragráfa
paragráf	paragráfa
parlamenta	parlameanta
Parlameantaralaš	Parlamentáralaš
Parlameanttaralaš	Parlamentáralaš
parlameantaralaš	parlamentáralaš
parlamentaralaš	parlamentáralaš
parlamentarihkarkonferánssa	parlamentarihkkarkonferánssa
parlamentarihkkara	parlamentarihkkara
parlamentarihkára	parlamentarihkkára
parlamentta	parlameantta
parlamentárlaš	parlamentáralaš
parola	Parola
pasiiva		passiiva
pedagogálaš	pedagogalaš
pedogogalaš	pedagogalaš
pensjonista	penšunista
penšonista	penšunista
penšonkássii	penšunkássii
penšonvuoigatvuođaid	penšunvuoigatvuođaid
penšouproseantta	penšunproseantta
persovnnalaccat	persovnnalaččat
peršonalgiehtagiehtagirjji	peršonálgiehtagirjji
pinniidemiid	biinnidemiid
pinniidit	biinnidit
plánejeaddjiid	plánejeddjiid
plánenjuvvon	plánejuvvon
poastajournala	poastajournála
poliiijáin	politiijain
polithkalaš	politihkalaš
politiadvokáhtta	politiadvokáhta
politiat	politiijat
politihkaláš	politihkalaš
politihkarat	politihkkarat
politihkariid	politihkkariid
politihkariidda	politihkkariidda
politihkariin	politihkkariin
politihkkálačat	politihkalaččat
politihkkálaš	politihkalaš
politihklaš	politihkalaš
politihkálaččat	politihkalaččat
politihkár	politihkkár
politihkáriid	politihkkáriid
politihkáriin	politihkkáriin
politiiat	politiijat
politiijáid	politiijaid
politiijáide	politiijaide
politiiját	politiijat
politijaduođaštusa	politiijaduođaštusa
politijaide	politiijaide
politijat	politiijat
politiját	politiijat
poltiijat	politiijat
porsáŋgolaččat	porsáŋgulaččat
poršeavttas	prošeavttas
positivva	positiivva
positivvalaččat	positiivvalaččat
postiivvalaš	positiivvalaš
potihkkasurggiid	politihkkasurggiid
praktihkkalaččat	praktihkalaččat
praktihkkalaš	praktihkalaš
preassai	pressii
presensa	preseansa
presidaenta	presideanta
presideanttad	presideanttaid
presidenta	presideanta
prihsihppa-dieđáhusaid	prinsihppadieđáhusaid
prinsipiála	prinsihpiála
prioritehta1-4	prioritehta 1-4
prisihpaid	prinsihpaid
prisihpas	prinsihpas
priváhtarievttalaš	priváhtarievttálaš
produsenttaid	produseanttaid
profeassor	professor
profila		profiila
programma	prográmma
progámma	prográmma
progámmas	prográmmas
propaganda	propagánda
propagándai	propagándii
proseaktajođiheaddji	prošeaktajođiheaddji
proseantalaš	proseanttalaš
proseassalahkaaddimis	proseassaláhkaaddimis
proseavtta	prošeavtta
prosessa	proseassa
prosetalaš	proseanttalaš
prospekterenossodaŧ	prospekterenossodat
prošavttat	prošeavttat
prošeaktajođiheaddjiide	prošeaktajođiheddjiide
prošeaktajođiheaddjiin	prošeaktajođiheaddjiin
prošeaktii	prošektii
prámaŧ	prámat
psyhkálaš	psyhkalaš
psykiatrálaš	psykiatralaš
psyklologaoahpu	psykologaoahpu
psyklologiija	psykologiija
páhkkejuvovn	páhkkejuvvon
párasihtaid	parasihtaid
rabahttaortnegiid	rabáhttaortnegiid
radioa	rádio
radjái	rádjái
rahkaduvvon	ráhkaduvvon
rahpa	rahpá
rahppan	rahpan
rahpámiin	rahpamiin
rahčámuš	rahčamuš
raje	ráje
rajes	rájes
rasistalaš	rasisttalaš
rasistalažžan	rasisttalažžan
rasta	rastá
rastilda	rasttilda
rastildeaddji	rasttildeaddji
rastildit	rasttildit
ratifikašuvngažaldat	ratifikašuvdnagažaldat
ravisolbmuid	rávisolbmuid
reabbaealliŧ	reabbáeallit
reabbáid	reappáid
readjái	rádjái
reahkaid	reahkáid
reajes	rájes
realistalaš	realisttalaš
referansajoavkku	referánsajoavkku
regiondepartemeantii	regiondepartementii
regiovdnapolitihkkalaš	regiovdnapolitihkalaš
regiovnnalaccat	regiovnnalaččat
registerejuvvon	registrerejuvvon
registeren	registreren
registrerenja	registreren ja
registrerjuvvot	registrerejuvvot
registtariidda	registariidda
regiuvdnan	regiovdnan
rehkanastá	rehkenastá
rehkenastan	rehkenastán
rehketgirjjiŧ	rehketgirjjit
rektuteret	rekruteret
relavánta	relevánta
religiovdahistorjá	religiovdnahistorjá
religuvnnalaš	religiuvnnalaš
reportaša	reportáša
reporttar	reportár
resepttahaga	reseaptta haga
resideanttaid	presideanttaid
ressursa	resursa
ressursahálddašeapmi	resursahálddašeapmi
ressursaid	resurssaid
ressursajoavku	resursajoavku
ressursan	resursan
ressurssaid	resurssaid
ressurssaide	resurssaide
ressurssaiguin	resurssaiguin
ressurssat	resurssat
resturáŋŋa	restoráŋŋa
resursaid	resurssaid
resursat	resurssat
resursssaid	resurssaid
resurššaid	resurssaid
resurššat	resurssat
reákšuvnnaid	reakšuvnnaid
reákšuvnnat	reakšuvnnat
reškii		reškkii
rhkadit	ráhkadit
riddodorskki	riddodorski
riddoja	riddo- ja
riegadan	riegádan
riegadanbeaivi	riegádanbeaivi
riegadii	riegádii
riegádattán	riegádahttán
rieiddut	reaiddut
riektegeavaheaddjiid	riektegeavaheddjiid
riektegeavaheaddjiide	riektegeavaheddjiide
riektenjuolggadusaŧ	riektenjuolggadusat
riekteoahppavaččaŧ	riekteoahppavaččat
riekteoainnuŧ	riekteoainnut
riekteposišuvnnaidsáhttá	riekteposišuvnnaid sáhttá
riektevuogádaŧ	riektevuogádat
rievadadusaid	rievdádusaid
rievadit	rievdadit
rievda		rievdá
rievdadanja	rievdadan ja
rievdakeahttá	rievdatkeahttá
rievdeami	rievdadeami
rievttilaš	rievttálaš
rievttimielde	rievtti mielde
riggodahkkii	riggodahkii
rihkkokeahttá	rihkokeahttá
rihkkomiidda	rihkkumiidda
rihkušii	rihkošii
riiddudet	riiddodet
riidogážaldat	riidogažaldat
riiduid	riidduid
riikaid	riikkaid
riikaide	riikkaide
riikaidgaskasaččat	riikkaidgaskasaččat
riikaidgaskasaš	riikkaidgaskasaš
riikain	riikkain
riikačoahkkamii	riikačoahkkimii
riikkaidgaskasáš	riikkaidgaskasaš
riikkii	riikii
rikkástuvvat	rikkustuvvat
rivadit	ribadit
rivveŧ	rivvet
rjes	rájes
roasmahuvai	roasmmehuvai
roasmmahuvai	roasmmehuvai
roasmmahuvai	roasmmohuvai
roasmmahuvvan	roasmmehuvvan
roasmmahuvvan	roasmmohuvvan
roasmmahuvvon	roasmmohuvvon
roavvarávddiŧ	roavvarávddit
rogganvuoigatvuoda	rogganvuoigatvuođa
rohkosvisui	rohkosvissui
rollai	rollii
rollá	rolla
romantalaš	románttalaš
romantihkkalaš	romantihkalaš
romántalaš	románttalaš
ruda	ruđa
rudaid	ruđaid
rudalaš	ruđalaš
rudat	ruđat
ruhtadeaddjiiguin	ruhtadeddjiiguin
ruhtagažu	ruhtagahču
ruktobiillaŧ	ruktobiillat
rumašrihkosiidda	rumašrihkkosiidda
runasárgumaŧ	runasárgumat
ruona	ruoná
ruonágeadgeáviŧ	ruonágeađgeávit
ruonágeadgeáviŧ	ruuonágeađgeávit
ruota	ruoŧa
ruovttušiljjus	ruovttušiljus
ruoŧelaččat	ruoŧŧelaččat
ruoŧelaš	ruoŧŧelaš
rustega	rusttega
rutnoŧ	rutnot
ruvdkedoamma	ruvkedoaimma
ruvnnoin	ruvnnuin
rvudnui	ruvdnui
ráddádallá	ráđđádallá
rádja	rádjá
rádjejuvvon	ráddjejuvvon
rádđehusa	ráđđehusa
ráfáiduhttin-ja	ráfáiduhttin- ja
ráhkadišgđii	ráhkadišgođii
ráhppo	rahppo
ráhppojit	rahppojit
rámmajuolludeamiŧ	rámmajuolludeamit
rámmá	rámma
rámppástallet	rámppastallet
ránnjáriikkii	ránnjáriikii
ránska	Ránská
rátjái	rádjái
rávdnjefievrredeaddjiŧ	rávdnjefievrredeaddjit
rávesolbuin	rávesolbmuin
rávisolbuid	rávisolbmuid
ráði	ráđi
ráđid	ráđiid
ráđđehusadvokahta	ráđđehusadvokáhta
ráđđenduohtadeamiŧ	ráđđenduohtadeamit
ráđđenráddjemaŧ	ráđđenráddjemat
ráđđádallamaŧ	ráđđádallamat
ráđđádallaŧ	ráđđádallat
ráŋggaštit	ráŋggáštit
ráŋggaštuvvot	ráŋggáštuvvot
ráŋggáštusaŧ	ráŋggáštusat
ráŋggáštuvvi	ráŋggáštuvvo
saddat	šaddat
sadjai	sadjái
sadjásas	sadjásaš
sahendimbaraŧ	sáhendimbarat
sahka	sáhka
sahtašii	sáhtášii
sahtta	sáhttá
sajiide:Djupvik-Nordmannvik	sajiide: Djupvik-Nordmannvik
sallihit	sallihiid
samedikkeplánas	sámedikkeplánas
samedikkeáirras	sámediggeáirras
samegiela	sámegiela
samegillii	sámegillii
samemeasttirvuoittu	sámemeasttirvuoittu
sami	sámi
samid	sámiid
samiide	sámiide
sapmelaš	sápmelaš
sartni	sártni
satjái	sadjái
sattai	šattai
savvaba	sávvaba
savvat	sávvat
sddejuvvo	sáddejuvvo
sddet	sáddet
seammalagan	seammalágan
seammalahkai	seamma láhkai
seamms	seammás
seammáš	seammás
seanga	seaŋga
searvegotteráđi	searvegodderáđi
searvegotteráđđi	searvegodderáđđi
searvegotteviesus	searvegoddeviesus
searveorganisašuvnnaŧ	searveorganisašuvnnat
searveriggodaŧ	searveriggodat
seađašii	seađášii
seksuala	seksuála
seksualalaš	seksuálalaš
seksualaláhkarihkkulávdegotti	seksuálaláhkarihkkunlávdegotti
semifinalas	semifinálas
seminara	seminára
seminaras	semináras
seminárai	seminárii
serdodateallin	servodateallin
servdodatfága	servodatfága
servodatoeallima	servodateallima
servodatplánejeaddjiid	servodatplánejeddjiid
servvet	servet
servviguin	servviiguin
sevodatásahusat	servodatásahusat
shttet	sáhttet
si	sii
sidjide	sidjiide
siearradoarjaga	sierradoarjaga
siehtadallančoahkkimiid	šiehtadallančoahkkimiid
siehtadus	šiehtadus
sieludet	silodet
sierrabibliiotehka	sierrabibliotehka
sierraduopmostuoluŧ	sierraduopmostuolut
sierralagaid	sierralágaid
sierraoavilistis	sierraoaivilisttis
signalat	signálat
signalaid	signálaid
sihkarasten	sihkkarastin
sihkarastima	sihkkarastima
sihkarastojuvvo	sihkkarastojuvvo
sihkarasttit	sihkkarastit
sihkarasttojuvvon	sihkkarastojuvvon
sihkarastá	sihkkarastá
sihkarastášedje	sihkarasttášedje
sihkarit	sihkkarit
sihkkarasta	sihkkarastá
sihkkarastašii	sihkkarasttášii
sihkkarasttan	sihkkarasttán
sihkkarasttašii	sihkkarasttášii
sihkkarastášii	sihkkarasttášii
sihkkárastit	sihkkarastit
sihkkárvuođamunni	sihkkarvuođamunni
sihkár	sihkar
siiguin	singuin
siin	sin
siinguin	singuin
singela	siŋgela
sirddolaččaŧ	sirddolaččat
sirdojuvve	sirdojuvvo
sirdášuvvan	sirdásuvvan
sis-eatnama	siseatnama
sis-eatnamis	siseatnamis
sis-eatnan	siseatnan
sis-riika	sisriika
sis-riikka	sisriikka
sisabeassin	sisabeassan
sisaboaduid	sisaboađuid
sisabáhkemiid	sisabahkkemiid
sisabáhkkemiidda	sisabahkkemiidda
sisafievrreduvvui	sisafievrriduvvui
sisafievrridanja	sisafievrridan ja
sisafárrejeaddjiid	sisafárrejeddjiid
sisafárrejeaddjiide	sisafárrejeddjiide
sisbeassima	sisabeassama
sisbándygilvvuin	sisbandygilvvuin
sisbándyroadda		sisbandyroadda
sisdoalla	sisdoallá
sisilialáččat	sisilialaččat
sisilialáš	sisilialaš
siskabealde	siskkabealde
siskildit	siskkildit
siskkalbealde	siskkabealde
siskkelii	siskelii
siskkelis	siskelis
siskobealde	siskkobealde
siskáldas	siskkáldas
siskáldasat	siskkáldasat
sisriikalaččat	sisriikkalaččat
sisriikalaš	sisriikkalaš
sisttisdoalla	sisttisdoallá
sisábáhkkehemiin	sisabahkkehemiin
sivahalla	sivahallá
sivahállá	sivahallá
sivila	siviila
sivvá	sivva
sivá	siva
siváid	sivaid
siválaš	sivalaš
skabmamánu	skábmamánu
skapmamanus	skábmamánus
skeaŋkain	skeaŋkkain
skeaŋkii	skeŋkii
skenkii	skeŋkii
skeŋkaaddin	skeaŋkaaddin
skeŋkejeaddjiide	skeŋkejeddjiide
skihpar	skihpár
skihppáraččat	skihpáraččat
skihppáriid	skihpáriid
skihppáriidda	skihpáriidda
skihppáriiddis	skihpáriiddis
skihppáriiguin	skihpáriiguin
skihppáriin	skihpáriin
skoalttáid	skoalttaid
skoalttát	skoalttat
skohteriiin	skohteriin
skohtervuoddjiid	skohtervuddjiid
skoltálaš	skoltalaš
skoltásámi	skoltasámi
skopriuvdna	skorpiovdna
skunálaccat	skunálaččat
skuvlabiret	skuvlabiiret
skuvlainternahttii	skuvlainternáhttii
skuvlaluohkaid	skuvlaluohkáid
skuvlašiljjus	skuvlašiljus
skábamanu	skábmamánu
skáhpput	skáhppot
sloahta	šloahta
sloahtta	šloahtta
smađahkes	smáđáhkes
smađáhkkat	smádáhkkásat
smegiela	sámegiela
smiehtán	smiehtan
smiehtán	smiehttan
smiid	sámiid
smávvaguolásteaddjiid	smávvaguolásteddjiid
soabadankommišuvnnaŧ	soabadankomišuvnnat
soabadiŧ	soabadit
soahpamušaigun	soahpamušaiguin
soahppat	soahpat
soahteveagaŧ	soahteveagat
soaitašii	soaittášii
soaite	soaitte
soaittahagas	soaittáhagas
soaittahatprinsihpa	soaittáhatprinsihpa
soaittašii	soaittášii
soalddaha	soalddáha
soalddahiidda	soalddáhiidda
soapmasa	soapmása
soapmasiin	soapmásiin
soađimáŋŋa	soađi maŋŋá
sofa	soffá
soffa	soffá
soffai	soffái
soffaid	soffáid
sohpojuvvo	sohppojuvvo
soisiála	sosiála
soitá	soaitá
sojáha	sojaha
soma	somá
somas	somás
sorjankehttá	sorjankeahttá
sorjjaskeahttá	sorjjaskeahttá
sorjjavaš	sorjavaš
sorjuskeahttá	sorjjaskeahttá
sosialalaš	sosiálalaš
sosialistalaš	sosialisttalaš
sosialkántuvrras	sosiálkantuvrras
sosialála	sosiálalaš
sosiáladarvinisma	sosiáldarwinisma
sosiálajođiheaddjiid	sosiáljođiheddjiid
sosiálaččat	sosiálalaččat
sosiálbávlaluslágá	sosiálbálvaluslága
sotnábeaivvi	sotnabeaivvi
spabbačiekčanjoavkku	spábbačiekčanjoavkku
speallagoahtet	speallagoahtit
speallagoahtet	speallagohtet
spelemann	spelleman
spelemannvuoiti	spellemanvuoiti
spiehkastagaŧ	spiehkastagat
spábbačiekčiid	spábbačikčiid
spábbá	spábba
srdni	sárdni
stahtačálli	stáhtačálli
staluid	stáluid
statskogbargiid	Statsskoga bargit
statskogbargit	Statsskoga bargit
status	stáhtus
statusa	stáhtusa
steamppal	steampal
steapmila	steampila
stipendiahta	stipendiáhta
stivraovddasteaddjiid	stivraovddasteddjiid
stivrenja	stivren ja
stivrenjaovku	stivrenjoavku
stivrráláhtto	stivralahttu
strategálaš	strategalaš
streikkas	streaikkas
studeantaid	studeanttaid
stuodeanttat	studeanttat
stuoramus	stuorámus
stuorasevodaga	stuoraservodaga
stuormus	stuorámus
stuorradikkeáirras	stuorradiggeáirras
stuorramus	stuorrámus
stuorrat	stuorrát
stuorráŧ	stuorrát
stuorušii	sturošii
stuorá	stuora
sturrut	sturrot
stáha	stáhta
stáhatid	stáhtaid
stáhtaborggáriida	stáhtaborgáriidda
stáhtadivatnjuolggadusaŧ	stáhtadivatnjuolggadusat
stáhtahálddašeames	stáhtahálddašeamis
stáhtaministtara	stáhtaministara
stáhtaministtariin	stáhtaministariin
stáhtá	stáhta
stáhtáeiseválddiid	stáhtaeiseválddiid
stáinnára	stáidnára
stálledoaimmahagaŧ	stálledoaimmahagat
stándardda	standárdda
stánželáirras	stánželáirrás
státha	stáhta
sudje	suddje
sudjet	suddjet
sudnje	sutnje
sulaid	sulai
sulasaš	sullasaš
sullalágaid	sullalagaid
sullastahttet	sulastahttet
sulliid	sullii
sulllii	sullii
sulloin	sulluin
suláid	sulaid
sulástahtii	sulastahtii
sulástahttit	sulastahttit
sulástahttá	sulastahttá
sulástáhtá	sulastahttá
summális	summalis
sunnje	sutnje
sunno	sudno
sunnos	sudnos
suoggardit	suokkardit
suohkanant	suohkanat
suohkanfysioterapeuta	suohkanfysioterapevta
suohkaniida	suohkaniidda
suohkastivrraáigodagas	suohkanstivraáigodagas
suohkánii	suohkanii
suohpamuš	soahpamuš
suohpamušaid	soahpamušaid
suohtasat	suohttasat
suohttasdihte	suohttasa dihte
suohttsii	suohttasii
suoi	soai
suoidemánu	suoidnemánu
suoidnemnu	suoidnemánu
suoladan 	suoládan
suoladeapmin	suoládeapmin
suoladit	suoládit
suoladuvvon	suoláduvvon
suomabealde	Suoma bealde
suomabealdi	Suoma bealde
suomabeallai	Suoma beallái
suorggehahtti	suorggahahtti
suorggiin	surggiin
suorgihahtti	suorggahahtti
susttáša	susttaša
sutno	sudno
sutnos	sudnos
sutnuide	sudnuide
svaldagaid	sávaldagaid
svaldat	sávaldat
syhkkelasttimii	sihkkelastimii
syhkkelasttit	sihkkelastit
symboleaffeakta	symbolaeffeakta
symobola	symbola
systematalaččat	systemahtalaččat
systemáhtalaccat	systemáhtalaččat
systemátiseret		systematiseret
sábehiiguin	sabehiiguin
sáddejuvvoi	sáddejuvvui
sádjásaš	sadjásaš
sáhkki	sáhkkii
sáhkki	sáhkkái
sáhkkivuohta	sáhkkiivuohta
sáhppángillár	sáhpángillár
sáhtan	sáhttán
sáhtan	sáhtán
sáhtat	sáhtát
sáhtet	sáhttet
sáhti	sáhtii
sáhtibehtet	sáhttibehtet
sáhtta	sáhttá
sáhttan	sáhttán
sáhtttán	sáhttán
sáhtá	sáhttá
sáhtášivčče	sáhtášedje
sáji	saji
sájis	sajis
sájuštuvvo	sajuštuvvo
sálbmagirjiide	sálbmagirjjiide
sálloša	sállaša
sámastit	sámástit
sámedikkeairras	sámediggeáirras
sámedikkejoavku	sámediggejoavku
sámedikkepresideanta	sámediggepresideanta
sámedikkeráđi	sámediggeráđi
sámedikkeválggaid	sámediggeválggaid
sámedikkeválggaide	sámediggeválggaide
sámedikkeválggain	sámediggeválggain
sámedikkeválggas	sámediggeválggas
sámedikkeválggat	sámediggeválggat
sámedikkeáirasat	sámediggeáirasat
sámegielaigun	sámegielaiguin
sámegielja	sámegiel ja
sámegieloahpa-headdjit	 sámegieloahpaheaddjit
sámegilii	sámegillii
sámelágá	sámelága
sámepolithkalaš	sámepolitihkalaš
sámepolitihkkalaš	sámepolitihkalaš
sámepolitihkálaš	sámepolitihkalaš
Sámi info	Sámi Info
sámid	sámiid
sámidráma	sámidrámá
sámielbmotbeaivvi	sámiálbmotbeaivvi
sámigeavaheaddjiide	sámigeavaheddjiide
sámiiid	sámiid
sámimusihkii	sámimusihkkii
sámpmelaččaide	sápmelaččaide
sápmalaččaide	sápmelaččaide
sápmelaccat	sápmelaččat
sápmálaččaid	sápmelaččaid
sárdnijeaddjiid	sárdnideddjiid
sárdnunaiggi	sárdnunáiggi
sárnestuollu	sárdnestuollu
sátnevuorka	sátnevuorká
sártnisdis	sártnistis
sátkkuŧ	sátkkut
sátnejoðiheaddje	Sátnejođiheaddji
sátnejođheaddji	sátnejođiheaddji
sátnejođiheaddjiid	sátnejođiheddjiid
sátnejođiheaddjiin	sátnejođiheddjiin
sátnejođiheaddjiávalus	sátnejođiheaddjiárválus
sátnjejođiheaddji	sátnejođiheaddji
sávccaide	sávzzaide
sávva	sávvá
sávvámis	sávvamis
sávzádoallu	sávzadoallu
sáváldagaid	sávaldagaid
sáváldat	sávaldat
sáván	sávan
sáŋggar	sáŋgár
sáŋggár	sáŋgár
sážu	sázu
tabelahtat	tableahtat
tamperees	Tamperes
teahter	teáhter
teahtera	teáhtera
teahterii	teáhterii
teahteris	teáhteris
teaknihka	teknihka
teakstta	teavstta
teat	leat
teater	teáhter
teipa	teaipa
teknalaccat	teknalaččat
teknihkkalaš	teknihkalaš
telefunnummára	telefonnummára
teorehtálaš	teorehtalaš
teorija	teoriija
tiima	tiimma
tiimas	tiimmas
tiinet	dinet
tittel	tihttel
tođđajagimánu	ođđajagimánu
traktor	tráktor
traktoriid	tráktoriid
traktoriin	tráktoriin
traktorin	tráktoriin
traktorin	tráktorin
trampoliinna	tramboliinna
turistaid	turisttaid
turistaide	turisttaide
tursitta	turistta
uhcca	uhca
uhccimus	uhcimus
uhccimusat	uhcimusat
uhccit	uhcit
uhcuda	uhccuda
uhcudit	uhccudit
uhkkidit	uhkidit
uhkkiduvvon	uhkiduvvon
ulbmilaččaŧ	ulbmillaččat
ulbmiliida	ulbmiliidda
ulbmilmearrádusaŧ	ulbmilmearrádusat
ulbmilparagrafas	ulbmilparagráfas
uniuvdna	uniovdna
uniuvdnii	uniovdnii
uniuvnna	uniovnna
uniuvnnas	uniovnnas
unjárgga-gávtti	Unjárgga gávtti
unnišedje	unnošedje
unnušdje	unnošedje
unnušedje	unnošedje
unná	unna
unuhas	unohas
vahagin	vahágin
vahkolaohpa	vahkoloahpa
vahkosaččat	vahkkosaččat
vahkui	vahkkui
vahá-gahttomiidda	vahágahttomiidda
vahágahttikeahttá	vahágahttikeahttá
vahágahttoŧ	vahágahttot
vahágain	vahágin
vaikkevel	vaikke vel
vaikkovel	vaikko vel
vaikkuha	váikkuha
vaikkuhangaskaoapmin	váikkuhangaskaoapmin
vaikkuhit	váikkuhit
vaikkuhusat	váikkuhusat
vaillevaš	váilevaš
vaimmolas	váimmolaš
vaimmolaš	váimmolaš
vajalduhte	vajálduhte
vajalduhttit	vajálduhttit
vajalduhttán	vajálduhttán
vajálduvvo	vajálduvvá
vajálduvvojedje	vajálduvve
vajálduvvojit	vajálduvvet
valaštallamii	valáštallamii
valdit	váldit
valljema	válljema
valljit	valjit
valátalliid	valáštalliid
vanhemat	vánhemat
varás	várás
vasahusat	vásáhusat
vattis	váttis
vattisvuodat	váttisvuođat
vattisvuođat	váttisvuođat
veagalváldan	veagalváldán
veaha	veahá
veahaš	veaháš
veahkešivččet	veahkehivččet
veahkkehan	veahkehan
veahkklagaid	veahkkálagaid
veaikeminerálaŧ	veaikeminerálat
vealtakeahttá	vealttakeahttá
vealttameahttun	vealtameahttun
veardidt	veardidit
vearrofriddjavuoda	vearrofriddjavuođa
vearrogáibideaddjiŧ	vearrogáibideaddjit
vearroja	vearro- ja
vearroráhtoásahuš	vearroráhtoásahus
vearrováldiŧ	vearroválddit
vejolaš-vuohta	vejolašvuohta
vejolašvuodat	vejolašvuođat
vejolašvuođ	vejolašvuođa
vejoláš	vejolaš
vela	velá
velgoheaddjiide	velgoheddjiide
veranda	veránda
vidát	viidát
vieljja	vielja
vielljaiguin	vieljaiguin
vielljain	vieljain
viessohuksejeaddjiide	viessohuksejeddjiide
viessohuksejeaddjiŧ	viessohuksejeaddjit
viessuláigu		viessoláigu
viežža	viežžá
viežžakeahttá	vieččakeahttá
vihkedalla	vihkedallá
vihkesteamen	vihkkesteamen
vihta	vihtta
vihtannuššančilgehusain	vihtanuššančilgehusain
vihtána	vihtana
vihtánat	vihtanat
viidabut	viidábut
viidasat	viidásat
viidaseappot	viidáseappot
viidaset	viidáset
viidasit	viidásit
viidat	viidát
viiddaseappot	viiddáseappot
viiddedeami	viiddideami
viiddiduvvont	viiddiduvvon
viiddiida	viiddida
viiddát	viidát
viidábot	viidábut
viidáseabbut	viidáseabbot
viidásetovddidit	viidáset ovddidit
vilgesfosfora	vilges fosfora
vilgesolbmot	vilges olbmot
vimmat		viimmat
virggii		virggiid
virggisttis	virggistis
virkut	virkot
vissasit	vissásit
visut	visot
viđadin	viđádin
viđajagi	viđa jagi
viššallit	viššalit
vldit	váldit
vmearriduvvon	mearriduvvon
vokálista	vokalista
vsihit	vásihit
vttis	váttis
vudolaccat	vuđolaččat
vuhti	vuhtii
vuhtiváldá	vuhtiiváldá
vuigatvuohta	vuoigatvuohta
vuitii	vuittii
vulgii	vulggii
vulgiidet	vulggiidet
vulgiimet	vulggiimet
vuoddjinkoarta	vuodjinkoarta
vuoddoealáhusat	vuođđoealáhusat
vuoddoealáhusdoalliid	vuođđoealáhusdolliid
vuoddoealáhusdoalliide	vuođđoealáhusdolliide
vuoddu	vuođđu
vuoddudit	vuođđudit
vuoddun	vuođđun
vuodima	vuovdima
vuodji	vuoddji
vuodu	vuođu
vuodul	vuođul
vuogadagas	vuogádagas
vuogatvuođat	vuoigatvuođat
vuogádatlaččaŧ	vuogádatlaččat
vuohkaseamos	vuohkkaseamos
vuohkki	vuohki
vuoigatuohta	vuoigatvuohta
vuoigatvuoda	vuoigatvuođa
vuoigatvuoda-	vuoigatvuođa-
vuoigatvuodacielggadeapmi		vuoigatvuođačielggadeapmi
vuoigatvuodagáibádus	vuoigatvuođagáibádus
vuoigatvuodahámát	vuoigatvuođahámát
vuoigatvuodaid	vuoigatvuođaid
vuoigatvuodaide	vuoigatvuođaide
vuoigatvuodaideaset	vuoigatvuođaideaset
vuoigatvuodaiguin	vuoigatvuođaiguin
vuoigatvuodain	vuoigatvuođain
vuoigatvuodalaccat	vuoigatvuođalaččat
vuoigatvuodalaš	vuoigatvuođalaš
vuoigatvuodalažžii	vuoigatvuođalažžii
vuoigatvuodalávdegoddi	vuoigatvuođalávdegoddi
vuoigatvuodalávdegoddái	vuoigatvuođalávdegoddái
vuoigatvuodalávdegotti	vuoigatvuođalávdegotti
vuoigatvuodalávdegottis	vuoigatvuođalávdegottis
vuoigatvuodamiellahtu	vuoigatvuođamiellahtu
vuoigatvuodamálle	vuoigatvuođamálle
vuoigatvuodatge	vuoigatvuođatge
vuoigatvuodavuoddu	vuoigatvuođavuođđu
vuoigatvuohtaja	vuoigatvuohta ja
vuoigatvuođ	vuoigatvuođa
vuoigatvuođagažalddagaid	vuoigatvuođagažaldagaid
vuoigatvuođahámáŧ	vuoigatvuođahámat
vuoigatvuođalaccat	vuoigatvuođalaččat
vuoigatvuođay	vuoigatvuođat
vuoigatvuođaŧ	vuoigatvuođat
vuoigatvuođe	vuoigatvuođa
vuoigavuohta	vuoigatvuohta
vuoigavuođadiehtagiid	vuoigatvuođadiehtagiid
vuoitindihte	vuoitin dihte
vuoitut	vuoittut
vuojadanbasseanga	vuojadanbasseaŋŋa
vuojadanálddi	vuojadanálddis
vuolga		vuolgá
vuolgadis	vuolgagis
vuolggahansádji	vuolggasadji
vuolggašii	vuolggášii
vuollaibáza	vuolláibáza
vuolleahkáhaččain	vuolleahkahaččain
vuolleahkáhaččain	vuolleahkásaččain
vuolleahkáhaš	vuolleahkahaš
vuolleahkáhaš	vuolleahkásaš
vuolláičállan	vuolláičállán
vuoodieuid	vuođđodieđuid
vuoofágas	vuođđofágas
vuooáššit	vuođđoáššit
vuordamušat	vuordámušat
vuorddetkeahtes	vuorddekeahtes
vuordetmeahttun	vuordemeahttun
vuorkagovva	vuorkágovva
vuorkkagovat	vuorkkágovat
vuortnoheigga	vuortnuheigga
vuoru-hemiid	vuoruhemiid
vuoruhanja	vuoruhan ja
vuosargga	vuossárgga
vuossarga	vuossárga
vuosta	vuostá
vuostaldit	vuosttaldit
vuostamužžan	vuosttamužžan
vuostas	vuosttas
vuostaš	vuosttaš
vuostažettiin	vuosttažettiin
vuostebeallimiehtá	vuostebealli miehtá
vuostehagu	vuostehágu
vuostelas	vuostelaš
vuosteággavuogádaŧ	vuosteággavuogádat
vuostildit	vuosttildit
vuosttasjienasteaddjiŧ	vuosttasjienasteaddjit
vuosttasvuoigatvuoda	vuosttašvuoigatvuođa
vuosttasvuoigatvuodain	vuosttašvuoigatvuođain
vuosttašin	vuosttažin
vuosttažettin	vuosttažettiin
vuosttálaga	vuostálaga
vuosttálasttii	vuostálasttii
vuosttážettiin	vuosttažettiin
vuostálasttá	vuostálastá
vuostáleaddjiid	vuostáleddjiid
vuotnaguolásteaddjiid	vuotnaguolásteddjiid
vuotnaguolásteaddjiide	vuotnaguolásteddjiide
vuovdehálddašeaddjiid	vuovdehálddašeddjiid
vuovdekeahttá	vuovddekeahttá
vuovdemassii	vuovdimassii
vuovdeossodaŧ	vuovdeossodat
vuovdinfállovuogiŧ	vuovdinfállovuogit
vuovdinsumma	vuovdinsummá
vuođolaš	vuđolaš
vuođoštit	vuođuštit
vuođđaoskuvladási	vuođđoskuvladási
vuođđobákteguovlluŧ	vuođđobákteguovllut
vuođđogeainnuŧ	vuođđogeainnut
vuođđonoađiŧ	vuođđonoađit
vuođđuealáhussan	vuođđoealáhussan
vuođđuskuvlla	vuođđoskuvlla
vuošttaš	vuosttaš
vurrolagai	vurrolagaid
vuđoleabbut	vuđoleappot
vuđđolaččat	vuđolaččat
vvváikkuhusat	váikkuhusat
váddát	váddásat
váddát	váddáseappot
váddát	váddáset
váhkkodiimmut	vahkkodiimmut
váhkku	vahkku
váhko	vahku
váhkos	vahkus
váhnemiideaset	váhnemiiddiset
váhnemiideasetguin	váhnemiiddisetguin
váhneráđđi	váhnenráđđi
váhát	vahát
váidalanásahuš	váiddaásahus
váiddagiidda	váidagiidda
váidinvuoigatvuoda	váidinvuoigatvuođa
váidinvuoigatvuodas	váidinvuoigatvuođas
váihkkuhusat	váikkuhusat
váikkkuhangaskaoamit	váikkuhangaskaoamit
váikkkuhusat	váikkuhusat
váikkoha	váikkuha
váikkohan	váikkuhan
váikkohangaskaomiid	váikkuhangaskaomiid
váikkoheamin	váikkuheamin
váikkohit	váikkuhit
váikkohus	váikkuhus
váikkohusaid	váikkuhusaid
váikkuheaddjjiiguin	váikkuheddjiiguin
váilevašvuoda	váilevašvuođa
váillevaš	váilevaš
váilojit	váilot
váivášuvvat	váivašuvvat
vájolašvuođa	vejolašvuođa
vákšujeaddji	vákšojeaddji
válda	váldá
váldan	váldán
válddahalla	válddahallá
válddahallamistis	válddahallamisttis
válddan	válddán
válddašii	válddášii
válddimiidda	váldimiidda
válddá		váldá
váldii		válddii
váldii	válddii
váldiŧ	váldit
váldodoaimmaheaddjiid	váldodoaimmaheddjiid
váldodokomeanta	váldodokumeanta
váldogirdifierbmádaŧ	váldogirdifierpmádat
váldogirdiruvttuŧ	váldogirdiruvttut
váldogáaldat	váldogažaldat
váldogážaldat	váldogažaldat
váldojuvvonn	váldojuvvon
váldokántuvra	váldokantuvra
váldokántuvrras	váldokantuvrras
váldoluohttamušaide	váldoluohttámušaide
váldoorgasnisašuvnnaide	váldoorganisašuvnnaide
váldopoastain	váldopoasttain
váldoáššálaccat	váldoáššálaččat
válgabire	válgabiire
válgabires	válgabiires
válgabiret	válgabiiret
válgadohkálaš-vuohta	válgadohkálašvuohta
válgagiccu	válgagičču
válgalohpparehkenastin	válgaloahpparehkenastin
váljejuvvo	válljejuvvo
váljejuvvon	válljejuvvon
váljen	válljen
váljii	válljii
váljje	vállje
váljjejit	válljejit
váljjejuvvun	válljejuvvon
váljjen	válljen
válljejeaddjiid	válljejeddjiid
válljejeaddjiide	válljejeddjiide
válljejuvvba	válljejuvvoba
válljejuvvoi	válljejuvvui
válljemistis	válljemisttis
válljetbearráigeahččanlávdegotti	válljet bearráigeahččanlávdegotti
váláštallamiid	valáštallamiid
várrejuvvojjit	várrejuvvojit
várrelahtui	várrelahttui
várreláhttut	várrelahtut
várrá	várra
vásedingálvvuid	vásedin gálvvuid
vássan	vássán
vástadusa	vástádusa
vástideaddjiid	vástideddjiid
vázzan	vázzán
ytringsfrihetskommisjona	Ytringsfrihetskommisjona
Áfriika	Afrihkká
Áfriikii	Afrihkái
Áfriikka	Afrihká
Áfriikkas	Afrihkás
Áhki	Ahki
Áidejávvris	Áidejávrris
Áigai	Áigái
Áilluhačča	Áillohačča
Áilluhaš	Áillohaš
Ákkastepmi	Ákkasteapmi
Álmmuheapmi	Almmuheapmi
Áltta	Álttá
Álttas	Álttás
Ámeriika	Amerihkká
Ámeriikii	Amerihkái
Ámeriikka	Amerihká
Ámeriikkas	Amerihkás
Ámmun	Ámmon
Ántiin	Ánttiin
Árbevirolaccat	Árbevirolaččat
Áššejodiheaddjiid	Áššejođiheddjiid
Â­guohtonÂ­eatnamiid	guohtoneatnamiid
Äärela	Äärelä
Øyind	Øyvind
áddejuvvoŧ	áddejuvvot
áevvoštallat	árvvoštallat
áhki	ahki
áhkidis	ahkidis
áhperávnnjiŧ	áhperávnnjit
áhččam	áhččán
áibbaš čielggas	áibbas čielggas
áidojuvvvon	áidojuvvon
áigai	áigái
áige	áigge
áige	áigi
áigeguovdilkeahttá	áigeguovdilkeahttá
áigehuvvamiidda	áiggehuvvamiidda
áigeráddjejuvvoŧ	áigeráddjejuvvot
áigges	áiggis
áiggesáigái	áigges áigái
áiggon	áiggun
áiggušii	áiggošii
áigiodagas	áigodagas
áita	áitá
áittardeaddjiŧ	áittardeaddjit
áivve	aivve
álbma	albma
álbmefuoddariin	álbmefuođđariin
álbmotmeahciš	álbmotmeahcis
álbmotrivttiiin	álbmotrivttiin
álga	álgá
álgahan	álggahan
álggaheaddjiid	álggaheddjiid
álggahuvvoi	álggáhuvvui
álggahán	álggahan
álggi	álggii
álggugeahčen	álgogeahčen
álggáhit	álggahit
álgogáldduid	álgogálduid
álgovuolggalaccat	álgovuolggalaččat
álkiibun	álkibun
álkkibun	álkibun
álkkidivččii	álkidivččii
álkkit	álkit
álmmohuvvon	almmuhuvvon
álmmolaččat	almmolaččat
álmmá	almmá
ámmástis	ámmáhisttis
ánssaša	ánssáša
ánssásivčče	ánssášivčče
árbbolaččaŧ	árbbolaččat
árbevierolaš	árbevirolaš
árbevirolaccat	árbevirolaččat
árjjalaccat	árjjalaččat
árpmikeahttá	árpmitkeahttá
ártisttaide	artisttaide
árvevieru	árbevieru
árvevierut	árbevierut
árvoštallan	árvvoštallan
árvoštallat	árvvoštallat
árvvostallat	árvvoštallat
árvvoštalallaba	árvvoštallaba
árvvoštalašivččii	árvvoštalašii
árvvoštalla	árvvoštallá
árvvoštallajuvvo	árvvoštallojuvvo
árvvoštallamiida	árvvoštallamiidda
árvvoštallojuvvoi	árvvoštallojuvvui
árvvoštangažaldat	árvvoštallangažaldat
árvvošteamiin	árvvoštemiin
ásadeamiin	ásademiin
ássanja	ássan ja
ássaŧ	ássat
ássiŧ	ássit
ávkkalaš	ávkkálaš
ávkkastallat	ávkkástallat
ávkkálaccat	ávkkálaččat
ávkkálaččaŧ	ávkkálaččat
ávkkástalln	ávkkástallan
ávnnalaš	ávnnaslaš
ávnnasliiggiŧ	ávnnasliiggit
ávččuha		ávžžuha
áŋgirdeaddji	áŋggirdeaddji
áŋgirušša	áŋgiruššá
áŋguruššansuorggi	áŋgiruššansuorggi
ášsi	ášši
áššaskuhtton	áššáskuhtton
áššebáhpirid	áššebáhpiriid
áššemeannudeaddjiid	áššemeannudeddjiid
áššečuoččaldahttiŧ	áššečuoččaldahttit
áššečuoččileddjiid	áššečuožžileddjiid
áššečuoččuheaddjiide	áššečuoččuheddjiide
áššitmat	áššit mat
áššá-skuhttimiidda	áššáskuhttimiidda
áššái-duhttomiidda	áššáiduhttomiidda
áššáiguoskevaccat	áššáiguoskevaččat
Čarajávrris	Čárajávrris
Čoaigidanvuovddijohkii	Čoaigedanvuovddijohkii
Čoalgedanvuovddijohka	Čoaigedanvuovddijohka
Čuohca	Čuohcá
Čuovzavárri	Čuovžavárri
Čuovzavárrái	Čuovžavárrái
Čáhccesuollo	Čáhcesullo
čadaha	čađaha
čahcadaga	čáhcadaga
čajeha	čájeha
čajehedje	čájehedje
čajehit	čájehit
čajehá	čájeha
čalbmebeallin	čalbmetbeallin
čalihivčče	čálihivčče
čalmmastuhttit	čalmmustuhttit
čappa	čáppa
čarvvui	čárvvui
časkan	časkán
čatnašupmi	čatnasupmi
čavgejuvvoi	čavgejuvvui
čaziide	čáziide
čađaheaigga	čađaheigga
čažiide	čáziide
čeabaha	čeabáha
čeahpastalle	čeahpástalle
čealká	cealká
čealkámuš	cealkámuš
čealkámuša	cealkámuša
čealkán	cealkán
čeavlat		čeavlát
čhpegolgadeapmi	áhpegolgadeapmi
čiekčiid	čikčiid
čiekŋaleamosit	čiekŋalepmosit
čiekŋudanfálaladagaid	čiekŋudanfálaldagaid
čielkká	cealká
čieza	čieža
čoahkkemii	čohkkemii
čoahkkimistis	čoahkkimisttis
čoahkkimngohččumiid	čoahkkingohččumiid
čoahkkimt	čoahkkimat
čoahkkinortnegistis	čoahkkinortnegisttis
čoakketkeahttá	čoakkikeahttá
čoakkimin	čoahkkimin
čoavddekeahtta	čoavddekeahttá
čohkkenja	čohkken ja
črvala	árvala
čujuheamiin	čujuhemiin
čujuhuvvojuvvojit	čujuhuvvojit
čujuhá	čujuha
čujuhán	čujuhan
čuohca	čuohcá
čuohčá	čuohcá
čuojaheaddjiiguin	čuojaheddjiiguin
čuolmmaidhaga	čuolmmaid haga
čuovganeapmai	čuovganeapmái
čuovvavaš	čuovvovaš
čuovvoba	čuovvuba
čuoččilan	čuožžilan
čuoččilii	čuožžilii
čuoŋumánu	čuoŋománu
čuožžuha	čuoččuha
čuvvodeaddjiŧ	čuvodeaddjit
čuvvovaš	čuovvovaš
čábbat	čábbát
čádnon	čadnon
čáhcelottid	čáhcelottiid
čáhcerájiŧ	čáhcerájit
čáhcevuoigat-vuođaid	čáhcevuoigatvuođaid
čáhpes		čáhppes
čáhppesmurjjiguin	čáhppesmurjjiiguin
čáhči	čáhci
čájahusgovva	čájáhusgovva
čájehalai	čájáhalai
čájehallat	čájáhallat
čájehalle	čájáhalle
čájehuvvoi	čájehuvvui
čájehá	čájeha
čájálamas	čájálmas
čájalmasain	čájálmasain
čákčamánu	čakčamánu
čákčat	čakčat
čálalašan	čálalažžan
čálbmi	čalbmi
čállan	čállán
čálligoahtet	čálligohtet
čálmmiguin	čalmmiiguin
čálmmostahttit	čalmmostahttit
čálmmosteapmi	čalmmosteapmi
čálálaččat	čálalaččat
čálálaš	čálalaš
čáppagirjjalašvuođa	čáppagirjjálašvuođa
čáppá	čáppa
čávgejit	čavgejit
čávgejuvvojit	čavgejuvvojit
čávčča	čavčča
čáđa	čađa
čáđahit	čađahit
čáđahuvvon	čađahuvvon
čáži	čázi
čážiid	čáziid
čážiide	čáziide
čážiin	čáziin
Šallošat	Šállošat
Šjuoššjávrris	Šuoššjávrris
Šuoššjávvri	Šuoššjávri
Šámi	Sámi
šadda	šaddá
šaldiid	šalddiid
šaldiin	šalddiin
šalloša	šálloša
šallošahtti	šállošahtti
šallošan	šállošan
šallošat	šállošat
šallošit	šállošit
šattašivčče	šattašedje
šattái	šattai
šealgi	sealgi
šerpenvuoigatvuoda	šerpenvuoigatvuođa
šibitdoalliide	šibitdolliide
šieahtadusbeliid	šiehtadusbeliid
šiehtadadallanbealit	šiehtadallanbealit
šiehtadallanja	šiehtadallan ja
šiehtadallanjođiheadji	šiehtadallanjođiheaddji
šiehtadanbeallálaččat	šiehtadanbealálaččat
šiljju	šilju
šiljjus	šiljus
šiljui	šilljui
šlavat	šlávat
šláhtti	šlahtti
šáddá	šaddá
šállosa	šálloša
šállosit	šállošit
šávčča	sávzza
šáŋgera		šáŋgára
smiehtttan	smiehttan
dudnje	dutnje
jeinastit	jienastit
dáidibehket	dáidibehtet
